NAME,B01003_001E,B01001_002E,B01001_026E,B02001_002E,B02001_003E,B02001_004E,B02001_005E,B02001_006E,B02001_007E,B02001_008E,B02001_009E,B02001_010E,B03003_002E,B03003_003E,B19083_001E,B19301_001E,B19301A_001E,B19301H_001E,B19301I_001E,B19301B_001E,B19301C_001E,B19301D_001E,B19301E_001E,B19301F_001E,B19301G_001E,state,county
"Carroll County, Arkansas",27690,13639,14051,25856,318,172,245,143,301,655,43,612,23669,4021,0.4365,20888,21449,23195,10334,4871,22373,8367,4324,11001,18969,05,015
"Chicot County, Arkansas",11189,5452,5737,4778,6070,47,46,0,176,72,21,51,10611,578,0.5425,18853,25733,27149,8332,13764,9226,35646,-666666666,4077,23056,05,017
"Clark County, Arkansas",22684,10769,11915,16387,5348,39,174,0,336,400,15,385,21671,1013,0.4654,19500,21694,22255,6782,15279,11187,5691,-666666666,4589,5422,05,019
"Clay County, Arkansas",15202,7490,7712,14632,76,62,26,0,242,164,5,159,14927,275,0.4528,19192,19537,19543,13036,3829,14435,,-666666666,13783,5916,05,021
"Cleburne County, Arkansas",25587,12731,12856,24850,143,103,147,0,65,279,3,276,24972,615,0.4727,25078,25414,25753,11874,4738,19295,16470,-666666666,19668,13503,05,023
"Cleveland County, Arkansas",8421,4216,4205,7299,885,19,9,0,15,194,6,188,8232,189,0.4317,21485,22842,23203,6565,13801,53411,,-666666666,,5013,05,025
"Columbia County, Arkansas",24168,11514,12654,14506,8420,76,256,0,665,245,67,178,23549,619,0.4630,19922,24479,24675,12930,12636,24271,28863,-666666666,12157,10891,05,027
"Conway County, Arkansas",21060,10306,10754,17959,2490,112,16,0,47,436,0,436,20270,790,0.4702,21896,22556,23150,9973,17818,14879,,-666666666,33838,18827,05,029
"Craighead County, Arkansas",102884,50128,52756,83094,14233,657,1222,80,1614,1984,139,1845,98028,4856,0.4762,24226,26491,26955,11569,15106,14906,26515,,9249,9212,05,031
"Crawford County, Arkansas",61927,30446,31481,55876,825,1248,1086,0,948,1944,32,1912,57599,4328,0.4387,20889,21551,22042,11559,16043,20061,16280,-666666666,9383,12637,05,033
"Crittenden County, Arkansas",49511,23382,26129,22338,25110,87,324,75,230,1347,102,1245,48360,1151,0.4512,20133,27887,28249,15998,13577,20255,29363,12792,25560,11010,05,035
"Cross County, Arkansas",17329,8379,8950,12940,4033,27,52,0,63,214,0,214,17007,322,0.4626,20692,23485,23505,20415,12475,5219,8429,-666666666,,13690,05,037
"Dallas County, Arkansas",7738,3748,3990,4256,3179,4,138,0,67,94,0,94,7509,229,0.3892,17803,19473,19791,5646,16660,,11645,-666666666,,,05,039
"Desha County, Arkansas",12234,5608,6626,5993,5837,24,14,0,238,128,0,128,11592,642,0.4747,17324,22932,24134,6598,11966,24042,,-666666666,9363,14223,05,041
"Drew County, Arkansas",18688,9034,9654,12728,5369,16,23,0,363,189,0,189,18137,551,0.4903,18373,21273,21539,7346,12559,,,-666666666,9330,3544,05,043
"Faulkner County, Arkansas",120417,59053,61364,100659,13464,483,1498,170,1644,2499,149,2350,115663,4754,0.4488,24809,26448,26718,16219,15986,49007,15601,,18478,12661,05,045
"Franklin County, Arkansas",17799,8795,9004,16789,164,423,64,26,16,317,8,309,17298,501,0.4239,19811,20284,20472,6409,14327,8633,7920,5096,,16619,05,047
"Fulton County, Arkansas",12186,6031,6155,11760,9,91,18,0,40,268,0,268,12028,158,0.4171,19082,19430,19491,10799,,7220,,-666666666,,10890,05,049
"Garland County, Arkansas",97119,46875,50244,83060,7959,708,691,9,2692,2000,59,1941,92055,5064,0.4851,24602,26063,26579,10526,15607,14695,27993,,15507,14421,05,051
"Grant County, Arkansas",18046,8867,9179,16935,788,56,33,2,25,207,13,194,17878,168,0.4477,24696,25036,25153,9076,22984,6696,,,13420,10307,05,053
"Greene County, Arkansas",43745,21558,22187,41969,411,161,59,20,408,717,32,685,42601,1144,0.4325,21643,21996,22196,10311,12755,17155,,,8601,16373,05,055
"Hempstead County, Arkansas",22208,10653,11555,13986,6737,39,1,0,909,536,141,395,19426,2782,0.4469,17813,20496,22404,7176,14325,32995,,-666666666,9667,4399,05,057
"Hot Spring County, Arkansas",33440,17232,16208,28677,3770,118,85,0,138,652,36,616,32347,1093,0.4431,20522,21692,22052,12907,13253,16005,,-666666666,12099,15008,05,059
"Howard County, Arkansas",13487,6493,6994,9094,2839,68,21,0,1264,201,0,201,11949,1538,0.5215,22587,26121,26450,11341,17477,18101,,-666666666,10474,14068,05,061
"Independence County, Arkansas",37030,17995,19035,34268,722,143,318,5,851,723,123,600,34809,2221,0.4670,22035,22624,23118,11030,22482,1248,15562,,14377,9681,05,063
"Izard County, Arkansas",13461,6980,6481,13044,166,32,21,0,55,143,10,133,13207,254,0.4192,18964,19265,19421,6147,10700,,,-666666666,,14061,05,065
"Jackson County, Arkansas",17495,8579,8916,13874,2997,62,25,0,137,400,0,400,17026,469,0.5096,18316,20366,20666,7369,11306,,,-666666666,5207,5060,05,067
"Jefferson County, Arkansas",72385,35626,36759,29613,40617,105,579,0,605,866,35,831,71016,1369,0.4710,19691,25785,26174,10961,15186,10497,36560,-666666666,11431,18251,05,069
"Johnson County, Arkansas",26025,12928,13097,24004,460,90,363,13,475,620,37,583,22551,3474,0.4630,18871,19538,19869,16078,11430,3093,11114,,12494,10689,05,071
"Lafayette County, Arkansas",7127,3498,3629,4291,2763,0,31,0,3,39,0,39,7056,71,0.5885,24171,31556,31577,27427,12782,-666666666,32548,-666666666,,13567,05,073
"Lawrence County, Arkansas",16915,8310,8605,16436,122,119,14,0,12,212,0,212,16706,209,0.4380,18010,17976,18100,7970,4261,28387,17571,-666666666,,23273,05,075
"Lee County, Arkansas",9781,5575,4206,4090,5615,21,6,0,0,49,0,49,9637,144,0.5081,14292,19401,19604,10857,10671,10910,,-666666666,-666666666,4363,05,077
"Lincoln County, Arkansas",13935,8622,5313,9275,4337,66,0,0,183,74,2,72,13434,501,0.4611,12610,16030,16272,7332,5631,12203,-666666666,-666666666,6319,8814,05,079
"Little River County, Arkansas",12616,6266,6350,9285,2644,150,0,0,347,190,0,190,12212,404,0.4288,20237,21929,21981,7904,16242,30257,-666666666,-666666666,6902,9589,05,081
"Logan County, Arkansas",21935,10961,10974,20421,381,183,479,0,136,335,35,300,21342,593,0.4578,20340,20141,20166,13484,6582,63387,28475,-666666666,,21178,05,083
"Lonoke County, Arkansas",71279,35076,36203,63610,4201,331,537,84,1015,1501,222,1279,68384,2895,0.3870,24501,25422,25607,21159,14620,18104,27801,,26060,12980,05,085
"Madison County, Arkansas",15761,7918,7843,14951,110,129,66,0,36,469,11,458,14934,827,0.4712,22637,23097,23857,8455,13627,13126,,-666666666,16722,15489,05,087
"Marion County, Arkansas",16404,8105,8299,15848,59,127,54,0,36,280,17,263,16060,344,0.4266,18706,18926,19082,9519,8258,27670,,-666666666,,8460,05,089
"Miller County, Arkansas",43666,21577,22089,31082,10991,283,57,31,358,864,113,751,42400,1266,0.4429,21217,23587,23817,12880,15463,19870,25295,,16586,11182,05,091
"Mississippi County, Arkansas",44199,21480,22719,27013,15404,33,91,33,788,837,23,814,42474,1725,0.4665,19159,22547,22942,10223,14236,19964,18370,,11091,8509,05,093
"Monroe County, Arkansas",7542,3509,4033,4226,3081,7,31,0,33,164,31,133,7361,181,0.4698,19849,24257,24081,23031,14667,,,-666666666,,8013,05,095
"Montgomery County, Arkansas",9100,4529,4571,8434,53,205,82,0,174,152,3,149,8745,355,0.4177,20375,21014,21100,8669,6143,25748,8907,-666666666,,6043,05,097
"Nevada County, Arkansas",8668,4489,4179,5547,2945,19,114,0,0,43,0,43,8642,26,0.4539,17595,20435,20476,11750,12789,25621,7540,-666666666,-666666666,3523,05,099
"Newton County, Arkansas",7988,4013,3975,7631,0,90,39,0,0,228,6,222,7902,86,0.4366,17790,17681,17808,6980,-666666666,27134,,-666666666,-666666666,20370,05,101
"Ouachita County, Arkansas",24728,11647,13081,14168,10072,47,16,0,26,399,0,399,24234,494,0.4813,20033,25293,25697,12482,13017,17945,55894,-666666666,,9989,05,103
"Perry County, Arkansas",10246,5104,5142,9547,275,30,11,0,139,244,17,227,10003,243,0.4374,22474,23085,22985,22966,10355,,,-666666666,15829,16632,05,105
"Phillips County, Arkansas",19929,9353,10576,7245,12410,2,23,0,15,234,16,218,19597,332,0.4994,16684,24234,24739,12962,12511,,42252,-666666666,,2821,05,107
"Pike County, Arkansas",11017,5412,5605,9816,334,34,77,0,561,195,0,195,10290,727,0.4432,19686,20847,20994,9769,15320,12000,3778,-666666666,8713,7879,05,109
"Poinsett County, Arkansas",24131,11833,12298,21558,1448,85,28,0,165,847,6,841,23466,665,0.4138,17710,18466,18592,10241,11684,17622,,-666666666,9558,10604,05,111
"Polk County, Arkansas",20290,9887,10403,18788,77,241,78,0,453,653,17,636,19012,1278,0.4247,18097,18609,18933,11306,11738,9750,32487,-666666666,10669,10639,05,113
"Pope County, Arkansas",63107,31051,32056,57527,1888,279,638,0,901,1874,68,1806,57932,5175,0.4534,20912,21328,21996,11174,14345,18268,22122,-666666666,11739,19170,05,115
"Prairie County, Arkansas",8334,4093,4241,7103,1114,30,2,0,28,57,1,56,8300,34,0.4267,21035,22586,22593,7524,12182,,,-666666666,,9402,05,117
"Pulaski County, Arkansas",391806,187819,203987,226711,140671,1049,8419,99,4889,9968,1635,8333,368512,23294,0.4920,28421,35845,37491,13842,17652,18248,34042,40991,13669,14974,05,119
"Randolph County, Arkansas",17584,8679,8905,16981,184,126,8,0,50,235,3,232,17272,312,0.4498,20059,20107,20233,9604,26433,11360,,-666666666,7820,18634,05,121
"St. Francis County, Arkansas",27023,14625,12398,11497,14335,92,84,14,629,372,87,285,25763,1260,0.4488,16540,21673,21884,13141,12966,,17414,,11397,7134,05,123
"Saline County, Arkansas",115577,56728,58849,104154,6989,388,1184,62,609,2191,148,2043,110682,4895,0.3869,26963,27618,28112,15478,23303,29573,19504,52534,12759,14304,05,125
"Scott County, Arkansas",10661,5397,5264,9590,14,165,328,0,220,344,0,344,9875,786,0.4305,17934,18170,18647,9581,,13885,21311,-666666666,8524,16312,05,127
"Searcy County, Arkansas",7938,3974,3964,7489,34,98,94,0,30,193,19,174,7831,107,0.4625,20618,20952,20438,51005,7056,15399,,-666666666,18300,10134,05,129
"Sebastian County, Arkansas",127351,62214,65137,101395,8397,1788,5556,75,5125,5015,597,4418,110310,17041,0.4911,23383,25344,27350,9893,13840,19780,23014,14104,10755,14443,05,131
"Sevier County, Arkansas",17193,8586,8607,11237,858,364,82,4,4318,330,64,266,11633,5560,0.4066,17458,20289,21445,11435,12113,16624,11096,,11869,10789,05,133
"Sharp County, Arkansas",17027,8345,8682,16294,55,95,97,0,23,463,82,381,16672,355,0.4777,19404,19717,19879,12687,5011,13616,22265,-666666666,8817,11237,05,135
"Stone County, Arkansas",12503,6341,6162,12080,10,44,26,0,29,314,0,314,12290,213,0.4860,19616,19957,20069,12433,,14495,,-666666666,,8296,05,137
"Autauga County, Alabama",55049,26877,28172,42311,10196,226,444,31,764,1077,70,1007,53633,1416,0.4295,26168,28781,28754,22887,17711,16415,25327,28784,14651,14045,01,001
"Baldwin County, Alabama",199510,97371,102139,172441,18594,1355,1338,0,1766,4016,908,3108,190798,8712,0.4608,28069,30185,30762,14947,13363,24142,22467,-666666666,13504,14857,01,003
"Barbour County, Alabama",26614,14239,12375,12430,12756,46,129,0,1099,154,6,148,25467,1147,0.4620,17249,23139,23329,11645,11822,85357,18159,-666666666,11357,12241,01,005
"Bibb County, Alabama",22572,12084,10488,17370,4788,81,14,0,8,311,0,311,22070,502,0.4494,18988,21341,21381,19676,11066,7247,,-666666666,,13933,01,007
"Blount County, Alabama",57704,28572,29132,55073,905,201,92,0,501,932,28,904,52668,5036,0.4165,21033,21313,22500,8634,14358,25934,15968,-666666666,15903,13195,01,009
"Bullock County, Alabama",10552,5719,4833,2301,7967,84,84,0,1,115,0,115,10539,13,0.4701,17909,32020,32179,3977,13445,,,-666666666,,,01,011
"Butler County, Alabama",20280,9522,10758,10876,8875,15,203,0,44,267,0,267,20027,253,0.4588,19011,23375,23527,15528,13301,4927,38263,-666666666,,17845,01,013
"Calhoun County, Alabama",115883,55742,60141,86777,23791,382,1079,6,1221,2627,133,2494,111901,3982,0.4543,22231,24445,24746,12046,15897,14285,28928,,10837,10232,01,015
"Chambers County, Alabama",34018,16299,17719,19417,13779,78,312,0,42,390,18,372,33870,148,0.4734,21532,25329,25402,10716,15453,205987,25185,-666666666,,9894,01,017
"Cherokee County, Alabama",25897,12883,13014,24156,1209,152,109,0,2,269,6,263,25492,405,0.4464,22544,23143,23336,9911,13211,39825,4599,-666666666,,8181,01,019
"Chilton County, Alabama",43817,21559,22258,36740,4418,134,191,0,1882,452,20,432,40476,3341,0.4575,22045,23715,24201,11849,14259,20663,,-666666666,11886,9315,01,021
"Choctaw County, Alabama",13287,6349,6938,7495,5658,2,6,0,2,124,0,124,13213,74,0.4799,20773,25173,25255,4186,15062,,,-666666666,,14624,01,023
"Clarke County, Alabama",24847,11738,13109,13253,11304,8,114,33,0,135,3,132,24804,43,0.5259,20543,25642,25715,,13843,,,,-666666666,10779,01,025
"Clay County, Alabama",13483,6532,6951,11177,1993,124,0,0,68,121,11,110,13064,419,0.4497,21115,22836,23356,7429,14084,4096,-666666666,-666666666,,5635,01,027
"Cleburne County, Alabama",14991,7423,7568,14176,354,21,86,0,58,296,26,270,14642,349,0.4441,19791,20117,20364,7543,16897,,30040,-666666666,10993,6365,01,029
"Coffee County, Alabama",50991,25210,25781,38945,8766,421,623,0,528,1708,14,1694,47647,3344,0.4485,25325,27920,28322,19922,17727,15781,13765,-666666666,12127,15816,01,031
"Colbert County, Alabama",54377,26271,28106,43379,8532,328,255,31,605,1247,168,1079,53071,1306,0.4396,23318,24415,24556,15040,19186,51969,33670,26258,18418,6079,01,033
"Conecuh County, Alabama",12697,6028,6669,6593,5880,19,14,0,1,190,0,190,12473,224,0.4791,16004,20049,20199,9383,11684,3137,,-666666666,,3673,01,035
"Coosa County, Alabama",10864,5355,5509,7204,3516,8,0,0,0,136,0,136,10724,140,0.4263,18080,20369,20586,9415,14041,,-666666666,-666666666,-666666666,,01,037
"Covington County, Alabama",37729,18219,19510,31881,4945,130,176,23,144,430,9,421,37151,578,0.4555,21738,23493,23542,16130,11528,27924,15550,,12226,13786,01,039
"Crenshaw County, Alabama",13896,6863,7033,9935,3312,123,232,0,180,114,0,114,13662,234,0.4680,20455,22852,22894,16058,14328,11772,25609,-666666666,9616,5621,01,041
"Cullman County, Alabama",81316,40200,41116,77946,899,425,497,19,634,896,41,855,77890,3426,0.4529,21041,21401,21869,8568,13131,15589,16224,,8971,11697,01,043
"Dale County, Alabama",49607,24443,25164,36921,9756,295,508,11,611,1505,71,1434,46686,2921,0.4576,22834,25424,25788,16241,14180,21240,28472,,9579,19364,01,045
"Dallas County, Alabama",41426,19128,22298,11884,28798,91,163,37,92,361,36,325,41029,397,0.5170,17611,29305,29585,14983,12794,20647,31064,32857,12274,9850,01,047
"DeKalb County, Alabama",70937,35134,35803,61858,1082,979,214,497,4713,1594,266,1328,60995,9942,0.4438,18685,19757,20582,8051,13782,15842,38946,4578,7446,17046,01,049
"Elmore County, Alabama",80957,39347,41610,61018,17296,210,457,0,634,1342,73,1269,78689,2268,0.4270,24771,27618,27803,20720,15635,11059,28260,-666666666,25081,13922,01,051
"Escambia County, Alabama",37875,19390,18485,23453,12267,1317,40,67,224,507,58,449,37095,780,0.4891,17420,20956,21025,16315,10538,20520,4710,,13220,14078,01,053
"Etowah County, Alabama",103363,50007,53356,84024,15931,475,699,67,584,1583,59,1524,99611,3752,0.4391,21287,22407,22827,11954,15504,11000,55156,,18478,9144,01,055
"Fayette County, Alabama",16783,8311,8472,14371,2104,0,45,0,0,263,0,263,16639,144,0.4579,20201,21546,21647,4251,12832,-666666666,1882,-666666666,-666666666,8777,01,057
"Franklin County, Alabama",31573,15553,16020,28133,1427,313,102,18,1244,336,133,203,26516,5057,0.4415,18193,18737,19688,12356,16783,8767,3014,,14466,5679,01,059
"Geneva County, Alabama",26765,13072,13693,23235,2570,126,103,0,178,553,3,550,25773,992,0.4508,20189,21237,21607,9454,13015,20329,17421,-666666666,5833,14607,01,061
"Greene County, Alabama",8587,4092,4495,1472,6977,35,14,0,0,89,54,35,8534,53,0.5086,13679,26548,26548,,11118,,,-666666666,-666666666,,01,063
"Hale County, Alabama",15159,7121,8038,6062,8843,49,16,9,147,33,33,0,14976,183,0.4906,19296,27607,27621,16049,13719,,,,19042,,01,065
"Henry County, Alabama",17187,8301,8886,12113,4793,0,0,0,88,193,18,175,16752,435,0.4590,22825,25464,25572,19191,16554,-666666666,-666666666,-666666666,14211,16878,01,067
"Houston County, Alabama",103891,49782,54109,72332,27680,427,866,27,648,1911,119,1792,100580,3311,0.4809,24086,28019,28446,14102,14517,20575,37316,,15123,11967,01,069
"Jackson County, Alabama",52608,25763,26845,47949,1733,448,196,28,591,1663,32,1631,51173,1435,0.4543,20487,20800,20885,12539,16751,25280,5900,49954,7537,19875,01,071
"Jefferson County, Alabama",659096,311971,347125,345499,280248,1467,9932,198,12185,9567,641,8926,634780,24316,0.4995,28162,36970,37612,14377,18471,24913,28624,26292,10666,16284,01,073
"Lamar County, Alabama",14066,6813,7253,12315,1584,42,0,0,81,44,0,44,13865,201,0.4710,20206,21119,21254,13030,14062,,-666666666,-666666666,,,01,075
"Lauderdale County, Alabama",92641,44261,48380,80627,9126,371,629,15,218,1655,148,1507,90424,2217,0.4640,24893,25794,26030,20414,17814,37308,31948,,40953,12548,01,077
"Lawrence County, Alabama",33433,16272,17161,26108,3800,1653,31,0,0,1841,126,1715,32742,691,0.4330,21911,21860,22004,10023,16819,27312,37577,-666666666,-666666666,28034,01,079
"Lee County, Alabama",153947,76027,77920,107682,35770,203,5576,27,2423,2266,110,2156,148266,5681,0.5003,24951,27667,27999,17186,17522,17712,28728,9252,18030,12080,01,081
"Limestone County, Alabama",90257,45146,45111,73517,11502,581,1125,30,1271,2231,103,2128,85122,5135,0.4595,26086,27714,28475,13061,19945,30695,25880,,15623,9147,01,083
"Lowndes County, Alabama",10565,5045,5520,2612,7886,8,0,0,0,59,0,59,10515,50,0.5244,18434,35600,35743,16838,12789,,-666666666,-666666666,-666666666,,01,085
"Macon County, Alabama",19684,9072,10612,3106,16162,65,44,0,175,132,12,120,19360,324,0.4753,18385,23776,22590,23177,17421,15160,23355,-666666666,14825,14230,01,087
"Madison County, Alabama",349973,171085,178888,240861,84657,2094,8574,396,3355,10036,550,9486,333611,16362,0.4664,33264,37954,38748,19975,22334,26504,37110,20095,13103,18299,01,089
"Marengo County, Alabama",20066,9433,10633,9167,10587,50,43,0,150,69,0,69,19876,190,0.5190,20359,28174,28056,15843,13886,,10200,-666666666,10937,10665,01,091
"Marion County, Alabama",30239,14958,15281,28242,1012,115,98,0,174,598,26,572,29513,726,0.4750,20998,21403,21388,16414,18183,21703,24871,-666666666,9490,9229,01,093
"Marshall County, Alabama",94534,46597,47937,87423,1981,567,556,20,2324,1663,237,1426,82324,12210,0.4730,21767,22336,24099,8138,12816,17128,35673,,8493,16317,01,095
"Mobile County, Alabama",414291,198297,215994,246794,146306,2568,8140,49,3207,7227,458,6769,403334,10957,0.4703,23318,28016,28235,18525,16058,22154,24029,35610,14519,13258,01,097
"Monroe County, Alabama",21975,10522,11453,12065,9405,251,50,0,0,204,0,204,21839,136,0.5370,16556,21128,21213,1905,10538,21209,16688,-666666666,-666666666,17845,01,099
"Montgomery County, Alabama",227392,107740,119652,85928,129205,388,5109,44,2830,3888,671,3217,219862,7530,0.4858,26255,37818,38817,20816,18683,29145,31180,31241,25930,15734,01,101
"Morgan County, Alabama",119555,58849,60706,97880,14557,849,802,5,2582,2880,121,2759,110216,9339,0.4531,24415,26198,27275,10997,17154,35831,20740,,9694,11412,01,103
"Perry County, Alabama",9856,4671,5185,2962,6760,4,18,0,47,65,0,65,9762,94,0.4983,14033,20374,20596,7060,11435,,,-666666666,11389,131,01,105
"Pickens County, Alabama",20042,9877,10165,11254,8387,24,12,9,184,172,37,135,19556,486,0.4958,19188,24385,24804,7601,12652,,,,10157,8892,01,107
"Pike County, Alabama",33277,15865,17412,19408,12514,215,704,2,19,415,56,359,32547,730,0.5205,20180,24395,24605,17119,14485,12807,10591,,,14670,01,109
"Randolph County, Alabama",22615,11025,11590,17452,4429,74,51,44,165,400,6,394,21954,661,0.4446,19584,21329,21590,7586,14896,16546,,,2106,4648,01,111
"Russell County, Alabama",58636,28519,30117,30392,24789,216,435,128,603,2073,457,1616,55662,2974,0.4554,20760,23189,23317,18544,19268,18157,15725,10526,13534,7052,01,113
"St. Clair County, Alabama",86576,43498,43078,75738,8156,265,741,0,715,961,99,862,84615,1961,0.4144,24474,25268,25391,14516,18970,20949,27129,-666666666,11647,17000,01,115
"Shelby County, Alabama",205951,100098,105853,167257,23898,446,4088,67,6873,3322,335,2987,194090,11861,0.4296,34117,36272,36671,16081,27246,26082,34560,47545,12159,20701,01,117
"Sumter County, Alabama",13285,6135,7150,3280,9523,41,375,0,18,48,6,42,13246,39,0.5215,13929,22802,22898,7172,11362,,4652,-666666666,,6592,01,119
"Talladega County, Alabama",81057,39342,41715,52390,25996,253,442,29,643,1304,100,1204,79305,1752,0.4567,20430,23018,23217,10688,15324,13032,65822,,12542,8161,01,121
"Tallapoosa County, Alabama",40958,19395,21563,28778,11248,144,208,0,292,288,25,263,39970,988,0.4548,21410,25045,25317,15451,13060,18589,12465,-666666666,3754,10054,01,123
"Tuscaloosa County, Alabama",202471,97672,104799,132344,62793,287,3044,29,1870,2104,62,2042,195805,6666,0.4686,23896,27667,28131,14213,16885,21032,21987,5469,12100,9776,01,125
"Walker County, Alabama",65593,31944,33649,59932,3791,36,302,0,109,1423,15,1408,64110,1483,0.4599,20410,21048,21279,10249,15079,37369,14211,-666666666,20903,8577,01,127
"Washington County, Alabama",16909,8389,8520,11082,4189,1341,110,0,79,108,37,71,16690,219,0.4354,19598,21779,21765,12462,15495,17015,1917,-666666666,,14769,01,129
"Wilcox County, Alabama",11119,5362,5757,3050,8000,7,0,0,62,0,0,0,11057,62,0.5301,14800,25277,25277,,10922,,-666666666,-666666666,,-666666666,01,131
"Winston County, Alabama",24013,11814,12199,23191,98,166,84,12,33,429,23,406,23313,700,0.4415,19299,19672,19858,11281,6003,9898,11527,,25039,7251,01,133
"Aleutians East Borough, Alaska",3299,2145,1154,630,231,1119,974,36,134,175,20,155,2968,331,0.3868,31025,44439,47587,27679,23526,26736,30125,31622,29149,26378,02,013
"Aleutians West Census Area, Alaska",5714,3578,2136,1763,315,745,2086,143,346,316,74,242,4924,790,0.3659,35083,49589,53866,30813,36914,28902,27623,30057,41029,11903,02,016
"Anchorage Municipality, Alaska",299321,152681,146640,192329,16938,20963,26756,6797,6187,29351,1760,27591,273230,26091,0.4201,37864,46142,47543,25226,28118,23418,22945,18581,23107,20744,02,020
"Bethel Census Area, Alaska",17885,9358,8527,1976,135,14651,161,67,75,820,11,809,17526,359,0.4289,18231,53551,55798,14806,32060,12819,36500,8558,17092,24840,02,050
"Bristol Bay Borough, Alaska",942,536,406,525,3,302,11,2,13,86,0,86,896,46,0.3808,41420,51738,53477,13189,,30187,,,11908,24837,02,060
"Denali Borough, Alaska",2125,1142,983,1817,21,66,72,0,4,145,0,145,2108,17,0.3762,38337,40000,39993,,39790,22362,11921,-666666666,,37062,02,068
"Dillingham Census Area, Alaska",4980,2564,2416,893,12,3596,108,1,27,343,0,343,4833,147,0.4268,23520,49258,51767,24797,18808,16761,28775,,96852,20141,02,070
"Fairbanks North Star Borough, Alaska",100150,53774,46376,76617,4183,6547,3037,594,925,8247,93,8154,92664,7486,0.4029,34182,37821,38948,20016,25000,20862,31454,18011,19770,19394,02,090
"Haines Borough, Alaska",2528,1429,1099,1970,1,123,85,5,12,332,0,332,2487,41,0.4263,32673,34069,34368,13768,,32175,60614,,,17997,02,100
"Hoonah-Angoon Census Area, Alaska",2107,1084,1023,1070,77,678,48,1,24,209,0,209,2002,105,0.3908,31451,39269,39862,24344,37900,19038,64904,,43508,20230,02,105
"Juneau City and Borough, Alaska",32524,16648,15876,22575,381,4009,2332,324,251,2652,162,2490,30476,2048,0.3790,40592,45877,46693,27740,150161,25593,25651,18755,34181,18956,02,110
"Kenai Peninsula Borough, Alaska",57637,30103,27534,48208,345,4338,761,190,399,3396,134,3262,55423,2214,0.4179,32556,34941,35371,19619,20024,17488,34675,6969,33527,20060,02,122
"Ketchikan Gateway Borough, Alaska",13715,7038,6677,9264,68,1834,1037,10,125,1377,15,1362,13081,634,0.4158,32694,39338,39868,25569,26796,19441,20339,,18047,16264,02,130
"Kodiak Island Borough, Alaska",13918,7338,6580,7516,20,1908,3048,159,261,1006,307,699,12707,1211,0.3845,32066,41720,42983,21096,22360,20549,22806,11324,24595,15244,02,150
"Kusilvak Census Area, Alaska",7993,4259,3734,312,46,7128,31,0,3,473,0,473,7886,107,0.4156,11701,43538,44499,14044,20709,9926,26777,-666666666,,15660,02,158
"Lake and Peninsula Borough, Alaska",1411,720,691,300,11,976,40,1,0,83,0,83,1382,29,0.4409,22684,39954,40371,16903,,17357,18320,,-666666666,22384,02,164
"Matanuska-Susitna Borough, Alaska",98679,51495,47184,82571,1042,5100,1316,175,611,7864,251,7613,94216,4463,0.4061,30078,32246,32631,21119,26144,21445,18529,21835,19675,16358,02,170
"Nome Census Area, Alaska",9879,5317,4562,1623,75,7174,127,22,11,847,17,830,9667,212,0.4413,20033,46082,47602,19279,17573,13374,32940,23632,27955,24608,02,180
"North Slope Borough, Alaska",9681,6114,3567,3150,57,5022,584,182,108,578,13,565,9310,371,0.4155,49982,96876,98536,41675,94839,23173,42003,29524,72600,33207,02,185
"Northwest Arctic Borough, Alaska",7723,4181,3542,890,43,6350,61,1,62,316,0,316,7560,163,0.4200,21028,56650,57513,30150,33165,15443,41833,,39361,23451,02,188
"Petersburg Borough, Alaska",3196,1712,1484,2391,75,241,143,20,61,265,16,249,2865,331,0.4475,34788,39506,41329,22708,15463,23625,26659,11510,24407,16375,02,195
"Prince of Wales-Hyder Census Area, Alaska",6374,3444,2930,2941,13,2650,69,38,10,653,15,638,6153,221,0.4103,25564,32986,33326,21761,24062,19298,12438,14647,32620,19506,02,198
"Sitka City and Borough, Alaska",8921,4564,4357,5744,195,1206,616,33,82,1045,126,919,8365,556,0.3924,35655,41700,42418,25023,27474,27959,25629,18836,30974,19645,02,220
"Skagway Municipality, Alaska",1014,541,473,815,11,59,76,0,4,49,4,45,950,64,0.3262,39412,42045,42219,30992,62545,24644,32168,-666666666,,20753,02,230
"Southeast Fairbanks Census Area, Alaska",6970,3876,3094,5444,98,768,124,3,105,428,14,414,6617,353,0.3899,30757,34306,35034,17564,13356,12688,43825,,32475,17467,02,240
"Valdez-Cordova Census Area, Alaska",9522,5065,4457,7023,12,1420,353,51,30,633,21,612,9078,444,0.4122,35457,41281,42325,22062,23400,17489,15307,11282,44793,24116,02,261
"Wrangell City and Borough, Alaska",2401,1218,1183,1621,7,462,83,0,3,225,0,225,2329,72,0.3991,29782,33939,34201,8836,,20002,26246,-666666666,,22075,02,275
"Yakutat City and Borough, Alaska",646,346,300,290,7,201,38,7,2,101,0,101,628,18,0.3499,31084,40577,41024,29494,,22753,30026,21500,,22067,02,282
"Yukon-Koyukuk Census Area, Alaska",5600,3026,2574,1250,21,3938,41,0,25,325,3,322,5493,107,0.4587,20812,35478,36662,13067,19671,16625,17139,-666666666,21124,15649,02,290
"Apache County, Arizona",72346,35740,36606,16307,361,52978,259,81,647,1713,187,1526,68043,4303,0.4847,13428,23808,25783,14383,10547,10090,18094,15191,23299,13948,04,001
"Cochise County, Arizona",128177,65281,62896,106136,5076,1496,2250,399,6577,6243,1200,5043,84080,44097,0.4529,23757,24709,29160,14998,25219,21426,29470,18770,16521,12822,04,003
"Coconino County, Arizona",138064,68229,69835,87335,2136,37054,2430,178,4202,4729,866,3863,119134,18930,0.4767,24711,30319,31851,18353,19118,14213,23324,22981,19008,11762,04,005
"Gila County, Arizona",53179,26432,26747,41812,332,8249,418,0,985,1383,186,1197,43315,9864,0.4328,21470,24231,25991,16044,13333,9849,23558,-666666666,13721,14144,04,007
"Graham County, Arizona",37529,20148,17381,29600,741,4941,265,49,953,980,226,754,25483,12046,0.4244,17710,19262,21875,14224,17849,9053,17983,15059,17418,14707,04,009
"Greenlee County, Arizona",9224,4905,4319,8333,175,351,51,0,220,94,74,20,4934,4290,0.4102,23778,23873,28684,18626,25062,26562,15194,-666666666,22614,9929,04,011
"La Paz County, Arizona",20304,10366,9938,15274,77,2683,148,48,1600,474,75,399,14988,5316,0.4389,21447,23068,25801,14527,15060,14608,26974,16438,17390,21437,04,012
"Maricopa County, Arizona",4088549,2021817,2066732,3214001,216064,77142,157074,8425,281320,134523,27886,106637,2850257,1238292,0.4682,28791,31174,37130,15127,21005,17149,33599,19148,14583,15752,04,013
"Mohave County, Arizona",203629,102473,101156,182395,2100,4332,2551,279,6421,5551,877,4674,171642,31987,0.4455,22026,22669,23983,13643,12867,14325,33626,28756,14091,13869,04,015
"Navajo County, Arizona",108209,54271,53938,51614,905,47599,659,100,3808,3524,496,3028,96252,11957,0.4696,16564,23252,24124,13986,14071,10186,17201,7782,13104,9277,04,017
"Pima County, Arizona",1003338,493568,509770,775748,35337,32542,27297,1483,89364,41567,10860,30707,641073,362265,0.4713,26204,28912,34110,16336,20277,13174,27492,22765,14997,14290,04,019
"Pinal County, Arizona",397604,207471,190133,317989,18223,20889,6974,1375,20437,11717,2275,9442,281532,116072,0.4202,21982,23746,27296,14250,19082,12260,20019,7683,14798,11344,04,021
"Santa Cruz County, Arizona",46547,22284,24263,39587,194,177,357,18,5634,580,280,300,7811,38736,0.4818,18860,19360,34963,15837,17272,40850,20546,,12774,36502,04,023
"Yavapai County, Arizona",218586,106905,111681,201048,1159,3998,1874,80,5782,4645,363,4282,187864,30722,0.4415,26584,27326,28897,15460,24264,16516,32566,15234,14841,16128,04,025
"Yuma County, Arizona",203292,104216,99076,147979,4230,2301,2622,348,40956,4856,1448,3408,77320,125972,0.4388,19483,21051,30247,13696,21039,12796,31042,8711,13845,15630,04,027
"Arkansas County, Arkansas",18569,8798,9771,13483,4892,11,1,0,14,168,30,138,18013,556,0.4876,23287,26793,27298,10915,14019,36155,,-666666666,,9007,05,001
"Ashley County, Arkansas",20989,10185,10804,15049,5440,43,0,0,307,150,13,137,19909,1080,0.4546,20290,23601,23799,17657,12034,,-666666666,-666666666,12402,9412,05,003
"Baxter County, Arkansas",40992,19848,21144,39668,101,218,227,7,205,566,5,561,40156,836,0.4388,23068,23284,23403,15545,5011,18521,17269,,14781,18233,05,005
"Benton County, Arkansas",245231,121493,123738,216485,3634,3376,8713,1045,4844,7134,894,6240,205826,39405,0.4477,28996,29576,32247,15026,33797,19071,35208,7094,19002,16074,05,007
"Boone County, Arkansas",37301,18285,19016,36003,129,284,191,46,16,632,2,630,36442,859,0.4520,21719,21726,21871,14776,33384,33077,24759,,9963,11979,05,009
"Bradley County, Arkansas",11096,5485,5611,6833,3239,157,0,0,822,45,10,35,9523,1573,0.4794,20465,25558,27057,9251,13185,1131,-666666666,-666666666,11271,6396,05,011
"Calhoun County, Arkansas",5210,2679,2531,3992,1140,6,11,15,2,44,0,44,5012,198,0.4401,21093,23645,24480,8938,12907,,,,,,05,013
"Union County, Arkansas",40334,19599,20735,26064,13299,319,200,0,108,344,58,286,38848,1486,0.4697,22240,26300,27147,10679,14888,11862,18267,-666666666,17866,12108,05,139
"Van Buren County, Arkansas",16892,8363,8529,16151,91,64,40,0,43,503,44,459,16404,488,0.4445,19883,20130,20300,14368,20524,14292,14310,-666666666,17058,13230,05,141
"Washington County, Arkansas",219930,109797,110133,172215,7585,1904,5268,4658,21781,6519,956,5563,184376,35554,0.4931,25249,28334,29519,12032,15485,19733,24890,8698,11055,16275,05,143
"White County, Arkansas",78823,38642,40181,72140,3357,155,573,15,768,1815,140,1675,75609,3214,0.4686,22510,23234,23640,10522,13123,18701,27923,,13042,13813,05,145
"Woodruff County, Arkansas",6873,3266,3607,4801,1831,5,101,7,10,118,1,117,6830,43,0.4724,18382,19712,19819,5019,15492,,,,,4547,05,147
"Yell County, Arkansas",21716,10731,10985,17708,590,163,308,0,2765,182,67,115,17525,4191,0.4231,18981,20197,20919,12680,15404,11552,9849,-666666666,13351,19940,05,149
"Alameda County, California",1605217,786730,818487,703973,182092,10176,452582,13811,140543,102040,19517,82523,1243147,362070,0.4688,39042,47724,56212,21215,27687,27695,40148,26382,19920,23686,06,001
"Alpine County, California",1184,692,492,857,10,224,9,0,0,84,0,84,1092,92,0.5054,26783,33728,34730,12374,,9271,,-666666666,-666666666,7775,06,003
"Amador County, California",36963,19839,17124,32039,898,502,547,76,1553,1348,87,1261,32141,4822,0.4355,27496,29802,31009,14157,1029,20226,23194,20408,11661,13413,06,005
"Butte County, California",223877,110926,112951,186105,3366,2445,9651,457,8164,13689,1626,12063,189374,34503,0.4816,25077,27077,28551,15150,13026,19878,16296,40379,15054,13447,06,007
"Calaveras County, California",44787,22156,22631,41304,258,453,448,155,394,1775,87,1688,39759,5028,0.4648,30577,31949,33282,20107,13904,15445,29243,10459,17838,9842,06,009
"Colusa County, California",21361,11097,10264,18721,222,211,346,20,1223,618,120,498,9010,12351,0.4563,25745,26369,42642,14294,54198,31470,32168,23675,13050,16280,06,011
"Contra Costa County, California",1107925,540671,567254,661857,97032,5447,171853,5511,95126,71099,12479,58620,830249,277676,0.4679,40792,47880,55577,21116,28159,24503,42101,23124,18948,20722,06,013
"Del Norte County, California",27628,15168,12460,21485,642,1834,672,31,668,2296,146,2150,22302,5326,0.4748,20282,21501,24764,7637,5804,25627,29585,,11507,8689,06,015
"El Dorado County, California",183000,91349,91651,159165,1784,1494,7596,343,6204,6414,731,5683,160132,22868,0.4578,37089,38245,39798,20776,24106,27509,47263,27970,15438,23622,06,017
"Fresno County, California",963160,480527,482633,593119,48434,10034,95558,1868,176490,37657,10907,26750,462024,501136,0.4799,21057,24499,34742,13597,16308,16903,20462,16181,12705,14951,06,019
"Glenn County, California",27976,14216,13760,23493,195,516,685,129,2318,640,123,517,16721,11255,0.4792,20362,21592,27156,12444,15186,19212,14023,18898,13639,9176,06,021
"Humboldt County, California",135182,67449,67733,109778,1603,6834,3739,331,4729,8168,803,7365,120652,14530,0.4592,24038,25575,26280,15266,18392,14846,18896,17557,15007,20033,06,023
"Imperial County, California",178807,91324,87483,124349,4856,1914,2558,254,36347,8529,4187,4342,30927,147880,0.4669,16311,17791,30517,14017,15982,15578,31082,18996,11647,10450,06,025
"Inyo County, California",18326,9235,9091,15003,180,2092,223,34,372,422,79,343,14459,3867,0.4177,28678,30551,34380,16882,13610,19588,24165,13400,22660,22517,06,027
"Kern County, California",871337,447079,424258,647832,48264,10051,40088,1623,94294,29185,8470,20715,421590,449747,0.4603,21094,22400,32148,13590,15808,15026,26654,14374,15118,14975,06,029
"Kings County, California",150261,83207,67054,100728,9596,2054,5700,381,25612,6190,1322,4868,70399,79862,0.4502,19123,20999,29131,12143,20124,16834,28772,14329,11449,10953,06,031
"Lake County, California",64076,31982,32094,50491,1395,2246,872,69,7100,1903,271,1632,51990,12086,0.4691,21799,24040,24847,12824,10332,15743,22752,,11149,17299,06,033
"Lassen County, California",31945,21191,10754,25461,2845,904,535,256,1189,755,212,543,26065,5880,0.4321,20072,22993,26559,5327,5379,20101,12488,7339,4504,11138,06,035
"Los Angeles County, California",10057155,4954616,5102539,5283457,831313,62671,1431361,26810,2030157,391386,110467,280919,5195507,4861648,0.5023,29301,34982,51522,16749,25373,19842,32729,22046,15442,22300,06,037
"Madera County, California",153366,74035,79331,121146,5102,2415,3055,179,15929,5540,2099,3441,67101,86265,0.4567,19021,20155,29050,12601,13336,15996,30631,20006,12469,13181,06,039
"Marin County, California",259358,126745,132613,204928,6075,797,14693,571,20533,11761,2073,9688,218415,40943,0.5251,63608,72452,76514,22568,38314,24833,54175,22492,14580,24568,06,041
"Mariposa County, California",17645,8881,8764,15542,226,541,224,27,320,765,74,691,15856,1789,0.4562,27832,28616,29979,14319,30528,17696,23910,,24014,20726,06,043
"Mendocino County, California",87409,43634,43775,72347,564,3501,1539,185,4749,4524,729,3795,66454,20955,0.4876,25278,27450,31070,12768,10964,15861,19521,27915,13910,13398,06,045
"Merced County, California",265001,133782,131219,155239,8902,1865,19843,537,66865,11750,4793,6957,112526,152475,0.4589,19130,22336,30572,13525,19283,16425,17885,23654,13678,10002,06,047
"Modoc County, California",9033,4637,4396,8151,82,379,130,8,66,217,7,210,7698,1335,0.4221,21899,22862,24573,11789,,14626,12655,,13438,11399,06,049
"Mono County, California",14051,7551,6500,11917,90,384,167,0,1064,429,58,371,10186,3865,0.3729,31059,33323,38626,13717,24179,18736,25395,-666666666,11845,30513,06,051
"Monterey County, California",430201,219883,210318,300610,11488,3173,25195,2076,70177,17482,3776,13706,183117,247084,0.4586,25947,28826,46201,15008,22094,20334,29212,25909,15169,18547,06,053
"Napa County, California",140823,70010,70813,103119,2943,1221,10931,267,17274,5068,1339,3729,93659,47164,0.4712,38057,42921,50740,20171,32830,26384,33985,23723,18311,21778,06,055
"Nevada County, California",98639,48833,49806,90973,495,1128,1281,75,1686,3001,458,2543,89620,9019,0.4514,33385,34158,35212,19521,22425,23653,42550,21065,11964,23852,06,057
"Orange County, California",3132211,1546687,1585524,1974749,51519,12938,602013,9552,362842,118598,24177,94421,2061658,1070553,0.4697,35939,40835,51309,18631,33377,24849,35008,34457,16164,22082,06,059
"Placer County, California",370571,180790,189781,308414,5473,1957,24862,585,11535,17745,2305,15440,320667,49904,0.4460,37914,39297,41064,22957,36335,32760,41256,34235,20497,21683,06,061
"Plumas County, California",18754,9484,9270,16800,26,417,171,190,341,809,55,754,17176,1578,0.4653,31292,32412,33343,19952,9412,31918,18097,14899,25387,17549,06,063
"Riverside County, California",2323892,1156126,1167766,1470294,145025,20205,143067,6915,436022,102364,28239,74125,1220924,1102968,0.4478,24443,27695,35576,15714,23347,20884,27498,21987,14995,16121,06,065
"Sacramento County, California",1479300,722955,756345,876485,146464,11133,224235,15500,104392,101091,17029,84062,1146333,332967,0.4598,28292,33074,37045,17639,21280,21969,25895,20369,17342,15524,06,067
"San Benito County, California",58051,29062,28989,48662,440,445,1517,110,4090,2787,973,1814,24187,33864,0.4060,27848,28656,41364,19512,49663,24691,32079,24212,22576,16392,06,069
"San Bernardino County, California",2106754,1047925,1058829,1306582,180733,17510,142332,6933,356704,95960,27412,68548,1017650,1089104,0.4442,21857,23585,31146,15824,20499,17405,29387,16338,15669,13925,06,071
"San Diego County, California",3253356,1635137,1618219,2310046,163928,21577,376393,14918,207129,159365,29156,130209,2177037,1076319,0.4662,32482,35269,44044,17920,25888,23891,33292,25458,16789,19168,06,073
"San Francisco County, California",850282,433226,417056,409355,45607,2922,287847,3168,59686,41697,5973,35724,720384,129898,0.5188,55567,75717,82183,30501,27317,28054,41562,29759,24266,34030,06,075
"San Joaquin County, California",714860,355719,359141,403016,49874,4508,106511,3995,83247,63709,9370,54339,425531,289329,0.4525,23477,27224,34626,15191,20110,19091,22610,22446,15064,15229,06,077
"San Luis Obispo County, California",278680,141572,137108,238145,5516,1950,10375,256,13169,9269,1378,7891,217585,61095,0.4516,32335,34378,37660,18696,19618,21111,25551,10320,16054,21126,06,079
"San Mateo County, California",754748,371545,383203,404461,18533,2440,203926,10615,76854,37919,7005,30914,565443,189305,0.4860,50262,60470,71903,23555,32594,29050,48362,24706,20743,28580,06,081
"Santa Barbara County, California",439395,220159,219236,325664,8878,4162,23342,768,57857,18724,4525,14199,244374,195021,0.4813,31098,34756,45521,16839,24308,21413,31086,36566,16129,18884,06,083
"Santa Clara County, California",1885056,949223,935833,883775,48003,8742,648047,7810,198893,89786,19362,70424,1388465,496591,0.4666,46034,53681,66096,21601,32957,25784,48194,27676,19387,24754,06,085
"Santa Cruz County, California",270931,134367,136564,214929,2374,1595,12169,322,27342,12200,2277,9923,181344,89587,0.4754,34732,38257,45742,17092,42992,23368,29504,11906,15697,20984,06,087
"Shasta County, California",179228,87903,91325,155944,1759,4329,5273,71,3698,8154,1072,7082,162525,16703,0.4541,25094,26315,26933,16631,19057,17072,19490,8879,15484,15434,06,089
"Sierra County, California",2931,1449,1482,2809,2,33,1,14,14,58,0,58,2626,305,0.4724,31873,31933,34027,13081,,61500,,,,28848,06,091
"Siskiyou County, California",43668,21713,21955,37355,709,1468,695,140,640,2661,261,2400,38568,5100,0.4588,23542,25127,26424,12438,18081,11671,13807,7117,14931,14765,06,093
"Solano County, California",429596,213518,216078,227173,60716,2118,65444,3579,38856,31710,5003,26707,320309,109287,0.4277,30251,34877,39908,18848,25158,20400,32551,25405,17644,18776,06,095
"Sonoma County, California",497776,243919,253857,378638,7848,5353,19421,1602,60010,24904,4616,20288,368142,129634,0.4593,35639,40331,44086,17852,23444,23051,33709,22137,16311,19809,06,097
"Stanislaus County, California",530561,262151,268410,396063,14505,3467,28764,3746,61006,23010,5578,17432,295566,234995,0.4504,22915,24578,31035,14901,22703,21492,24428,16205,14800,15360,06,099
"Sutter County, California",95406,47486,47920,67721,1861,859,14358,377,4389,5841,785,5056,66921,28485,0.4593,24335,26723,32884,13816,25418,17715,20599,25577,15203,13250,06,101
"Tehama County, California",63015,31379,31636,54530,394,1736,883,3,2958,2511,505,2006,48056,14959,0.4402,21521,22325,24469,13601,12840,20102,24210,,15225,12890,06,103
"Trinity County, California",13180,6752,6428,11373,144,566,205,138,393,361,20,341,12230,950,0.4663,22387,23618,23897,16277,17761,13025,15085,,20077,13224,06,105
"Tulare County, California",455769,227963,227806,363181,7261,5847,16004,703,48026,14747,4339,10408,168625,287144,0.4679,18257,18887,30636,11911,16620,14606,25306,14778,13550,12852,06,107
"Tuolumne County, California",53864,28134,25730,47618,1023,882,706,106,1289,2240,357,1883,47631,6233,0.4795,29431,31285,31769,21059,8879,18616,18677,24306,11708,17508,06,109
"Ventura County, California",843110,417442,425668,669728,14847,6294,59749,1530,54528,36434,7864,28570,489878,353232,0.4456,34331,35599,47799,18494,34526,27294,42142,28473,20275,20623,06,111
"Yolo County, California",209671,102268,107403,140668,5161,1494,29092,856,20509,11891,2115,9776,144223,65448,0.4879,28996,32815,38727,17582,21576,20334,24956,26000,17018,18890,06,113
"Yuba County, California",73897,37471,36426,53217,2260,1059,5125,322,6035,5879,1117,4762,53994,19903,0.4240,21418,23524,25922,13560,25671,18384,18059,20078,14424,11447,06,115
"Adams County, Colorado",479977,241414,238563,397314,15373,5842,17978,680,26102,16688,3495,13193,293125,186852,0.4046,26051,27430,34074,16545,19859,20452,22670,26348,17178,18401,08,001
"Alamosa County, Colorado",16353,7971,8382,14264,337,452,173,39,645,443,124,319,8883,7470,0.4849,18133,18766,23006,13583,6080,12397,13739,22818,14739,19028,08,003
"Arapahoe County, Colorado",617668,303932,313736,447507,64110,3497,34534,1298,38821,27901,6422,21479,502359,115309,0.4621,35250,40158,43744,17798,24106,27112,29892,23129,16440,16540,08,005
"Archuleta County, Colorado",12355,6274,6081,10585,119,302,89,0,1104,156,31,125,10065,2290,0.4425,28649,30804,31972,17167,24009,18893,14053,-666666666,14252,15068,08,007
"Baca County, Colorado",3648,1743,1905,3492,48,56,0,4,13,35,7,28,3285,363,0.4309,22113,22668,23065,18597,12183,10039,-666666666,,,8400,08,009
"Bent County, Colorado",5816,3821,1995,5025,472,72,34,0,98,115,33,82,3978,1838,0.4520,13772,15159,17621,10221,1854,3374,4868,-666666666,19746,6130,08,011
"Boulder County, Colorado",313961,157617,156344,278048,2914,1690,14060,235,8519,8495,1056,7439,271047,42914,0.4781,40097,42031,44955,18665,23202,17380,32098,45749,17809,22547,08,013
"Broomfield County, Colorado",62449,30980,31469,54028,610,298,3917,0,1469,2127,344,1783,55001,7448,0.4274,41698,43230,44772,28681,41867,27432,37018,-666666666,19554,28627,08,014
"Chaffee County, Colorado",18507,9854,8653,17739,237,136,67,0,120,208,74,134,16631,1876,0.4060,27848,28448,29811,14880,2532,16292,29984,-666666666,20020,16890,08,015
"Cheyenne County, Colorado",2071,1057,1014,1989,6,13,38,1,8,16,7,9,1805,266,0.3962,23916,24200,25991,10755,,12577,22211,,,13031,08,017
"Clear Creek County, Colorado",9238,4779,4459,8710,105,74,39,27,63,220,9,211,8715,523,0.4565,42355,43456,44658,16734,20586,27257,,,8738,18114,08,019
"Conejos County, Colorado",8213,4100,4113,7518,14,154,13,10,404,100,50,50,3778,4435,0.4469,18221,18502,21993,15289,12900,18981,16385,13260,14734,11439,08,021
"Costilla County, Colorado",3590,1924,1666,3345,13,7,38,0,81,106,0,106,1288,2302,0.5279,20238,19952,30061,14747,,,44195,-666666666,21037,21907,08,023
"Crowley County, Colorado",5537,3173,2364,4668,294,84,39,27,185,240,85,155,3829,1708,0.4411,12513,12894,14442,11365,115,3567,25926,,11820,23172,08,025
"Custer County, Colorado",4375,2146,2229,4069,136,41,0,1,51,77,0,77,4180,195,0.4323,22333,23069,23437,14470,9428,,-666666666,,20386,13229,08,027
"Delta County, Colorado",30221,15127,15094,28515,217,334,271,0,530,354,30,324,25722,4499,0.4739,24261,24725,26872,12144,1724,15578,17234,-666666666,21684,18083,08,029
"Denver County, Colorado",663303,331602,331701,510441,64805,6203,23191,406,35547,22710,4346,18364,459261,204042,0.5008,36616,40967,51601,16907,21796,19933,31343,20785,17759,20853,08,031
"Dolores County, Colorado",1789,946,843,1737,0,8,0,3,1,40,2,38,1696,93,0.4678,21112,21351,21821,12540,-666666666,,-666666666,,,9873,08,033
"Douglas County, Colorado",314238,156120,158118,283589,3533,767,13037,228,3782,9302,1104,8198,288503,25735,0.4016,47062,48127,49551,29013,47479,28620,45312,28267,32472,24804,08,035
"Eagle County, Colorado",52894,28064,24830,46821,416,337,441,49,3812,1018,162,856,37170,15724,0.4320,38604,41165,48248,17651,24296,24907,42801,,15346,16704,08,037
"Elbert County, Colorado",24225,12223,12002,22950,179,108,187,5,190,606,55,551,22711,1514,0.4052,39360,39795,40850,23686,44021,29665,43748,,38058,22211,08,039
"El Paso County, Colorado",665171,334605,330566,533391,40766,4104,17847,2329,29462,37272,5475,31797,557517,107654,0.4360,30261,32642,34397,18568,23367,21116,26200,25617,18660,16141,08,041
"Fremont County, Colorado",46835,27365,19470,42017,2360,498,379,30,757,794,271,523,40798,6037,0.4313,19427,20744,22555,8629,2246,9048,8264,,23956,8883,08,043
"Garfield County, Colorado",57495,29406,28089,49860,465,585,428,8,4876,1273,133,1140,41439,16056,0.4183,29179,30963,35170,14539,10395,47960,21717,,14480,16527,08,045
"Gilpin County, Colorado",5708,3019,2689,5196,17,63,11,0,146,275,73,202,5174,534,0.4210,37027,37468,38520,15562,,26573,,-666666666,69544,16428,08,047
"Grand County, Colorado",14490,7752,6738,13375,115,6,248,41,646,59,0,59,13339,1151,0.3877,32348,33728,34457,17209,13709,,32774,14032,10878,,08,049
"Gunnison County, Colorado",15889,8606,7283,15199,103,106,105,19,79,278,6,272,14476,1413,0.4056,25920,26384,27575,13360,3941,36551,21183,,15822,10408,08,051
"Hinsdale County, Colorado",856,407,449,821,0,17,0,0,0,18,0,18,830,26,0.4287,29958,30515,30972,10612,-666666666,,-666666666,-666666666,-666666666,19161,08,053
"Huerfano County, Colorado",6521,3283,3238,6114,23,130,10,0,187,57,22,35,4275,2246,0.4850,25062,25689,29953,16143,,19867,,-666666666,12868,22019,08,055
"Jackson County, Colorado",1306,634,672,1202,1,6,0,0,91,6,3,3,1080,226,0.4204,26798,28379,30414,9922,,,-666666666,-666666666,6762,,08,057
"Jefferson County, Colorado",558810,277758,281052,507544,6452,4766,14915,302,10017,14814,2765,12049,474801,84009,0.4360,38367,39550,42182,22184,26174,20223,34584,28867,24027,22704,08,059
"Kiowa County, Colorado",1465,699,766,1401,7,3,2,0,0,52,0,52,1368,97,0.4226,21602,21918,22722,11110,,,,-666666666,-666666666,12919,08,061
"Kit Carson County, Colorado",8174,4682,3492,7538,306,28,18,29,189,66,46,20,6585,1589,0.4838,24327,25828,28138,15241,821,164,8894,,16714,5597,08,063
"Lake County, Colorado",7401,4110,3291,6391,8,12,38,32,765,155,0,155,4847,2554,0.3909,26693,28808,33175,16262,,,,,14896,,08,065
"La Plata County, Colorado",53994,27292,26702,47916,242,3151,300,26,1135,1224,169,1055,47310,6684,0.4293,32953,34356,35567,22866,34217,21097,22561,55788,21833,20689,08,067
"Larimer County, Colorado",325228,161828,163400,296021,2931,1787,6542,301,6853,10793,1757,9036,289424,35804,0.4525,32433,33652,35034,17954,20419,21706,28171,17259,15760,17639,08,069
"Las Animas County, Colorado",14322,7392,6930,12067,133,492,110,23,913,584,259,325,8262,6060,0.4368,23857,24738,28128,19040,3109,17625,29654,,22324,15978,08,071
"Lincoln County, Colorado",5515,3460,2055,4811,468,80,12,23,21,100,0,100,4339,1176,0.4558,14210,15855,20126,1879,1047,1356,10200,,9195,8337,08,073
"Logan County, Colorado",21862,11972,9890,20116,480,422,211,16,133,484,239,245,18512,3350,0.4509,23692,24743,26182,16098,4843,14873,18209,,13794,11150,08,075
"Mesa County, Colorado",148166,73393,74773,138828,1038,1221,934,229,2063,3853,655,3198,127378,20788,0.4526,26731,27224,28840,16572,15832,20699,31716,10579,23687,15190,08,077
"Mineral County, Colorado",793,414,379,687,5,6,0,0,86,9,6,3,678,115,0.4024,35041,37971,38523,16608,,,-666666666,-666666666,17908,,08,079
"Moffat County, Colorado",13034,6761,6273,12349,109,71,104,84,167,150,33,117,11130,1904,0.4275,26344,26864,29249,12264,10972,37285,13882,17018,15844,15076,08,081
"Montezuma County, Colorado",26006,12843,13163,21582,104,3007,53,12,424,824,26,798,22857,3149,0.4242,22738,24089,25466,14481,4926,12780,16962,,26817,24397,08,083
"Montrose County, Colorado",40866,20143,20723,37916,233,402,323,241,1108,643,109,534,32611,8255,0.4195,23276,24040,26453,12594,14924,17792,18681,10534,10976,12935,08,085
"Morgan County, Colorado",28288,14071,14217,25655,875,141,143,3,608,863,357,506,18330,9958,0.4133,23408,23899,28755,14965,21251,22674,23117,,17027,15678,08,087
"Otero County, Colorado",18440,9072,9368,16686,89,304,184,140,682,355,76,279,10827,7613,0.4647,19842,20548,25336,12773,9990,17029,11230,,12167,6223,08,089
"Ouray County, Colorado",4651,2216,2435,4554,0,15,30,0,4,48,0,48,4354,297,0.4180,34993,35153,36059,22482,-666666666,,,-666666666,,19073,08,091
"Park County, Colorado",16440,8640,7800,15663,18,119,187,133,68,252,0,252,15519,921,0.3972,34442,34536,35189,25521,,32861,44876,41889,46075,16187,08,093
"Phillips County, Colorado",4347,2256,2091,4142,10,39,30,0,35,91,12,79,3576,771,0.4526,26290,26576,29680,12516,,10182,,-666666666,,24070,08,095
"Pitkin County, Colorado",17543,9208,8335,16197,254,43,217,1,608,223,5,218,15823,1720,0.5607,59229,62406,64796,24130,19353,33116,26235,,16374,28115,08,097
"Prowers County, Colorado",12121,6089,6032,11537,78,82,99,0,151,174,9,165,7672,4449,0.4415,20589,20743,25286,13007,5644,17043,19998,-666666666,23603,16413,08,099
"Pueblo County, Colorado",162158,79805,82353,126695,3625,5110,1269,96,18379,6984,2464,4520,93166,68992,0.4445,22431,24384,27661,16459,12675,16707,28453,6645,15504,13614,08,101
"Rio Blanco County, Colorado",6658,3403,3255,6429,18,30,6,9,41,125,68,57,5973,685,0.4127,27419,27300,28611,15623,31894,74277,,,34280,13738,08,103
"Rio Grande County, Colorado",11623,5733,5890,10602,88,237,43,19,482,152,65,87,6472,5151,0.4644,22918,23335,29496,15227,42691,16675,6693,18563,18477,11333,08,105
"Routt County, Colorado",23980,12465,11515,22726,179,101,263,0,481,230,16,214,22331,1649,0.4678,36692,37865,39003,14559,27090,16904,25049,-666666666,7134,12019,08,107
"Saguache County, Colorado",6255,3074,3181,5641,0,63,82,0,222,247,58,189,3872,2383,0.5002,21356,22440,27989,12745,-666666666,21783,4588,-666666666,14707,8037,08,109
"San Juan County, Colorado",552,291,261,534,0,3,0,0,15,0,0,0,422,130,0.3910,29427,28940,31653,22770,-666666666,,-666666666,-666666666,,-666666666,08,111
"San Miguel County, Colorado",7767,4118,3649,7427,12,39,85,0,63,141,0,141,7011,756,0.4701,35701,35886,37464,23672,7483,52536,69067,-666666666,7194,16307,08,113
"Sedgwick County, Colorado",2367,1121,1246,2167,26,12,36,0,45,81,5,76,2038,329,0.4308,24247,24402,25381,17495,,17508,40539,-666666666,18700,8084,08,115
"Summit County, Colorado",29269,16153,13116,25825,299,40,229,123,2229,524,258,266,25126,4143,0.4406,36545,39359,40578,18923,42132,25538,3849,3515,13321,16381,08,117
"Teller County, Colorado",23472,11986,11486,22235,216,48,212,0,201,560,2,558,22040,1432,0.4128,34230,33899,34775,19536,78315,7865,47171,-666666666,24798,31122,08,119
"Washington County, Colorado",4814,2477,2337,4633,43,23,17,0,37,61,12,49,4372,442,0.4322,25744,26159,27539,11724,3933,10374,,-666666666,20032,18707,08,121
"Weld County, Colorado",278065,139799,138266,243393,3109,2244,3651,159,17790,7719,2131,5588,198060,80005,0.4234,27808,29250,33191,16389,18526,20337,24216,41414,16015,16838,08,123
"Yuma County, Colorado",10150,4968,5182,9621,106,29,4,0,225,165,59,106,7957,2193,0.4437,23905,24680,28346,9227,,17621,,-666666666,11748,10795,08,125
"Fairfield County, Connecticut",941618,458490,483128,694622,107282,2441,47742,392,62931,26208,7999,18209,766138,175480,0.5444,51719,60223,65342,23588,23824,23893,53838,35147,18206,19979,09,001
"Hartford County, Connecticut",895699,434485,461214,648438,120439,2467,43798,370,50084,30103,8315,21788,744344,151355,0.4712,36570,41632,44720,17756,22744,17214,38344,93034,16029,15346,09,003
"Litchfield County, Connecticut",185141,91469,93672,172643,3154,286,3511,6,2664,2877,483,2394,175138,10003,0.4397,38859,40006,40615,20437,23749,26325,29041,,16270,20710,09,005
"Middlesex County, Connecticut",164438,80412,84026,146228,8214,143,4828,11,1574,3440,360,3080,155162,9276,0.4417,42573,44371,45122,26178,28275,37536,37515,,22437,16935,09,007
"New Haven County, Connecticut",860874,415286,445588,644385,110829,1688,33744,163,46626,23439,5578,17861,716325,144549,0.4677,33706,37555,40469,17307,22130,23170,35794,30688,15933,15768,09,009
"New London County, Connecticut",272033,136190,135843,221407,15526,1616,11283,57,8668,13476,1308,12168,245332,26701,0.4413,35531,38442,39458,18992,22305,25233,36075,20189,17893,15127,09,011
"Tolland County, Connecticut",151689,75894,75795,135217,4560,74,6321,6,1941,3570,273,3297,144060,7629,0.4180,36364,37906,38576,18635,20464,17424,30769,,17661,17947,09,013
"Windham County, Connecticut",117078,58044,59034,105140,2692,684,1555,26,3106,3875,305,3570,104343,12735,0.4111,28663,30084,31195,13557,18667,12451,23656,,13096,14437,09,015
"Kent County, Delaware",171474,82687,88787,114958,42097,1123,3433,104,2551,7208,472,6736,160148,11326,0.4201,26118,28537,29122,17190,22503,25012,29151,22797,18934,9961,10,001
"New Castle County, Delaware",551997,267276,284721,359253,134502,1347,28581,209,14025,14080,1594,12486,500085,51912,0.4545,33240,37281,39150,17793,24698,24629,40633,30333,17574,13213,10,003
"Sussex County, Delaware",211224,102453,108771,172791,26428,1024,2414,148,3876,4543,549,3994,191800,19424,0.4384,29630,32249,33685,16499,17775,21518,32257,10396,15365,12198,10,005
"District of Columbia, District of Columbia",659009,312629,346380,266035,318598,2174,24036,271,29650,18245,2561,15684,589903,69106,0.5334,48781,78151,82408,33944,26715,28056,56659,60170,23406,38990,11,001
"Alachua County, Florida",256581,124004,132577,178684,50945,785,14906,523,2403,8335,1209,7126,233502,23079,0.5161,25758,29818,30937,18904,14829,24768,24230,14195,14247,12410,12,001
"Baker County, Florida",27312,14280,13032,22833,3798,95,178,0,194,214,9,205,26679,633,0.4300,21222,23527,23843,9521,8624,14834,9767,-666666666,17563,14591,12,003
"Bay County, Florida",178361,88681,89680,146493,19188,1228,4019,104,1122,6207,467,5740,168144,10217,0.4456,25695,27383,27670,20864,18005,17746,25830,15198,15823,13063,12,005
"Bradford County, Florida",26919,14875,12044,21033,5214,26,166,8,41,431,23,408,25897,1022,0.4560,19852,22407,22648,16413,10891,,18272,,,6998,12,007
"Brevard County, Florida",560683,273945,286738,466147,57306,1652,13274,486,6424,15394,1699,13695,508530,52153,0.4528,28189,30091,30967,20292,17461,20153,27144,52495,19460,15169,12,009
"Broward County, Florida",1863780,906235,957545,1153566,525216,4636,65574,1029,57775,55984,11913,44071,1350032,513748,0.4807,28987,34620,40257,23820,18500,22089,30932,21745,20396,18586,12,011
"Calhoun County, Florida",14550,7936,6614,11720,1933,130,93,0,279,395,36,359,13730,820,0.4167,16560,18120,18459,9209,8308,18024,12909,-666666666,8375,16818,12,013
"Charlotte County, Florida",169642,82682,86960,152785,9748,341,1963,88,1301,3416,436,2980,158391,11251,0.4525,27860,28868,29714,16305,20107,14513,27245,20902,14383,11896,12,015
"Citrus County, Florida",140453,67884,72569,131042,4241,442,2278,0,442,2008,164,1844,133259,7194,0.4555,24188,24256,24690,15805,18774,41814,38190,-666666666,31023,9927,12,017
"Clay County, Florida",200346,98575,101771,163638,19765,310,6068,184,2646,7735,868,6867,182299,18047,0.4115,27159,28463,28924,21519,22583,25707,24579,29206,21464,15233,12,019
"Collier County, Florida",348236,171049,177187,306114,24300,1083,4480,0,8297,3962,883,3079,255485,92751,0.5298,39616,42763,52786,15669,13773,18524,28192,-666666666,16512,22012,12,021
"Columbia County, Florida",68198,35318,32880,52704,12112,118,581,37,641,2005,219,1786,64410,3788,0.4605,21875,23847,24288,13657,15623,3134,35159,,8884,9289,12,023
"DeSoto County, Florida",35134,19905,15229,29041,4590,95,81,42,836,449,105,344,24352,10782,0.4287,16710,17963,21558,11161,9238,45640,30952,10500,15709,5824,12,027
"Dixie County, Florida",16084,8779,7305,14097,1220,65,65,35,115,487,26,461,15476,608,0.4583,18490,19889,19944,17101,6610,3192,10463,,,10793,12,029
"Duval County, Florida",900890,436406,464484,551020,264996,2021,39702,1003,10864,31284,3279,28005,823119,77771,0.4719,27235,32257,33565,19822,18027,27036,32139,16949,20009,13426,12,031
"Escambia County, Florida",309574,153860,155714,212494,67330,1368,9030,133,4253,14966,966,14000,292888,16686,0.4350,24532,28542,28875,18966,16088,26616,19663,29717,14623,11093,12,033
"Flagler County, Florida",102917,49410,53507,84152,11257,139,2424,36,2621,2288,470,1818,92838,10079,0.4306,25314,27069,27627,19490,17765,20102,24291,,17396,8796,12,035
"Franklin County, Florida",11705,6675,5030,9618,1689,66,37,78,54,163,0,163,11106,599,0.4886,21515,23788,24504,8464,9615,11135,17059,,,20067,12,037
"Gadsden County, Florida",46153,21862,24291,18865,25718,53,209,23,656,629,14,615,41525,4628,0.4458,18187,23531,26011,12289,14698,9608,22733,,9765,9131,12,039
"Gilchrist County, Florida",17033,8961,8072,15650,1059,34,15,0,50,225,25,200,16124,909,0.4695,21620,22903,23466,12317,4198,11938,,-666666666,28928,14625,12,041
"Glades County, Florida",13420,7269,6151,10740,1697,541,87,0,171,184,15,169,10603,2817,0.4471,17798,17203,19285,10385,8093,64390,10346,-666666666,10373,15451,12,043
"Gulf County, Florida",15851,9220,6631,12390,2948,71,93,24,26,299,45,254,15089,762,0.4463,20050,22581,23217,11023,11090,8475,7431,,,5701,12,045
"Hamilton County, Florida",14362,8377,5985,8618,4933,108,53,0,263,387,140,247,13065,1297,0.4704,15970,19970,21084,6466,10235,13511,12577,-666666666,6923,7289,12,047
"Hardee County, Florida",27302,14728,12574,22458,2171,48,159,5,2115,346,59,287,15561,11741,0.4702,17179,18699,24907,10411,7914,7267,26163,,11987,5637,12,049
"Hendry County, Florida",38376,20347,18029,29226,4578,836,360,51,2731,594,231,363,18751,19625,0.4870,18027,19518,27960,12871,11151,23981,18086,,14623,6288,12,051
"Hernando County, Florida",176797,85023,91774,158419,9301,401,1955,47,2558,4116,392,3724,156338,20459,0.4236,22435,23358,24153,15807,16316,9557,16433,,13361,10702,12,053
"Highlands County, Florida",98862,48031,50831,81606,9901,157,1452,34,4128,1584,243,1341,80595,18267,0.4636,21916,23662,25692,12752,13713,15462,22152,,9777,15648,12,055
"Hillsborough County, Florida",1323059,644746,678313,940105,219430,4080,50230,817,67249,41148,8299,32849,970764,352295,0.4804,28727,32054,36945,18405,19404,24610,33777,19402,15709,18135,12,057
"Holmes County, Florida",19569,10463,9106,17310,1562,118,66,28,58,427,38,389,19259,310,0.4492,17854,18761,18952,4072,6123,12548,27556,5361,3817,26706,12,059
"Indian River County, Florida",145342,69798,75544,124489,13282,363,1776,0,2732,2700,242,2458,128199,17143,0.5308,32208,34926,37016,16406,14675,14738,36267,-666666666,11917,13330,12,061
"Jackson County, Florida",48721,27001,21720,33766,13015,308,338,36,359,899,108,791,46481,2240,0.4503,17222,19666,20161,9583,11928,10789,12891,,3082,12231,12,063
"Jefferson County, Florida",14082,7483,6599,8589,5064,35,0,0,220,174,0,174,13513,569,0.4545,21311,26121,27018,6209,14387,18309,-666666666,-666666666,1243,11348,12,065
"Lafayette County, Florida",8742,5015,3727,6963,1485,13,5,0,99,177,59,118,7618,1124,0.5006,19341,21829,24577,10524,4659,,,-666666666,12837,46996,12,067
"Lake County, Florida",317586,153595,163991,265082,31492,1339,5790,372,6378,7133,1195,5938,273734,43852,0.4292,24760,26269,27661,17371,15650,28407,28440,12644,15387,14213,12,069
"Lee County, Florida",680970,333403,347567,578220,58757,1463,10637,234,19515,12144,2693,9451,547218,133752,0.4768,28949,31209,34914,14442,15382,27510,28465,22721,12689,13817,12,071
"Leon County, Florida",284788,135482,149306,176962,88889,691,9538,54,2267,6387,515,5872,267469,17319,0.4848,27190,32858,33822,19357,16688,16968,29506,22820,13989,18675,12,073
"Levy County, Florida",39707,19555,20152,34829,3554,156,158,0,79,931,100,831,36559,3148,0.4624,20555,21257,21850,14669,15523,26638,12497,-666666666,18638,14015,12,075
"Liberty County, Florida",8285,5224,3061,6394,1514,22,59,0,208,88,0,88,7775,510,0.4455,17218,19822,20556,5838,7464,,24671,-666666666,10052,9752,12,077
"Madison County, Florida",18560,9750,8810,10754,7177,85,31,0,206,307,6,301,17664,896,0.4883,16486,20622,21241,8845,10965,16733,,-666666666,3775,10009,12,079
"Manatee County, Florida",353411,170779,182632,302459,31382,931,6660,219,5652,6108,815,5293,298031,55380,0.4668,29140,31105,34244,14345,15699,31623,28102,15140,15820,14487,12,081
"Marion County, Florida",340341,163611,176730,278342,43307,999,5037,135,3650,8871,1903,6968,299762,40579,0.4409,22390,23552,24511,15684,15337,11833,37820,33381,13078,16456,12,083
"Martin County, Florida",153592,75837,77755,133754,8583,637,1797,61,6504,2256,646,1610,133815,19777,0.5170,35892,38883,40858,15099,12092,15311,42247,,10182,16139,12,085
"Miami-Dade County, Florida",2664418,1292784,1371634,2015422,489030,3485,42007,734,74835,38905,11705,27200,894495,1769923,0.5264,24515,26609,45511,21890,16035,21023,31259,41412,21196,21756,12,086
"Monroe County, Florida",77150,40911,36239,68621,5513,171,872,0,792,1181,170,1011,59786,17364,0.5003,36771,38707,44009,20677,19106,21955,38435,-666666666,18319,20020,12,087
"Nassau County, Florida",77187,38139,39048,69760,4948,276,686,5,544,968,63,905,74265,2922,0.4557,31141,32131,32509,21961,22082,8920,27261,,30017,15809,12,089
"Okaloosa County, Florida",195798,99177,96621,154416,18821,1097,5735,334,6733,8662,622,8040,179451,16347,0.4279,29603,32173,32626,20685,20465,20715,26658,12552,19825,14964,12,091
"Okeechobee County, Florida",39420,21306,18114,34256,3470,348,408,31,523,384,34,350,29530,9890,0.4512,17173,18203,20931,10536,7653,17626,17017,,10538,21474,12,093
"Orange County, Florida",1256055,617633,638422,807479,263131,2311,64845,578,76386,41325,10417,30908,887552,368503,0.4813,26210,30183,36199,17836,17675,19205,27991,18976,17339,17022,12,095
"Osceola County, Florida",311962,153499,158463,234781,35421,1116,8209,355,20884,11196,3370,7826,155232,156730,0.4304,19482,20496,26801,14876,16376,14998,22217,12040,15020,15053,12,097
"Palm Beach County, Florida",1398757,676486,722271,1042509,255606,2087,35653,539,32010,30353,5679,24674,1109106,289651,0.5169,34846,40300,46666,19535,17090,23820,30831,21492,21178,17200,12,099
"Pasco County, Florida",488310,237641,250669,431979,25064,1731,11622,291,5412,12211,2654,9557,422741,65569,0.4469,25225,25770,26759,18654,21251,22591,29077,37053,17005,14163,12,101
"Pinellas County, Florida",939548,450712,488836,774949,96224,2780,30112,768,10211,24504,3062,21442,856403,83145,0.4861,31035,33484,34779,19738,17929,34092,27025,21571,19547,14726,12,103
"Polk County, Florida",637691,312427,325264,500894,96445,1767,10860,285,11232,16208,3173,13035,511850,125841,0.4359,21669,23562,26105,14040,13982,22495,27453,17544,13914,10377,12,105
"Putnam County, Florida",72304,35711,36593,56974,12006,183,424,29,1589,1099,167,932,65403,6901,0.4625,18561,20384,21314,10410,11464,19525,16593,,10797,13654,12,107
"St. Johns County, Florida",218362,106007,112355,194915,11370,544,5323,203,1182,4825,493,4332,204978,13384,0.4772,38362,39874,40556,27566,19301,25898,49849,15735,26309,14851,12,109
"St. Lucie County, Florida",293136,142999,150137,216152,57196,814,5334,64,7046,6530,1126,5404,241373,51763,0.4625,24104,26496,29304,15337,16448,15606,27756,,18627,16206,12,111
"Santa Rosa County, Florida",163903,83912,79991,140972,9412,817,3063,266,1914,7459,592,6867,155524,8379,0.4270,28219,29672,30014,19756,21084,31990,24130,25922,25018,11932,12,113
"Sarasota County, Florida",398011,189970,208041,363082,18087,1057,6047,39,3129,6570,580,5990,363777,34234,0.4832,35210,36778,38254,20455,16150,19081,28581,30592,26577,13877,12,115
"Seminole County, Florida",442905,213833,229072,350590,50282,725,18297,324,9267,13420,2102,11318,357613,85292,0.4571,30097,32284,35113,19770,21123,29099,30210,14253,17522,15577,12,117
"Sumter County, Florida",113589,57426,56163,100709,9417,354,397,49,1098,1565,345,1220,107232,6357,0.4344,31591,34252,35203,11906,10707,19005,11146,5459,7426,11870,12,119
"Suwannee County, Florida",43653,21469,22184,36214,6051,156,122,29,422,659,0,659,39835,3818,0.4475,19322,20711,21800,9028,11575,13299,17421,,31000,9228,12,121
"Taylor County, Florida",22582,12572,10010,16837,4875,210,108,32,194,326,9,317,21805,777,0.4004,16081,19120,19618,3639,7008,12414,8947,,2039,9487,12,123
"Union County, Florida",15159,9842,5317,11232,3379,64,72,9,199,204,10,194,14338,821,0.4248,12943,14883,14924,12060,6681,44914,25975,,6033,1296,12,125
"Volusia County, Florida",510806,248681,262125,425913,53908,1829,8753,214,9896,10293,1460,8833,447812,62994,0.4639,24834,26413,27741,16012,15588,16303,23033,52854,16941,17954,12,127
"Wakulla County, Florida",31314,17476,13838,25709,4751,183,128,0,144,399,22,377,30162,1152,0.3952,22129,24074,24473,14615,11549,53409,9718,-666666666,22877,12133,12,129
"Walton County, Florida",61528,31164,30364,53493,3067,410,737,98,1964,1759,81,1678,57905,3623,0.4936,28475,30707,31091,15412,11134,13640,21912,8879,13254,15141,12,131
"Washington County, Florida",24627,13426,11201,19719,3873,300,34,86,89,526,42,484,23780,847,0.4461,18239,20363,20729,10890,9154,20610,3991,17573,18348,5167,12,133
"Appling County, Georgia",18410,8971,9439,14194,3357,89,149,0,416,205,0,205,16688,1722,0.4549,19607,21965,23260,9033,11832,2583,21817,-666666666,8558,11833,13,001
"Atkinson County, Georgia",8268,4244,4024,5910,1496,58,0,0,740,64,35,29,6222,2046,0.4977,19002,19261,21769,9809,23574,4195,-666666666,-666666666,9961,6150,13,003
"Bacon County, Georgia",11251,5597,5654,8860,1735,0,42,35,391,188,44,144,10325,926,0.4269,18299,19717,20483,12205,12804,-666666666,15764,,18247,6113,13,005
"Baker County, Georgia",3250,1577,1673,1782,1347,11,27,16,57,10,0,10,3035,215,0.4485,23001,28533,27811,32085,15286,,,,,,13,007
"Baldwin County, Georgia",45808,22995,22813,24874,19087,111,702,61,400,573,123,450,44813,995,0.5168,19147,22854,23001,12414,14895,29212,18796,,6821,8765,13,009
"Banks County, Georgia",18336,9276,9060,17147,449,59,234,0,163,284,50,234,17172,1164,0.3978,18890,19162,19610,12467,19624,,13218,-666666666,20901,7996,13,011
"Barrow County, Georgia",73340,36165,37175,58575,8266,225,2558,0,2053,1663,272,1391,66297,7043,0.4010,21978,23427,24180,14195,17338,8246,15657,-666666666,15615,13454,13,013
"Bartow County, Georgia",101942,50533,51409,85010,11163,536,848,0,3187,1198,291,907,93789,8153,0.4241,23376,24876,25122,15887,17262,20479,18789,-666666666,9946,14182,13,015
"Ben Hill County, Georgia",17405,8396,9009,10427,6269,0,17,5,410,277,179,98,16351,1054,0.4954,15311,19027,19769,7364,9433,-666666666,,,15494,9111,13,017
"Berrien County, Georgia",18986,9394,9592,16000,2123,93,170,0,190,410,161,249,18064,922,0.4400,17007,18214,18258,11357,12247,8796,5282,-666666666,14294,2518,13,019
"Bibb County, Georgia",154194,72823,81371,64747,83092,196,2846,71,837,2405,202,2203,149398,4796,0.5200,22175,31937,32847,14427,14823,33542,26697,,10678,11522,13,021
"Bleckley County, Georgia",12835,5911,6924,8914,3563,9,16,0,162,171,95,76,12502,333,0.5077,19511,25248,25310,8102,6376,,,-666666666,,9042,13,023
"Brantley County, Georgia",18403,9119,9284,17390,526,11,232,36,13,195,0,195,18011,392,0.4204,17320,17509,17743,3755,10608,,30258,,7608,3898,13,025
"Brooks County, Georgia",15645,7540,8105,9355,5611,14,129,8,371,157,40,117,14767,878,0.4623,19665,24286,25209,9098,12683,,10995,,16609,10159,13,027
"Bryan County, Georgia",34104,17013,17091,26736,5183,191,615,0,351,1028,135,893,31906,2198,0.4336,29056,30900,31390,20019,24688,32083,14322,-666666666,26549,12228,13,029
"Bulloch County, Georgia",73141,36097,37044,48299,20862,202,1086,23,1031,1638,246,1392,70483,2658,0.4912,19544,22637,22852,15994,13140,2824,27708,,19833,6599,13,031
"Burke County, Georgia",22838,10941,11897,10961,11238,8,60,0,429,142,36,106,22158,680,0.4728,18667,25084,25270,14205,12527,,25227,-666666666,14146,20301,13,033
"Butts County, Georgia",23479,12469,11010,16273,6645,14,134,18,206,189,32,157,22755,724,0.4424,19529,22372,22384,21193,12612,46164,46256,,5673,13961,13,035
"Calhoun County, Georgia",6443,3882,2561,2192,3864,1,51,0,204,131,0,131,6147,296,0.5821,16778,18398,18654,6527,16994,,,-666666666,,9363,13,037
"Camden County, Georgia",52092,26946,25146,38815,9496,286,686,57,683,2069,205,1864,48907,3185,0.4057,24368,26356,26822,20062,18835,17176,24400,64435,28912,10842,13,039
"Candler County, Georgia",10962,5410,5552,7408,2631,66,257,0,501,99,3,96,9750,1212,0.5009,17750,18568,19503,7508,17962,33400,5625,-666666666,11133,5414,13,043
"Carroll County, Georgia",113756,55651,58105,85742,20904,326,972,81,3119,2612,398,2214,106291,7465,0.4519,22002,24474,24919,14981,15178,14191,17654,30270,12892,8676,13,045
"Catoosa County, Georgia",65645,31839,33806,61190,1684,123,952,16,492,1188,53,1135,63877,1768,0.4022,23834,24330,24422,19259,18119,18085,16172,,21274,14303,13,047
"Charlton County, Georgia",12968,6695,6273,8691,3433,115,48,0,388,293,102,191,11828,1140,0.4166,18693,20608,21383,9785,16607,3967,19906,-666666666,8755,5081,13,049
"Chatham County, Georgia",282613,136383,146230,150695,112500,740,7270,293,3927,7188,1263,5925,265518,17095,0.4760,27204,34742,35735,19563,18419,17907,25341,25291,17238,15031,13,051
"Chattahoochee County, Georgia",11882,8023,3859,8309,2193,94,381,25,338,542,82,460,10121,1761,0.3843,19708,20869,21262,17988,18349,9965,19952,18544,14116,12472,13,053
"Chattooga County, Georgia",25046,13032,12014,21724,2686,27,153,18,206,232,62,170,23889,1157,0.4516,17381,18607,19103,8747,8683,13867,18696,,12113,8681,13,055
"Cherokee County, Georgia",230629,113565,117064,200053,14934,558,4006,12,6352,4714,953,3761,207820,22809,0.4130,32002,33315,34827,14907,27264,14412,26396,,14347,21979,13,057
"Clarke County, Georgia",122037,58029,64008,77967,33245,254,5334,41,2887,2309,183,2126,109199,12838,0.5341,20195,23364,25244,9755,14932,32007,14156,9354,8817,16036,13,059
"Clay County, Georgia",3068,1471,1597,900,1912,0,0,0,12,244,237,7,2913,155,0.4670,13533,26609,26718,,8580,-666666666,-666666666,-666666666,,4776,13,061
"Clayton County, Georgia",270269,127718,142551,52955,184017,607,14025,22,12513,6130,721,5409,234763,35506,0.4226,18728,19257,24640,12094,19348,9266,18071,,12587,10523,13,063
"Clinch County, Georgia",6814,3418,3396,4570,1826,42,37,0,231,108,9,99,6508,306,0.5458,16912,19899,20168,1150,11652,,,-666666666,,12608,13,065
"Cobb County, Georgia",728388,352083,376305,441994,194744,1494,36668,439,33979,19070,3082,15988,636467,91921,0.4534,34891,40987,43714,17420,25817,24523,37240,27001,14528,19044,13,067
"Coffee County, Georgia",43042,22025,21017,28964,12104,49,342,0,1240,343,46,297,38289,4753,0.5031,18060,21876,23533,9444,10099,,8965,-666666666,10590,11844,13,069
"Colquitt County, Georgia",46002,22919,23083,30679,10244,181,383,12,3594,909,116,793,37467,8535,0.4664,17477,20195,21750,10645,12809,9506,7508,,10724,11033,13,071
"Columbia County, Georgia",139904,68243,71661,105145,23253,502,5595,0,1368,4041,274,3767,131449,8455,0.4148,31004,32596,33428,19221,25493,28511,37544,-666666666,16189,17575,13,073
"Cook County, Georgia",17103,8313,8790,11852,4790,73,26,0,261,101,0,101,16106,997,0.4560,17564,19981,20531,10891,12007,22379,,-666666666,10166,16709,13,075
"Coweta County, Georgia",135625,66160,69465,103978,23913,169,2225,36,1900,3404,156,3248,126633,8992,0.4249,29769,31924,32763,19266,22212,24493,41072,58375,23477,13109,13,077
"Crawford County, Georgia",12483,6398,6085,9250,2870,28,97,0,22,216,37,179,12384,99,0.4702,22183,23116,23159,23939,18365,40632,48474,-666666666,36432,17331,13,079
"Crisp County, Georgia",23061,10784,12277,12384,9935,15,295,63,72,297,0,297,22312,749,0.5386,19943,27628,28465,13001,10991,,15044,,,8626,13,081
"Dade County, Georgia",16356,7990,8366,15568,105,45,245,95,75,223,32,191,16007,349,0.4414,21997,22355,22404,14686,7824,,25254,,19723,6277,13,083
"Dawson County, Georgia",22939,11329,11610,21843,159,37,81,0,387,432,62,370,22035,904,0.4588,29958,30545,31040,12300,31918,21949,21980,-666666666,17966,12470,13,085
"Decatur County, Georgia",27237,13219,14018,14349,11423,77,124,0,1073,191,29,162,25704,1533,0.5220,18972,24850,25303,11841,11998,32539,27184,-666666666,12141,22145,13,087
"DeKalb County, Georgia",723902,344188,379714,252162,392967,3319,43017,55,15915,16467,2432,14035,660729,63173,0.4916,30517,46636,52565,14701,21694,12614,28064,34836,13156,20989,13,089
"Dodge County, Georgia",20995,11107,9888,14019,5851,3,118,0,338,666,7,659,20264,731,0.4483,18481,22271,22523,9786,11138,,31723,-666666666,8838,5844,13,091
"Dooly County, Georgia",14089,7691,6398,6224,6915,2,14,0,675,259,102,157,13065,1024,0.4385,16109,21814,22208,10557,11810,,,-666666666,12302,4209,13,093
"Dougherty County, Georgia",92326,42785,49541,25715,63267,134,777,21,898,1514,161,1353,89979,2347,0.5229,20403,33238,33175,23162,15453,33903,25345,,9986,11954,13,095
"Douglas County, Georgia",138283,66287,71996,68460,60118,250,2273,0,4376,2806,292,2514,125838,12445,0.4132,24471,26940,28340,13416,22440,12333,35515,-666666666,12947,17856,13,097
"Early County, Georgia",10480,4822,5658,4915,5289,3,67,0,165,41,0,41,10264,216,0.4858,17338,24004,23919,15000,11490,,,-666666666,11731,13422,13,099
"Echols County, Georgia",4025,1911,2114,3119,82,55,0,0,636,133,6,127,2829,1196,0.4527,17989,18990,21097,12031,28418,17638,-666666666,-666666666,14994,2547,13,101
"Effingham County, Georgia",55852,27755,28097,46166,7316,44,510,71,489,1256,40,1216,53796,2056,0.3810,25553,26827,27228,18170,19130,27111,44779,,17881,11421,13,103
"Elbert County, Georgia",19394,9234,10160,12933,5885,0,65,0,441,70,0,70,18342,1052,0.4990,21039,25259,26029,9220,12815,-666666666,14514,-666666666,9661,10637,13,105
"Emanuel County, Georgia",22723,11166,11557,13871,7730,7,77,0,622,416,12,404,21708,1015,0.4686,16681,20387,20714,7330,11336,,,-666666666,9574,5595,13,107
"Evans County, Georgia",10733,5037,5696,6388,3163,1,80,0,978,123,1,122,9483,1250,0.4639,20710,25888,26473,9227,14488,,26833,-666666666,8084,8336,13,109
"Fannin County, Georgia",24017,11646,12371,23336,47,74,148,24,18,370,4,366,23534,483,0.4516,22425,22747,22912,15610,5432,14746,4697,,17061,14283,13,111
"Fayette County, Georgia",109495,52974,56521,76936,22916,368,4745,85,1655,2790,401,2389,101842,7653,0.4313,38493,41215,42559,22513,34797,27755,31591,10948,21308,17980,13,113
"Floyd County, Georgia",96199,46869,49330,73768,13982,190,1319,0,5192,1748,266,1482,86289,9910,0.4618,22284,24637,25502,11469,14402,8537,33724,-666666666,10166,14878,13,115
"Forsyth County, Georgia",203841,101074,102767,171379,5984,393,19123,29,2886,4047,521,3526,184720,19121,0.4101,37686,38312,39986,20344,31147,19149,41409,21724,14470,21731,13,117
"Franklin County, Georgia",22188,10857,11331,19082,2099,8,152,0,573,274,2,272,21232,956,0.4655,18642,19874,19777,16240,12868,,5319,-666666666,10699,1477,13,119
"Fulton County, Georgia",996757,483429,513328,450929,439282,4072,64202,396,14135,23741,3148,20593,922804,73953,0.5417,39101,58380,62635,21022,20792,19540,41748,27012,20000,19490,13,121
"Gilmer County, Georgia",28956,14535,14421,26184,248,710,194,0,1248,372,52,320,25787,3169,0.4454,22893,24217,24455,13247,11302,5521,9113,-666666666,13569,9034,13,123
"Glascock County, Georgia",3053,1491,1562,2701,207,15,0,0,9,121,11,110,3006,47,0.3849,19037,20246,20420,2168,13261,,-666666666,-666666666,,,13,125
"Glynn County, Georgia",82623,38982,43641,55315,21014,323,940,109,2329,2593,483,2110,77196,5427,0.4961,27819,33693,34495,15751,14561,22646,49306,30611,14974,14225,13,127
"Gordon County, Georgia",56079,27736,28343,50346,2336,537,606,13,1442,799,132,667,47670,8409,0.4404,20009,20750,22180,11144,15697,21277,17892,,8352,7324,13,129
"Grady County, Georgia",25145,12447,12698,16546,7214,111,137,49,730,358,7,351,22467,2678,0.4613,17764,20761,22487,5687,11873,14245,43228,,4185,9221,13,131
"Greene County, Georgia",16535,8036,8499,9882,5990,6,134,0,374,149,40,109,15515,1020,0.5680,31485,43934,45803,11085,13213,4700,22154,-666666666,4777,16954,13,133
"Gwinnett County, Georgia",874242,427930,446312,451951,228057,2909,97394,361,70576,22994,3950,19044,694608,179634,0.4267,26749,31901,36570,14546,23225,17629,23996,14548,13466,14235,13,135
"Habersham County, Georgia",43724,20741,22983,38118,1433,40,1058,63,2247,765,50,715,37711,6013,0.4324,19171,20294,21364,10583,8202,18968,24356,,8207,10411,13,137
"Hall County, Georgia",190482,94865,95617,158201,14240,425,3366,27,10605,3618,702,2916,138328,52154,0.4464,24099,25841,30392,12380,16395,17794,25593,,12107,12808,13,139
"Hancock County, Georgia",8747,4939,3808,2128,6420,0,56,0,128,15,0,15,8578,169,0.4995,13898,25082,25575,,10556,-666666666,6054,-666666666,,,13,141
"Haralson County, Georgia",28667,13977,14690,26354,1362,84,234,0,239,394,67,327,28247,420,0.4508,21838,22242,22317,18405,17169,46488,24904,-666666666,16941,6891,13,143
"Harris County, Georgia",32992,16487,16505,26115,5206,49,338,0,197,1087,166,921,31956,1036,0.4320,30703,33706,33825,26529,19758,,23328,-666666666,44102,8977,13,145
"Hart County, Georgia",25518,12561,12957,19731,4862,12,255,5,469,184,0,184,24599,919,0.4663,20866,22910,23263,9081,14371,,15330,,10954,8232,13,147
"Heard County, Georgia",11571,5739,5832,9899,1215,5,53,0,1,398,0,398,11500,71,0.4046,20494,21471,21527,11555,17582,18620,15515,-666666666,,5828,13,149
"Henry County, Georgia",214171,102486,111685,110858,86207,98,6913,30,3144,6921,1249,5672,200679,13492,0.4011,25727,28330,28979,18108,24061,42457,21632,,14534,13723,13,151
"Houston County, Georgia",149137,72545,76592,92425,44074,517,4263,80,2829,4949,952,3997,139524,9613,0.4272,25289,28811,29618,16741,20567,15389,18320,19320,18242,12702,13,153
"Irwin County, Georgia",9365,4797,4568,6458,2616,0,8,0,14,269,32,237,9258,107,0.5188,18514,21357,21544,5479,13317,-666666666,,-666666666,,,13,155
"Jackson County, Georgia",62131,30638,31493,54589,4335,135,1121,21,950,980,84,896,57812,4319,0.4320,23982,25163,25742,15263,17249,19941,15497,,10038,12192,13,157
"Jasper County, Georgia",13571,6604,6967,10258,2779,14,75,0,207,238,0,238,13048,523,0.4371,20685,22317,22873,7984,16142,,21056,-666666666,12804,10203,13,159
"Jeff Davis County, Georgia",14953,7192,7761,11663,2463,10,0,0,650,167,102,65,13245,1708,0.4447,17981,19140,20103,8948,15492,,-666666666,-666666666,9908,5298,13,161
"Jefferson County, Georgia",16201,7835,8366,7000,8760,24,33,0,150,234,141,93,15643,558,0.4868,16986,22994,23655,3611,12732,,15382,-666666666,5181,5693,13,163
"Jenkins County, Georgia",9055,4456,4599,5653,3109,31,24,0,59,179,0,179,8702,353,0.5106,18288,21403,21835,12355,13999,,,-666666666,,,13,165
"Johnson County, Georgia",9694,5141,4553,6267,3272,0,59,0,2,94,0,94,9470,224,0.4476,16693,19433,20084,1684,12012,-666666666,,-666666666,,,13,167
"Jones County, Georgia",28701,13910,14791,20963,7092,60,193,0,64,329,12,317,28308,393,0.4436,26602,27050,26810,38572,25811,29265,25884,-666666666,8333,18571,13,169
"Lamar County, Georgia",18195,8767,9428,11996,5359,15,128,0,16,681,81,600,17795,400,0.4564,19143,23341,23291,20340,11204,,15792,-666666666,,8599,13,171
"Lanier County, Georgia",10382,5247,5135,7640,2606,0,29,0,25,82,0,82,9836,546,0.4802,17403,20225,20368,18773,9240,-666666666,,-666666666,29216,14984,13,173
"Laurens County, Georgia",47802,22691,25111,29096,17500,28,527,0,253,398,87,311,46598,1204,0.5215,19826,23540,23834,13812,13872,,27830,-666666666,3275,10906,13,175
"Lee County, Georgia",29134,14605,14529,21842,5679,22,693,0,218,680,35,645,28355,779,0.4270,28175,30946,31120,24229,20900,,13751,-666666666,22265,16542,13,177
"Liberty County, Georgia",63949,32636,31313,29913,26397,297,1385,307,2643,3007,478,2529,56243,7706,0.4125,20065,21209,21758,16573,20112,22496,21514,21601,16678,10186,13,179
"Lincoln County, Georgia",7712,3606,4106,5134,2497,0,19,2,11,49,0,49,7603,109,0.4849,23582,27601,27873,13033,15518,-666666666,,,,24714,13,181
"Long County, Georgia",17243,8627,8616,11180,3944,32,133,39,847,1068,22,1046,15212,2031,0.3780,19176,19997,20862,11499,20913,11666,,22364,9813,11853,13,183
"Lowndes County, Georgia",113898,55878,58020,66019,41468,182,2120,44,1716,2349,358,1991,107843,6055,0.4878,20428,24768,25503,10942,14315,39781,25650,31402,9971,7592,13,185
"Lumpkin County, Georgia",31094,15371,15723,29407,595,235,118,0,181,558,25,533,29664,1430,0.4768,21814,22455,22847,12405,4949,20629,13942,-666666666,13708,10803,13,187
"McDuffie County, Georgia",21558,10084,11474,11926,8796,0,49,134,385,268,0,268,20957,601,0.4691,19497,24409,24688,8240,13422,-666666666,88527,,,18067,13,189
"McIntosh County, Georgia",13941,6865,7076,8612,4898,25,25,17,151,213,10,203,13746,195,0.4349,23826,28418,28468,18498,16073,,,,18846,14438,13,191
"Macon County, Georgia",13846,7702,6144,4822,8188,67,233,1,392,143,29,114,13290,556,0.4839,14039,21146,22031,6030,9901,,35589,,5899,4574,13,193
"Madison County, Georgia",28362,14038,14324,24028,2468,113,339,0,967,447,106,341,27047,1315,0.4286,21883,22551,22739,7776,17392,29806,61829,-666666666,8962,6440,13,195
"Marion County, Georgia",8646,4246,4400,5129,3126,0,15,52,169,155,0,155,8505,141,0.4421,17522,19678,19678,27240,14196,-666666666,,,21833,8108,13,197
"Meriwether County, Georgia",21195,10224,10971,12066,8464,24,135,0,168,338,11,327,21006,189,0.4893,19626,23328,23404,11111,15354,,14147,-666666666,6212,4513,13,199
"Miller County, Georgia",5911,2839,3072,4064,1796,38,0,0,6,7,0,7,5905,6,0.5028,21093,26056,26056,,9929,,-666666666,-666666666,,,13,201
"Mitchell County, Georgia",22778,11847,10931,11212,10842,37,95,6,274,312,10,302,21780,998,0.4596,15027,19212,20013,8317,11084,,8380,,11800,6594,13,205
"Monroe County, Georgia",27044,13551,13493,19801,6463,52,247,0,212,269,122,147,26416,628,0.5217,29053,30910,31038,16360,13637,,26837,-666666666,363891,4779,13,207
"Montgomery County, Georgia",9005,4610,4395,6222,2368,33,31,0,276,75,0,75,8431,574,0.4826,19131,22200,23081,8084,12701,,,-666666666,10783,11399,13,209
"Morgan County, Georgia",17943,8612,9331,13309,4239,10,7,0,87,291,45,246,17387,556,0.4468,26298,29245,29610,16688,17841,,,-666666666,14433,18927,13,211
"Murray County, Georgia",39358,19520,19838,38067,387,21,164,0,400,319,0,319,33862,5496,0.4048,17856,18081,19151,11214,10898,22552,11576,-666666666,11953,9819,13,213
"Muscogee County, Georgia",200303,98284,102019,90769,90256,699,4783,395,5275,8126,1266,6860,185498,14805,0.4943,23747,31236,32256,16864,17551,25887,29505,11131,14496,11959,13,215
"Newton County, Georgia",103901,49424,54477,54902,44682,392,1063,0,487,2375,381,1994,98804,5097,0.4170,22478,25118,25726,15624,19887,6948,24335,-666666666,15059,13437,13,217
"Oconee County, Georgia",35071,17207,17864,31250,2056,24,1346,2,102,291,62,229,33441,1630,0.4566,37054,37677,38381,21827,19862,,52351,,30574,9690,13,219
"Oglethorpe County, Georgia",14743,7397,7346,11598,2464,20,79,0,201,381,0,381,14153,590,0.3928,20987,22644,22939,14153,16261,16955,20366,-666666666,8732,7921,13,221
"Paulding County, Georgia",149830,72973,76857,115242,27438,304,1498,100,2040,3208,463,2745,141396,8434,0.3980,25655,27300,27609,17823,21147,28749,24397,14110,18974,10029,13,223
"Peach County, Georgia",26907,13007,13900,12933,12179,22,301,19,1233,220,9,211,24957,1950,0.4480,20746,27124,27961,9641,15694,,11081,,9231,1728,13,225
"Pickens County, Georgia",29992,14904,15088,28732,359,12,174,12,246,457,0,457,29079,913,0.4375,28637,29210,28778,38168,18713,,15885,31600,18782,11097,13,227
"Pierce County, Georgia",19030,9564,9466,16442,1572,64,49,0,373,530,77,453,18060,970,0.4994,23470,25402,25666,14237,12254,4289,,-666666666,18026,3511,13,229
"Pike County, Georgia",17843,8753,9090,15693,1872,0,83,0,27,168,0,168,17587,256,0.4298,23783,24957,25043,18446,16000,-666666666,11775,-666666666,6874,9418,13,231
"Polk County, Georgia",41263,20107,21156,31671,5069,59,241,11,3403,809,21,788,35976,5287,0.4856,21582,23703,24557,11553,17546,,15002,,11724,8577,13,233
"Pulaski County, Georgia",11460,4756,6704,7230,3873,0,0,0,136,221,50,171,10922,538,0.4536,17587,22207,23225,7796,9492,-666666666,-666666666,-666666666,,13398,13,235
"Putnam County, Georgia",21259,10526,10733,14377,5564,8,93,0,875,342,0,342,19877,1382,0.4515,25164,30235,30327,19465,15379,,7957,-666666666,15315,1270,13,237
"Quitman County, Georgia",2095,1045,1050,1031,1025,10,12,5,0,12,0,12,2074,21,0.4624,18499,22744,23217,,13946,,,,-666666666,,13,239
"Rabun County, Georgia",16312,8066,8246,15051,346,65,111,0,528,211,23,188,15004,1308,0.5090,24374,25516,25834,18219,9425,8912,11297,-666666666,8494,18813,13,241
"Randolph County, Georgia",7224,3734,3490,2566,4518,0,132,0,3,5,0,5,7184,40,0.6265,26198,25934,25610,82518,26087,-666666666,,-666666666,,,13,243
"Richmond County, Georgia",201418,97454,103964,77645,112308,659,3392,467,2224,4723,611,4112,192085,9333,0.4842,20956,28382,29196,16204,16247,15025,24147,6385,17056,12670,13,245
"Rockdale County, Georgia",87569,41424,46145,38222,44299,91,1736,203,1236,1782,200,1582,78795,8774,0.4152,23003,25381,28473,11822,21685,56515,21997,,14537,12307,13,247
"Schley County, Georgia",5089,2513,2576,3600,1371,0,0,0,75,43,2,41,4846,243,0.4888,21202,25350,25457,13619,11655,-666666666,-666666666,-666666666,4715,7081,13,249
"Screven County, Georgia",14114,6910,7204,7901,5881,51,31,0,29,221,71,150,13868,246,0.4868,19801,24679,24734,16504,13901,17814,15045,-666666666,14210,4292,13,251
"Seminole County, Georgia",8696,4140,4556,5428,2980,0,35,0,166,87,9,78,8439,257,0.5005,21484,27137,27191,8517,12559,-666666666,,-666666666,3660,7623,13,253
"Spalding County, Georgia",64006,31064,32942,40309,21101,284,616,14,728,954,68,886,61217,2789,0.4553,19899,23853,24334,12356,12723,19575,44638,,5030,7320,13,255
"Stephens County, Georgia",25584,12114,13470,21550,3234,45,108,0,445,202,18,184,24830,754,0.4801,20125,21964,22150,7107,10227,,4793,-666666666,6473,18866,13,257
"Stewart County, Georgia",5791,3528,2263,1689,2751,18,135,0,1061,137,79,58,4495,1296,0.4817,13883,24775,24842,11852,9200,,5529,-666666666,9742,14904,13,259
"Sumter County, Georgia",31070,14699,16371,13095,16159,70,388,0,775,583,145,438,29430,1640,0.4894,18487,27675,28177,11667,11891,29996,13883,-666666666,5989,13193,13,261
"Talbot County, Georgia",6373,3043,3330,2672,3648,4,29,0,5,15,0,15,6232,141,0.4923,20366,27518,27951,21591,15156,,,-666666666,,,13,263
"Taliaferro County, Georgia",1904,970,934,668,1219,0,8,0,5,4,0,4,1823,81,0.4301,15469,17072,18729,6305,14584,-666666666,,-666666666,,,13,265
"Tattnall County, Georgia",25260,14743,10517,15347,7365,94,53,0,1729,672,416,256,22514,2746,0.4651,15632,20293,20628,9830,8071,8429,36658,-666666666,11343,2442,13,267
"Taylor County, Georgia",8354,4028,4326,4866,3259,0,62,0,142,25,8,17,8167,187,0.4913,17321,20792,20880,7108,12782,-666666666,,-666666666,7669,,13,269
"Telfair County, Georgia",16405,9452,6953,9482,6623,4,2,0,237,57,12,45,14027,2378,0.4354,12440,16022,18469,3012,7036,,,-666666666,17606,22989,13,271
"Terrell County, Georgia",9132,4313,4819,3339,5697,3,21,0,28,44,3,41,8896,236,0.4751,17246,26496,26399,14192,11841,,48771,-666666666,15321,,13,273
"Thomas County, Georgia",44977,21310,23667,27206,16199,28,335,0,211,998,14,984,43431,1546,0.4987,22178,27268,27801,15352,14412,25886,20893,-666666666,11199,12125,13,275
"Tift County, Georgia",40691,19224,21467,26005,11953,44,557,15,1501,616,59,557,36165,4526,0.5052,20642,24443,26120,10076,13564,,43189,,6478,11350,13,277
"Toombs County, Georgia",27160,12685,14475,17466,6860,0,257,0,1937,640,122,518,24071,3089,0.5231,20309,24868,25786,8781,13190,-666666666,8999,-666666666,9339,9939,13,279
"Towns County, Georgia",10976,5211,5765,10595,137,84,17,0,28,115,0,115,10718,258,0.4387,21671,22141,22245,11855,6912,12236,,-666666666,7196,9150,13,281
"Treutlen County, Georgia",6711,3296,3415,4590,2085,0,0,0,16,20,0,20,6595,116,0.4585,21307,25618,25823,13760,11831,-666666666,-666666666,-666666666,,,13,283
"Troup County, Georgia",69314,33253,36061,41555,24028,54,1241,10,847,1579,225,1354,66800,2514,0.4854,21942,25700,26105,14561,15628,38217,37654,,17219,8916,13,285
"Turner County, Georgia",8151,4040,4111,4559,3301,16,112,0,95,68,0,68,7790,361,0.4593,17149,22303,22342,10857,11343,,4233,-666666666,786,,13,287
"Twiggs County, Georgia",8363,4159,4204,4638,3566,17,1,0,0,141,0,141,8322,41,0.5231,18255,21104,21263,,14993,8929,,-666666666,-666666666,8131,13,289
"Union County, Georgia",22033,10784,11249,21373,143,174,168,0,67,108,0,108,21397,636,0.4278,23603,23750,23986,13885,5155,,6998,-666666666,3342,19837,13,291
"Upson County, Georgia",26394,12595,13799,18496,7446,107,177,13,0,155,0,155,25785,609,0.4733,19511,20987,21593,2798,16058,30083,11034,,-666666666,12926,13,293
"Walker County, Georgia",68143,33874,34269,63051,2949,235,294,0,423,1191,233,958,66820,1323,0.4560,21588,22264,22319,11773,15203,6997,24042,-666666666,6651,9161,13,295
"Walton County, Georgia",87436,42594,44842,69320,14627,183,1199,92,740,1275,175,1100,84068,3368,0.4209,24141,26259,26650,13396,15993,18893,22387,31203,10922,11998,13,297
"Ware County, Georgia",35671,17684,17987,23492,10414,201,389,19,728,428,0,428,34331,1340,0.4680,18396,21751,22074,10434,12391,10835,9803,,11736,3864,13,299
"Warren County, Georgia",5504,2563,2941,2067,3299,0,44,7,12,75,37,38,5467,37,0.4658,18381,26998,26998,,13243,-666666666,,,,8083,13,301
"Washington County, Georgia",20680,10436,10244,9346,10952,0,80,0,82,220,3,217,20226,454,0.4713,18662,26913,27794,6096,11905,-666666666,8544,-666666666,11450,10822,13,303
"Wayne County, Georgia",30006,15334,14672,22401,6155,30,60,0,557,803,191,612,28187,1819,0.4576,18663,21080,21474,8741,11552,3690,39947,-666666666,10859,10127,13,305
"Webster County, Georgia",2672,1364,1308,1319,1323,0,0,0,30,0,0,0,2642,30,0.4755,20834,25841,25841,,16314,-666666666,-666666666,-666666666,,-666666666,13,307
"Wheeler County, Georgia",7932,5145,2787,4579,3333,9,0,0,0,11,0,11,7772,160,0.4413,9688,13831,14169,,4022,,-666666666,-666666666,-666666666,,13,309
"White County, Georgia",28140,13642,14498,26542,695,19,69,0,404,411,194,217,27305,835,0.4417,22055,22816,22979,9956,13747,,4804,-666666666,,7983,13,311
"Whitfield County, Georgia",103653,51439,52214,91573,3964,679,1453,0,4197,1787,475,1312,68925,34728,0.4775,21158,22234,26463,12724,16200,4194,18619,-666666666,11569,8042,13,313
"Wilcox County, Georgia",8884,5240,3644,5517,3179,20,21,0,83,64,0,64,8522,362,0.4432,14536,18784,18820,23787,6728,,,-666666666,40134,8358,13,315
"Wilkes County, Georgia",9924,4723,5201,5250,4266,0,76,0,290,42,2,40,9509,415,0.4623,19129,25411,25484,9589,12312,-666666666,27975,-666666666,4675,9986,13,317
"Wilkinson County, Georgia",9312,4454,4858,5515,3564,10,1,8,43,171,0,171,9076,236,0.4298,19173,21524,21422,24226,16388,,,,23756,1831,13,319
"Worth County, Georgia",20988,10226,10762,14471,6167,33,100,0,103,114,21,93,20554,434,0.4427,20068,22619,22886,13365,14366,,19639,-666666666,,8363,13,321
"Hawaii County, Hawaii",193680,96563,97117,64255,1213,684,43217,26517,3230,54564,1191,53373,169653,24027,0.4715,25827,34842,36290,14812,20180,29726,28802,17213,20124,17457,15,001
"Honolulu County, Hawaii",986999,497019,489980,208830,23334,1464,423405,92920,8448,228598,8180,220418,894364,92635,0.4256,32194,43302,45238,21246,31744,25810,34463,19825,29079,23074,15,003
"Kalawao County, Hawaii",91,44,47,29,0,0,22,28,2,10,0,10,88,3,0.3950,45812,56252,56252,36200,-666666666,-666666666,39314,44214,,36330,15,005
"Kauai County, Hawaii",70447,35176,35271,23222,478,314,24606,6809,317,14701,370,14331,62941,7506,0.4234,28791,36723,38414,18738,35223,29339,28852,22026,24183,19173,15,007
"Maui County, Hawaii",162456,81068,81388,57307,846,253,46113,17699,1482,38756,871,37885,144800,17656,0.4421,30599,42885,46000,17873,27516,29849,29097,19421,25312,19599,15,009
"Ada County, Idaho",425798,213344,212454,388813,5253,2439,10624,648,5692,12329,1224,11105,392893,32905,0.4589,30086,30945,31729,18036,24110,18652,28556,17342,15869,16345,16,001
"Adams County, Idaho",3865,2034,1831,3711,8,73,0,8,19,46,0,46,3743,122,0.4134,22741,23164,23353,16063,,11138,-666666666,,,9948,16,003
"Bannock County, Idaho",83815,41777,42038,75560,529,2654,1042,144,1254,2632,326,2306,77137,6678,0.4526,22885,23451,23924,13946,16984,14444,13627,11336,39098,12934,16,005
"Bear Lake County, Idaho",5928,2943,2985,5685,46,17,32,3,84,61,33,28,5685,243,0.4038,22985,23288,23352,13978,10033,,19375,,8412,28202,16,007
"Benewah County, Idaho",9068,4621,4447,7884,21,825,103,24,4,207,13,194,8768,300,0.4210,22055,22904,23127,12590,,13257,48616,13133,,14577,16,009
"Bingham County, Idaho",45261,22611,22650,38511,142,2545,466,22,2349,1226,206,1020,37224,8037,0.3939,20199,21402,22882,11855,3992,12882,24153,,14651,8310,16,011
"Blaine County, Idaho",21427,10824,10603,19717,25,9,243,61,1130,242,13,229,16983,4444,0.4712,34330,35640,40197,14284,8904,,31273,19130,17131,17841,16,013
"Boise County, Idaho",6891,3616,3275,6531,31,127,27,26,16,133,12,121,6631,260,0.4504,28273,28477,28539,32251,56745,19902,78789,,,16571,16,015
"Bonner County, Idaho",41389,20754,20635,39482,43,257,219,63,235,1090,83,1007,40246,1143,0.4547,24507,24861,24981,17203,20012,20668,7739,7113,18072,18530,16,017
"Bonneville County, Idaho",108989,54256,54733,97758,476,399,973,77,6559,2747,483,2264,95472,13517,0.4492,24889,26261,27114,12509,18570,22362,27284,3561,11628,8940,16,019
"Boundary County, Idaho",11141,5646,5495,10445,17,185,44,0,84,366,0,366,10648,493,0.4912,22822,23196,23301,19561,,25765,,-666666666,13056,15016,16,021
"Butte County, Idaho",2592,1374,1218,2537,31,4,0,0,14,6,0,6,2491,101,0.4801,25209,25394,25982,14393,2397,,-666666666,-666666666,,,16,023
"Camas County, Idaho",968,500,468,927,0,3,0,0,36,2,0,2,886,82,0.4927,26544,27381,28412,6574,-666666666,,-666666666,-666666666,,,16,025
"Canyon County, Idaho",202782,100584,102198,180258,842,2059,1685,361,11488,6089,1153,4936,152841,49941,0.4016,18639,19280,21260,11415,16983,11837,26503,9886,12531,12069,16,027
"Caribou County, Idaho",6813,3467,3346,6545,13,13,5,0,93,144,1,143,6450,363,0.3911,25146,25868,26145,16797,,,,-666666666,12528,5210,16,029
"Cassia County, Idaho",23441,11954,11487,21994,44,140,102,7,810,344,13,331,17193,6248,0.3970,18785,19259,21550,12348,,26928,10044,,11114,7742,16,031
"Clark County, Idaho",960,488,472,893,1,0,0,0,40,26,17,9,506,454,0.3751,14622,14886,19342,8932,,-666666666,-666666666,-666666666,8883,,16,033
"Clearwater County, Idaho",8528,4772,3756,8021,18,168,55,32,78,156,0,156,8199,329,0.4110,21316,21879,22216,10728,10772,8764,27480,4316,9963,14099,16,035
"Custer County, Idaho",4185,2122,2063,4105,0,22,1,0,29,28,0,28,4053,132,0.4334,23624,23690,23632,25030,-666666666,14864,,-666666666,22531,22857,16,037
"Elmore County, Idaho",26103,13525,12578,22093,687,433,768,84,1322,716,6,710,21899,4204,0.4211,22045,23343,24557,12965,24836,5397,28164,15602,9728,6321,16,039
"Franklin County, Idaho",13013,6632,6381,12581,37,24,4,16,163,188,16,172,12142,871,0.3780,19985,20232,20673,12101,,,,,10853,10332,16,041
"Fremont County, Idaho",12896,6664,6232,12086,41,62,19,37,331,320,118,202,11307,1589,0.3950,21196,21900,23213,9310,5554,8989,,10135,9582,13145,16,043
"Gem County, Idaho",16853,8260,8593,15803,0,246,129,2,273,400,0,400,15491,1362,0.4153,18745,19164,19674,11211,-666666666,20049,8402,,12723,8877,16,045
"Gooding County, Idaho",15157,7870,7287,13397,12,217,98,11,1044,378,175,203,10769,4388,0.4244,20418,21266,23663,13392,,12892,9980,,14409,13954,16,047
"Idaho County, Idaho",16251,8435,7816,15172,32,491,50,8,91,407,43,364,15744,507,0.3819,19524,19882,20053,11747,10266,12320,14468,,24247,15530,16,049
"Jefferson County, Idaho",27096,13741,13355,24844,18,120,41,51,1312,710,256,454,24286,2810,0.3989,20750,21766,22242,11050,,20831,,25075,10466,5395,16,051
"Jerome County, Idaho",22694,11491,11203,20819,22,260,95,31,1098,369,22,347,15072,7622,0.4009,18214,18679,21852,11596,8800,15143,20772,,12690,9241,16,053
"Kootenai County, Idaho",147716,73116,74600,139060,570,2175,1264,83,684,3880,241,3639,141497,6219,0.4379,26514,27176,27495,16305,8823,19347,24181,10451,18499,11947,16,055
"Latah County, Idaho",38593,19614,18979,35797,274,308,903,25,257,1029,21,1008,37034,1559,0.4640,22717,23468,23796,12958,14341,15602,13794,22028,9726,12024,16,057
"Lemhi County, Idaho",7743,3942,3801,7390,16,82,34,0,32,189,36,153,7512,231,0.4226,21953,22105,22057,22346,,39274,,-666666666,,8720,16,059
"Lewis County, Idaho",3826,1906,1920,3391,3,211,28,1,21,171,27,144,3666,160,0.4537,22589,23520,23794,11750,,12137,23786,,20057,17661,16,061
"Lincoln County, Idaho",5292,2692,2600,4786,0,97,9,0,331,69,32,37,3715,1577,0.3870,18239,19215,21218,12597,-666666666,2905,,-666666666,10364,11700,16,063
"Madison County, Idaho",38114,19220,18894,36048,238,6,388,71,617,746,48,698,35475,2639,0.4970,15103,15540,15873,8784,8158,,13036,13665,6744,4451,16,065
"Minidoka County, Idaho",20331,10251,10080,18358,92,170,89,29,1262,331,45,286,13462,6869,0.4387,22103,23391,27410,12913,7661,12194,19894,,9196,9281,16,067
"Nez Perce County, Idaho",39995,19821,20174,35950,154,2336,341,18,99,1097,42,1055,38566,1429,0.4112,25179,26334,26502,15877,30402,15609,11928,,11416,12629,16,069
"Oneida County, Idaho",4269,2153,2116,4155,0,20,0,0,4,90,20,70,4107,162,0.3811,19073,19356,19599,11717,-666666666,7120,-666666666,-666666666,,8864,16,071
"Owyhee County, Idaho",11356,5826,5530,9677,14,384,18,0,899,364,22,342,8355,3001,0.4543,18135,19513,22143,9286,,10326,24517,-666666666,10128,9908,16,073
"Payette County, Idaho",22773,11394,11379,20919,87,239,322,0,655,551,201,350,18977,3796,0.4429,21700,22505,24058,12621,,22967,6064,-666666666,14810,11359,16,075
"Power County, Idaho",7696,3932,3764,6143,17,333,0,2,1172,29,0,29,5209,2487,0.4053,20431,23295,25558,11366,,11283,-666666666,,7885,16800,16,077
"Shoshone County, Idaho",12551,6287,6264,11886,43,228,54,0,50,290,38,252,12139,412,0.4164,21875,22302,22526,18982,41093,6756,4091,-666666666,60602,10039,16,079
"Teton County, Idaho",10437,5375,5062,9575,18,22,11,0,616,195,53,142,8623,1814,0.4304,29251,30198,32741,13106,,93768,,-666666666,16082,17451,16,081
"Twin Falls County, Idaho",80955,39915,41040,74926,517,980,1272,58,1964,1238,92,1146,68720,12235,0.4251,21682,22381,23660,13146,12799,10809,15009,18247,15366,8714,16,083
"Valley County, Idaho",9897,5121,4776,9781,1,11,11,0,0,93,0,93,9786,111,0.4631,28133,28205,28343,16225,,,,-666666666,-666666666,20989,16,085
"Washington County, Idaho",10035,4975,5060,9141,0,60,61,0,447,326,74,252,8292,1743,0.4195,19559,20218,21718,10624,-666666666,14710,20600,-666666666,10634,14027,16,087
"Adams County, Illinois",66949,32663,34286,62268,2541,172,534,54,387,993,48,945,65990,959,0.4318,26053,26833,26935,14524,14223,9307,36216,,17907,7558,17,001
"Alexander County, Illinois",7051,3462,3589,4365,2388,31,20,0,27,220,62,158,6924,127,0.4671,16067,19279,19396,6722,11587,1371,25795,-666666666,,4113,17,003
"Bond County, Illinois",17137,8736,8401,15560,905,17,217,0,107,331,15,316,16539,598,0.4191,23660,24547,25098,8061,17385,22071,12289,-666666666,18497,8327,17,005
"Boone County, Illinois",53656,26951,26705,46967,1149,172,710,0,3498,1160,388,772,42636,11020,0.4342,27825,28988,31720,13955,27056,,43391,-666666666,15169,12660,17,007
"Brown County, Illinois",6836,4420,2416,5441,1262,2,48,0,3,80,18,62,6587,249,0.4286,21822,26715,27579,5386,2075,,7046,-666666666,,10769,17,009
"Bureau County, Illinois",33822,16657,17165,32130,236,53,266,7,685,445,82,363,30948,2874,0.4246,27332,27889,28778,15249,13845,21398,23705,,17253,12869,17,011
"Calhoun County, Illinois",4962,2496,2466,4892,7,2,7,0,1,53,8,45,4910,52,0.4025,25341,25594,25748,5875,,,,-666666666,,3194,17,013
"Carroll County, Illinois",14793,7366,7427,14193,191,14,89,3,56,247,52,195,14290,503,0.4195,27325,27952,28338,10797,13333,6136,14397,,9109,12103,17,015
"Cass County, Illinois",13068,6638,6430,11748,577,5,37,43,467,191,65,126,10657,2411,0.4237,25010,26293,28852,12334,12227,,26605,,16592,8592,17,017
"Champaign County, Illinois",206420,103115,103305,150806,25974,317,21009,79,2111,6124,516,5608,194841,11579,0.5000,27373,30949,31629,19258,16613,24062,20261,26785,17509,12930,17,019
"Christian County, Illinois",33888,17274,16614,32714,524,87,179,40,44,300,26,274,33376,512,0.4182,23823,24362,24425,18900,3049,6041,12783,,14550,14180,17,021
"Clark County, Illinois",16089,7840,8249,15646,72,6,70,10,94,191,52,139,15862,227,0.4302,25806,25885,25950,18072,9350,,45369,,32866,15460,17,023
"Clay County, Illinois",13466,6642,6824,13173,84,22,37,0,0,150,0,150,13284,182,0.4092,23843,24050,24063,23099,9750,7995,48954,-666666666,-666666666,9737,17,025
"Clinton County, Illinois",37858,19639,18219,35539,1283,96,213,0,204,523,44,479,36704,1154,0.4105,29512,30703,31153,15048,4279,34525,34386,-666666666,31717,6689,17,027
"Coles County, Illinois",52802,25466,27336,49104,1940,120,595,106,92,845,57,788,51578,1224,0.5001,23944,24739,24974,11611,7719,11327,24532,15764,95121,9616,17,029
"Cook County, Illinois",5227575,2535190,2692385,2965530,1248948,14296,357845,1810,515138,124008,33404,90604,3926732,1300843,0.5048,32179,40178,47154,17406,20250,22813,35586,31519,15992,19544,17,031
"Crawford County, Illinois",19441,10046,9395,18055,818,16,71,22,37,422,80,342,19026,415,0.4552,26245,27539,28014,4405,7446,29600,26117,13918,16176,8710,17,033
"Cumberland County, Illinois",10890,5473,5417,10709,20,31,35,18,0,77,0,77,10735,155,0.3989,22786,22851,23111,5185,7260,29765,,,-666666666,23561,17,035
"DeKalb County, Illinois",104458,51767,52691,87701,7187,66,2584,0,4134,2786,463,2323,93292,11166,0.4311,25172,27558,28580,12845,12018,7468,21463,-666666666,12463,6696,17,037
"De Witt County, Illinois",16322,8188,8134,15686,55,12,8,9,192,360,0,360,15929,393,0.4170,28294,28844,29063,8370,7631,56908,,24444,9321,16826,17,039
"Douglas County, Illinois",19770,9743,10027,19096,58,55,135,0,150,276,72,204,18371,1399,0.4254,26309,26650,27345,16420,7276,7276,20634,-666666666,34057,9067,17,041
"DuPage County, Illinois",930514,456361,474153,734032,43791,1972,103084,336,23796,23503,4908,18595,800550,129964,0.4563,40547,42970,46473,20049,26496,26115,38928,24846,19409,21019,17,043
"Edgar County, Illinois",17828,8730,9098,17479,80,20,76,0,1,172,19,153,17630,198,0.4399,25122,25493,25510,18707,4244,9425,17325,-666666666,,2488,17,045
"Edwards County, Illinois",6612,3270,3342,6442,25,0,60,0,0,85,20,65,6551,61,0.4259,25235,25567,25705,1097,,-666666666,29512,-666666666,-666666666,3107,17,047
"Effingham County, Illinois",34356,17210,17146,33551,151,25,205,11,172,241,3,238,33708,648,0.4401,27680,28009,28211,15994,13256,11720,9211,,25458,11124,17,049
"Fayette County, Illinois",22025,11670,10355,20590,985,44,108,0,69,229,43,186,21564,461,0.4266,21665,22701,23050,3212,1622,59843,28205,-666666666,4928,9377,17,051
"Ford County, Illinois",13758,6783,6975,13403,115,54,57,3,25,101,6,95,13364,394,0.4160,25524,25485,25762,15339,12316,40043,63312,,11888,19568,17,053
"Franklin County, Illinois",39503,19434,20069,38420,241,123,222,28,75,394,3,391,38900,603,0.4443,22119,22408,22581,5819,8623,13006,14106,44371,7124,10772,17,055
"Fulton County, Illinois",36047,18804,17243,34017,1291,54,72,32,141,440,32,408,35065,982,0.4160,22969,23826,24156,11118,3502,23976,11522,,16331,17172,17,057
"Gallatin County, Illinois",5325,2512,2813,5131,17,23,17,0,5,132,0,132,5290,35,0.4345,23109,23641,23755,,18524,41991,,-666666666,,2185,17,059
"Greene County, Illinois",13390,6774,6616,13038,147,25,6,0,75,99,0,99,13241,149,0.4228,21916,22271,22374,10905,1359,30768,,-666666666,17552,7367,17,061
"Grundy County, Illinois",50338,25173,25165,47309,808,42,359,0,1148,672,187,485,45754,4584,0.4064,30232,30944,31875,17647,17315,,30378,-666666666,20239,12208,17,063
"Hamilton County, Illinois",8251,4046,4205,8192,41,8,10,0,0,0,0,0,8229,22,0.4368,24309,24414,24480,,3429,,,-666666666,-666666666,-666666666,17,065
"Hancock County, Illinois",18633,9267,9366,18195,91,43,68,3,6,227,30,197,18380,253,0.4005,25647,26023,26179,10389,5137,4365,11393,,,11766,17,067
"Hardin County, Illinois",4173,2126,2047,3904,115,15,31,0,15,93,24,69,4102,71,0.4720,21573,21727,21843,6558,208,,,-666666666,,39855,17,069
"Henderson County, Illinois",6966,3417,3549,6796,7,22,56,0,11,74,7,67,6865,101,0.4194,26504,26907,27026,13811,21514,,8046,-666666666,,5986,17,071
"Henry County, Illinois",49681,24692,24989,46507,908,37,275,13,1191,750,50,700,46975,2706,0.4205,27777,28799,29166,14000,11638,23689,19164,,11426,13526,17,073
"Iroquois County, Illinois",28814,14042,14772,27048,359,12,141,0,954,300,63,237,26987,1827,0.4301,25562,26274,26714,11161,13923,18900,53435,-666666666,9372,13962,17,075
"Jackson County, Illinois",59188,29683,29505,45785,8510,221,2107,12,685,1868,77,1791,56728,2460,0.5375,21948,24266,24531,15240,11956,15457,26359,,18133,7683,17,077
"Jasper County, Illinois",9592,4776,4816,9461,64,13,18,0,0,36,0,36,9469,123,0.3814,25811,25939,26150,9085,7200,,1839,-666666666,-666666666,6197,17,079
"Jefferson County, Illinois",38523,19712,18811,33797,3200,46,443,0,126,911,60,851,37625,898,0.4496,23054,24370,24706,6803,11200,21241,39615,-666666666,14187,9138,17,081
"Jersey County, Illinois",22441,11007,11434,21806,64,36,129,21,28,357,36,321,22156,285,0.4125,26346,26658,26660,26425,6488,,40969,2395,,5028,17,083
"Jo Daviess County, Illinois",22186,11165,11021,21648,89,27,112,20,46,244,23,221,21534,652,0.4259,29892,30181,30512,16945,17003,,36914,9200,8428,13986,17,085
"Johnson County, Illinois",12866,7322,5544,11439,1245,22,32,0,22,106,10,96,12430,436,0.4275,20928,23137,23507,11025,1116,17482,38000,-666666666,10527,12974,17,087
"Kane County, Illinois",526615,261893,264722,381666,29545,1900,19647,122,82248,11487,3181,8306,361501,165114,0.4417,31774,36746,41699,15619,20533,17152,35109,32995,14413,16505,17,089
"Kankakee County, Illinois",111493,54748,56745,89149,16908,334,1192,37,1856,2017,261,1756,100518,10975,0.4194,25111,27471,28990,12982,14606,14113,44795,,14472,8941,17,091
"Kendall County, Illinois",121452,60053,61399,100946,7933,86,3821,0,5704,2962,973,1989,100844,20608,0.3532,31920,33282,35297,19520,32173,,25476,-666666666,19064,16595,17,093
"Knox County, Illinois",51752,26180,25572,44825,4400,119,558,0,1097,753,51,702,48974,2778,0.4467,22939,25033,25420,12929,7461,17533,20926,-666666666,12392,6438,17,095
"Lake County, Illinois",702890,350890,352000,560871,48091,1116,48690,353,25062,18707,3074,15633,556282,146608,0.4844,40655,43817,50860,16737,23708,21760,42316,16404,17994,17051,17,097
"LaSalle County, Illinois",111935,56200,55735,105539,2732,265,754,38,986,1621,236,1385,101809,10126,0.4253,26228,26994,28080,14992,8654,15814,25373,,19533,11940,17,099
"Lawrence County, Illinois",16582,9285,7297,13351,2706,33,43,18,174,257,83,174,15776,806,0.4044,16417,19917,20627,3435,1283,7070,20347,,2351,5120,17,101
"Lee County, Illinois",34718,18344,16374,31520,1767,70,216,61,463,621,176,445,32729,1989,0.4332,27021,28572,29313,10615,7201,17199,49437,53444,8688,9114,17,103
"Livingston County, Illinois",37278,18946,18332,34466,1641,21,255,0,334,561,22,539,35676,1602,0.4328,26777,28208,28768,12453,2267,15743,25585,-666666666,12749,19812,17,105
"Logan County, Illinois",29820,15158,14662,24020,3056,96,179,14,520,1935,38,1897,28825,995,0.4114,23410,27270,27488,7839,2776,18719,20955,18693,3091,14024,17,107
"McDonough County, Illinois",31727,15668,16059,28665,1709,48,642,19,105,539,33,506,30880,847,0.4807,22387,23132,23477,7687,8514,24338,37233,,8773,11664,17,109
"McHenry County, Illinois",307083,152971,154112,283564,4007,268,8191,97,5177,5779,944,4835,269356,37727,0.4004,34589,35408,37436,18599,24091,21151,34598,41277,18809,16285,17,111
"McLean County, Illinois",173254,84335,88919,144534,14247,243,8550,38,1751,3891,587,3304,165147,8107,0.4497,31752,33267,33940,16870,18293,16791,39183,46216,22354,13419,17,113
"Macon County, Illinois",108404,51954,56450,84943,15319,288,1274,2,548,6030,113,5917,106119,2285,0.4660,27010,30337,30624,14980,14350,14828,33116,,19936,12237,17,115
"Macoupin County, Illinois",46482,22939,23543,45088,254,56,224,9,80,771,56,715,45996,486,0.4158,26779,27109,27142,16634,21981,12380,23109,47389,11945,12511,17,117
"Madison County, Illinois",266759,130430,136329,235054,22009,544,2404,89,1017,5642,566,5076,258626,8133,0.4396,29100,30731,31097,16388,16832,21300,25708,65165,21735,11953,17,119
"Marion County, Illinois",38503,18824,19679,35800,1354,71,327,0,194,757,18,739,37816,687,0.4280,23366,24092,24260,11404,16231,17037,19340,-666666666,14746,6378,17,121
"Marshall County, Illinois",12060,6008,6052,11718,44,31,43,5,77,142,4,138,11690,370,0.4022,28279,28669,28980,15066,4570,7839,18137,,9642,17791,17,123
"Mason County, Illinois",13931,6921,7010,13610,104,10,60,9,2,136,0,136,13791,140,0.4312,25166,25516,25552,22042,15388,,16562,,,,17,125
"Massac County, Illinois",14883,7055,7828,13541,955,9,62,0,23,293,61,232,14502,381,0.4510,23673,24352,24657,16583,15566,,11497,-666666666,,17210,17,127
"Menard County, Illinois",12576,6142,6434,12227,87,30,56,28,22,126,0,126,12403,173,0.4349,31323,31848,32211,6769,18808,,,,,9278,17,129
"Mercer County, Illinois",15971,7917,8054,15583,87,13,47,0,67,174,12,162,15635,336,0.3994,27566,27844,28038,14993,22257,29246,25166,-666666666,14712,10799,17,131
"Monroe County, Illinois",33703,16535,17168,32907,99,17,377,0,21,282,30,252,33208,495,0.4133,35699,35971,36158,13672,28675,,18130,-666666666,,28176,17,133
"Montgomery County, Illinois",29301,15308,13993,26345,2347,53,79,11,93,373,57,316,28803,498,0.4421,21072,22894,23024,9369,3182,,38975,,,5266,17,135
"Morgan County, Illinois",34801,17511,17290,31708,2067,19,212,0,59,736,42,694,34006,795,0.4343,25201,26582,27011,6135,12398,,17978,-666666666,3873,5845,17,137
"Moultrie County, Illinois",14915,7246,7669,14656,54,25,18,0,20,142,3,139,14745,170,0.4005,25351,25519,25656,14172,13939,19740,,-666666666,,15923,17,139
"Ogle County, Illinois",52034,25934,26100,49110,540,59,217,2,1201,905,102,803,47044,4990,0.4152,28026,28713,29883,13171,22601,16983,23294,,12586,16276,17,141
"Peoria County, Illinois",186818,90575,96243,137377,32531,579,7027,15,2709,6580,524,6056,178462,8356,0.4662,29055,32440,32950,18167,14643,17744,40476,,18852,22701,17,143
"Perry County, Illinois",21595,11698,9897,19236,1823,27,123,0,38,348,44,304,20957,638,0.4669,22650,24808,25360,6906,3453,,21447,-666666666,,5960,17,145
"Piatt County, Illinois",16469,8145,8324,16036,65,5,76,0,15,272,32,240,16262,207,0.3966,33197,33775,33806,21956,5657,,9039,-666666666,,13025,17,147
"Pike County, Illinois",16054,7999,8055,15531,208,98,53,0,12,152,1,151,15852,202,0.4184,22048,22469,22671,6545,3079,14311,12638,-666666666,,14993,17,149
"Pope County, Illinois",4255,2247,2008,3915,206,13,47,0,35,39,0,39,4171,84,0.4138,21427,22196,22345,5049,9870,,,-666666666,,26572,17,151
"Pulaski County, Illinois",5792,2839,2953,3763,1808,14,14,0,37,156,2,154,5679,113,0.4569,18924,21266,21630,5664,15285,12950,15071,-666666666,,9277,17,153
"Putnam County, Illinois",5746,2912,2834,5595,20,0,21,0,25,85,8,77,5459,287,0.4136,32584,32925,33290,25660,7625,-666666666,25305,-666666666,27680,19314,17,155
"Randolph County, Illinois",32934,18105,14829,28765,3456,52,111,0,161,389,75,314,31950,984,0.4205,23424,25868,26272,10513,3968,28858,32557,-666666666,15166,15653,17,157
"Richland County, Illinois",16072,7913,8159,15604,91,68,105,0,7,197,18,179,15827,245,0.4289,23972,24443,24713,4695,5645,12025,7830,-666666666,,7172,17,159
"Rock Island County, Illinois",146536,72130,74406,120109,14066,431,3320,44,3404,5162,1108,4054,128444,18092,0.4351,26893,29048,30602,16082,16016,19549,30359,84066,17332,10606,17,161
"St. Clair County, Illinois",265569,128153,137416,172396,79402,529,3622,68,2236,7316,581,6735,255561,10008,0.4782,27683,33056,33428,21506,16787,26488,47187,56787,21353,11417,17,163
"Larue County, Kentucky",14127,6917,7210,13086,497,18,46,0,268,212,8,204,13684,443,0.4273,21204,21756,21766,12784,19513,,10180,-666666666,8888,7177,21,123
"Laurel County, Kentucky",59950,29173,30777,58206,370,254,336,0,49,735,176,559,59087,863,0.4614,19383,19513,19539,15490,5166,7004,45526,-666666666,36261,7456,21,125
"Lawrence County, Kentucky",15870,7924,7946,15513,71,5,68,0,8,205,20,185,15742,128,0.4752,18410,18562,18517,19603,9710,,,-666666666,,11060,21,127
"Lee County, Kentucky",6896,3540,3356,6666,47,89,23,0,0,71,0,71,6881,15,0.4976,13873,14251,14252,,396,1406,,-666666666,-666666666,6151,21,129
"Leslie County, Kentucky",10869,5379,5490,10653,44,0,70,0,62,40,5,35,10813,56,0.5006,14653,14279,14279,,,-666666666,87504,-666666666,,24063,21,131
"Letcher County, Kentucky",23382,11444,11938,22999,72,42,46,0,16,207,26,181,23228,154,0.4581,17181,17281,17237,23775,6275,,14783,-666666666,38500,8620,21,133
"Lewis County, Kentucky",13646,6781,6865,13455,55,62,0,0,0,74,0,74,13550,96,0.4864,17753,17897,17952,9834,14022,,-666666666,-666666666,-666666666,6359,21,135
"Lincoln County, Kentucky",24424,11927,12497,23232,558,31,4,8,56,535,162,373,24046,378,0.4632,18720,18804,18740,13194,29700,12281,,,,5835,21,137
"Livingston County, Kentucky",9353,4637,4716,9123,22,49,9,4,1,145,3,142,9212,141,0.4546,24203,23791,24022,7930,15745,,,,,13689,21,139
"Logan County, Kentucky",26757,13151,13606,24252,1691,39,19,2,176,578,41,537,26052,705,0.4387,20385,21360,21638,10481,11752,20113,,,18610,5598,21,141
"Lyon County, Kentucky",8325,4643,3682,7672,465,25,37,0,16,110,18,92,8211,114,0.4549,26105,27366,27331,21668,11188,14016,12354,-666666666,,12381,21,143
"McCracken County, Kentucky",65292,31043,34249,55748,7274,154,479,81,207,1349,116,1233,63784,1508,0.5200,28926,31186,31058,31061,16055,13979,11701,,13434,16456,21,145
"McCreary County, Kentucky",17850,9799,8051,16175,1058,122,33,0,117,345,201,144,17311,539,0.4938,11114,11572,11625,9291,5984,10678,,-666666666,,8284,21,147
"McLean County, Kentucky",9492,4693,4799,9272,20,36,35,0,4,125,23,102,9368,124,0.4025,21623,21852,22032,8355,20935,,,-666666666,,9292,21,149
"Madison County, Kentucky",87324,42491,44833,80101,3892,317,841,70,444,1659,135,1524,85376,1948,0.4516,22271,23016,23108,16144,14003,16061,21978,,7579,10769,21,151
"Magoffin County, Kentucky",12887,6495,6392,12868,4,4,0,0,0,11,0,11,12762,125,0.4570,15710,15700,15725,13164,,,-666666666,-666666666,-666666666,,21,153
"Marion County, Kentucky",19497,9882,9615,17427,1571,0,148,0,149,202,27,175,19017,480,0.4565,20450,21368,21532,13056,11689,-666666666,25239,-666666666,15323,9582,21,155
"Marshall County, Kentucky",31213,15413,15800,30588,181,41,94,0,24,285,64,221,30794,419,0.4307,25138,25472,25571,13359,11962,12295,18849,-666666666,,2875,21,157
"Martin County, Kentucky",12478,6922,5556,11727,633,11,0,8,9,90,0,90,12259,219,0.4735,14938,15496,15664,5137,6325,,-666666666,,,7272,21,159
"Mason County, Kentucky",17229,8535,8694,15677,951,8,127,0,10,456,11,445,16958,271,0.5196,24124,24839,24912,20348,20043,,24494,-666666666,,8436,21,161
"Meade County, Kentucky",28751,14554,14197,26449,1013,199,224,0,87,779,33,746,27645,1106,0.4230,24018,24442,24595,16768,21666,18110,23311,-666666666,16466,15221,21,163
"Menifee County, Kentucky",6345,3334,3011,6260,4,1,13,0,1,66,0,66,6292,53,0.4224,18995,19085,19005,,,,,-666666666,,,21,165
"Mercer County, Kentucky",21411,10599,10812,19858,795,41,110,0,237,370,9,361,20878,533,0.4371,24079,24771,24950,12109,18578,,26807,-666666666,13303,6669,21,167
"Metcalfe County, Kentucky",9983,4882,5101,9448,160,6,44,28,206,91,0,91,9823,160,0.4449,18141,18781,18715,20604,11521,,,,5326,6449,21,169
"Monroe County, Kentucky",10692,5325,5367,10270,275,3,14,0,66,64,0,64,10387,305,0.4879,19969,20179,20383,10979,19619,,,-666666666,8727,1695,21,171
"Montgomery County, Kentucky",27391,13477,13914,25841,815,93,5,20,290,327,0,327,26688,703,0.4532,20437,20842,21043,8283,17154,,,,13051,5144,21,173
"Morgan County, Kentucky",13379,7426,5953,12608,427,10,70,0,23,241,0,241,13197,182,0.4553,16780,17149,17204,8521,6149,,45427,-666666666,,9765,21,175
"Muhlenberg County, Kentucky",31216,15627,15589,28875,1654,75,121,47,31,413,65,348,31041,175,0.4185,19934,20893,20928,3698,9257,,7818,,,5442,21,177
"Nelson County, Kentucky",44875,22161,22714,41111,2413,134,96,0,424,697,64,633,43969,906,0.4542,26353,26371,26564,5697,36869,8136,12996,-666666666,3182,8260,21,179
"Nicholas County, Kentucky",7062,3421,3641,6859,70,18,0,0,53,62,5,57,6935,127,0.4719,22438,22846,21089,110162,12599,,-666666666,-666666666,,,21,181
"Ohio County, Kentucky",24152,11927,12225,23133,535,4,128,0,94,258,0,258,23469,683,0.4610,19963,20326,20555,8289,14203,,,-666666666,,14347,21,183
"Oldham County, Kentucky",63876,33698,30178,58096,2626,122,781,28,710,1513,112,1401,61484,2392,0.4299,35795,36451,37015,16571,21976,18335,67084,16664,24309,25603,21,185
"Owen County, Kentucky",10673,5240,5433,10254,191,19,0,10,160,39,0,39,10401,272,0.4904,22151,22450,22599,8752,11326,9095,-666666666,,8637,64110,21,187
"Owsley County, Kentucky",4552,2037,2515,4295,123,9,34,0,9,82,0,82,4534,18,0.5285,16533,17069,17139,,,,,-666666666,,,21,189
"Pendleton County, Kentucky",14509,7250,7259,14230,113,15,19,0,0,132,8,124,14339,170,0.4238,23578,23663,23712,33284,5582,,,-666666666,-666666666,29598,21,191
"Perry County, Kentucky",27818,13624,14194,26813,385,39,197,110,3,271,4,267,27558,260,0.5076,19697,19596,19661,9248,18744,,36517,22749,,11763,21,193
"Pike County, Kentucky",62791,30796,31995,61232,545,84,323,0,222,385,79,306,62296,495,0.4932,20128,20157,20059,26678,13497,,33164,-666666666,8873,24721,21,195
"Powell County, Kentucky",12387,6073,6314,12002,65,10,33,16,68,193,3,190,12210,177,0.4574,18158,18475,18544,7538,10035,,,,11010,4918,21,197
"Pulaski County, Kentucky",63772,31166,32606,61413,701,164,437,76,311,670,13,657,62292,1480,0.5063,21083,21247,21293,20821,17639,29402,12975,,26793,12674,21,199
"Robertson County, Kentucky",2191,1116,1075,2143,33,3,0,0,0,12,0,12,2158,33,0.5087,22702,22514,22439,,,,-666666666,-666666666,-666666666,,21,201
"Rockcastle County, Kentucky",16893,8257,8636,16521,35,216,4,12,26,79,22,57,16811,82,0.4578,17930,18065,18029,14217,7017,16161,,,,6566,21,203
"Rowan County, Kentucky",24302,11766,12536,23475,321,40,77,0,60,329,0,329,23761,541,0.4802,18743,19130,19238,14551,6933,,,-666666666,,4452,21,205
"Russell County, Kentucky",17684,8652,9032,16938,44,24,75,126,322,155,0,155,17060,624,0.4607,17702,18031,17974,14052,19818,,34220,,8513,8036,21,207
"Scott County, Kentucky",51348,25446,25902,45334,2680,73,547,0,1478,1236,128,1108,49146,2202,0.4121,29345,30871,30997,11811,19710,47581,18033,-666666666,9291,22166,21,209
"Shelby County, Kentucky",44967,21723,23244,39216,3258,24,442,0,912,1115,134,981,40987,3980,0.4370,28502,30133,31807,11296,20567,22021,23146,-666666666,14140,8344,21,211
"Simpson County, Kentucky",17856,8800,9056,15300,1822,154,30,0,276,274,74,200,17479,377,0.4317,21122,22347,22373,8044,16793,12454,25367,-666666666,5489,1691,21,213
"Spencer County, Kentucky",17798,8952,8846,17098,303,11,78,0,16,292,14,278,17461,337,0.3680,27227,27300,27595,11942,30319,,46063,-666666666,,14064,21,215
"Taylor County, Kentucky",25315,12390,12925,23201,1138,0,130,0,70,776,6,770,24778,537,0.4517,18613,19232,19316,10337,16870,-666666666,27512,-666666666,1979,2641,21,217
"Todd County, Kentucky",12465,6230,6235,10785,996,7,6,0,450,221,5,216,11977,488,0.4266,19165,20229,20332,8053,15604,,,-666666666,6897,8086,21,219
"Trigg County, Kentucky",14267,6993,7274,12848,1252,0,63,0,0,104,26,78,14002,265,0.4441,26068,25858,25935,21928,19757,-666666666,23719,-666666666,-666666666,129325,21,221
"Trimble County, Kentucky",8751,4338,4413,8669,0,5,1,0,36,40,2,38,8499,252,0.4322,24515,24426,24769,14695,-666666666,,,-666666666,40278,20490,21,223
"Union County, Kentucky",15065,7775,7290,12687,1926,12,38,0,24,378,0,378,14782,283,0.4240,21063,22940,23118,17573,11676,21658,,-666666666,20888,7875,21,225
"Warren County, Kentucky",121066,59236,61830,99435,11135,398,3917,219,3635,2327,286,2041,115056,6010,0.4582,24060,26019,26332,11049,15505,10815,20518,12479,10399,11910,21,227
"Washington County, Kentucky",12017,5936,6081,10683,707,0,17,0,258,352,119,233,11539,478,0.4139,20834,22106,22206,7056,13722,-666666666,,-666666666,7890,5473,21,229
"Wayne County, Kentucky",20557,10227,10330,19503,492,14,4,13,341,190,2,188,19957,600,0.4477,16104,16360,16401,8763,11337,,,,6771,17048,21,231
"Webster County, Kentucky",13331,6597,6734,12223,595,11,4,10,194,294,107,187,12671,660,0.4439,20117,20511,20802,9114,21077,,,,10784,7536,21,233
"Whitley County, Kentucky",35842,17637,18205,34728,350,59,153,7,117,428,39,389,35444,398,0.4891,17520,17876,17952,6525,4255,15503,4108,,3142,8591,21,235
"Wolfe County, Kentucky",7221,3516,3705,7118,24,35,0,0,16,28,0,28,7201,20,0.5215,14274,14372,14346,,,,-666666666,-666666666,,,21,237
"Woodford County, Kentucky",25591,12297,13294,22996,1203,12,60,8,718,594,47,547,23905,1686,0.4520,30786,32481,33186,13562,21447,,32587,,10521,9014,21,239
"Acadia Parish, Louisiana",62372,30297,32075,49287,11168,27,61,15,634,1180,46,1134,61010,1362,0.4644,20887,23295,23433,11066,12471,20785,,,8189,7791,22,001
"Allen Parish, Louisiana",25619,14808,10811,18797,5050,516,204,0,219,833,128,705,24527,1092,0.4771,20296,23575,24130,4689,12101,15680,12039,-666666666,3259,5344,22,003
"Ascension Parish, Louisiana",117009,58083,58926,86568,25560,68,1057,0,527,3229,48,3181,111070,5939,0.4086,30094,33436,34337,19798,20829,20568,27030,-666666666,23610,16117,22,005
"Saline County, Illinois",24659,12054,12605,22975,831,58,165,9,12,609,31,578,24254,405,0.4621,21917,22773,23057,4024,11477,40476,10907,,,5400,17,165
"Sangamon County, Illinois",198639,95430,103209,163815,25155,246,3519,80,1454,4370,208,4162,194422,4217,0.4565,31904,35214,35278,26116,15591,22383,28811,40766,13767,10615,17,167
"Schuyler County, Illinois",7205,3893,3312,6785,349,7,0,0,0,64,0,64,7184,21,0.3976,24323,25522,25582,6262,3218,,-666666666,-666666666,-666666666,14395,17,169
"Scott County, Illinois",5169,2523,2646,5078,0,20,7,0,7,57,5,52,5109,60,0.4508,25568,25838,26078,4493,-666666666,,,-666666666,,7814,17,171
"Shelby County, Illinois",22011,10930,11081,21656,143,43,77,0,12,80,2,78,21800,211,0.3889,23974,24035,24113,15993,12831,63151,13718,-666666666,,15450,17,173
"Stark County, Illinois",5840,2888,2952,5697,42,0,34,0,0,67,10,57,5766,74,0.4421,28545,28903,29157,5695,11917,-666666666,30288,-666666666,-666666666,7627,17,175
"Stephenson County, Illinois",46283,22383,23900,39890,4310,25,388,0,280,1390,42,1348,44695,1588,0.4265,24529,26032,26485,11103,14645,21420,42531,-666666666,14833,9032,17,177
"Tazewell County, Illinois",135400,66832,68568,129963,1630,242,1258,40,491,1776,220,1556,132405,2995,0.4164,30700,31301,31458,20339,12051,18813,31106,9938,15992,9722,17,179
"Union County, Illinois",17458,8803,8655,16412,124,12,76,0,324,510,21,489,16595,863,0.4450,24296,25181,25562,10266,6012,10392,30263,-666666666,8674,9631,17,181
"Vermilion County, Illinois",79613,39531,40082,65911,10946,186,712,27,555,1276,109,1167,75869,3744,0.4349,22733,24807,25512,11905,12497,7696,24741,,11922,8858,17,183
"Wabash County, Illinois",11587,5649,5938,11192,117,12,145,0,23,98,0,98,11387,200,0.4268,24697,25179,25409,7457,13296,,6204,-666666666,,9102,17,185
"Warren County, Illinois",17611,8488,9123,15836,493,5,382,0,591,304,0,304,16016,1595,0.4274,23350,24618,25480,10648,14523,,10987,-666666666,11968,9681,17,187
"Washington County, Illinois",14369,7253,7116,13896,115,13,72,3,126,144,12,132,14161,208,0.4241,29548,30016,30070,13223,25505,,14629,,5083,18065,17,189
"Wayne County, Illinois",16517,8183,8334,16070,110,27,128,0,1,181,3,178,16391,126,0.4209,24342,24680,24706,21169,3525,12930,8812,-666666666,,19838,17,191
"White County, Illinois",14410,7025,7385,14133,47,15,41,14,2,158,8,150,14222,188,0.4502,25065,25150,25305,12800,5672,,25610,,,22645,17,193
"Whiteside County, Illinois",57155,28128,29027,52983,1135,111,308,17,1400,1201,402,799,50486,6669,0.4185,26155,26684,27647,15988,12396,13413,60257,,23672,11379,17,195
"Will County, Illinois",685378,340422,344956,508499,76513,1466,35170,149,45613,17968,3613,14355,572198,113180,0.4097,32311,34870,36912,18874,25459,24038,39103,28578,18100,12576,17,197
"Williamson County, Illinois",67336,33555,33781,62148,2916,133,665,24,155,1295,115,1180,65704,1632,0.4456,25238,25832,26047,16470,16515,32243,37058,,14519,11152,17,199
"Winnebago County, Illinois",288896,141203,147693,227040,36120,648,7292,64,8759,8973,1368,7605,254457,34439,0.4490,26187,29055,30449,14996,15304,13724,26787,38375,13180,10455,17,201
"Woodford County, Illinois",39123,19428,19695,37882,215,14,306,0,156,550,80,470,38456,667,0.4162,32360,33060,33252,12315,4431,25821,23591,-666666666,11740,5943,17,203
"Adams County, Indiana",34813,17271,17542,33743,247,16,121,0,456,230,64,166,33280,1533,0.4281,21173,21381,21460,17488,2092,,45572,-666666666,15177,8452,18,001
"Allen County, Indiana",365565,178324,187241,290987,42168,731,12228,281,6922,12248,1218,11030,339755,25810,0.4509,26058,28614,29452,13976,16129,16331,23751,10396,11792,10832,18,003
"Bartholomew County, Indiana",80203,40059,40144,69108,1522,205,4585,103,3372,1308,205,1103,75124,5079,0.4285,28631,28836,29093,13657,24859,6512,43380,18553,11487,18948,18,005
"Benton County, Indiana",8709,4341,4368,8516,80,2,18,0,18,75,8,67,8260,449,0.3792,23181,23343,23877,13855,9026,,22222,-666666666,29283,18244,18,007
"Blackford County, Indiana",12364,6135,6229,12036,75,11,38,0,2,202,1,201,12188,176,0.4147,21980,22309,22305,22565,15412,,,-666666666,,8357,18,009
"Boone County, Indiana",61884,30594,31290,58207,807,106,1497,0,149,1118,232,886,60281,1603,0.4816,40487,40448,40667,25444,65533,35047,43881,-666666666,25277,22419,18,011
"Brown County, Indiana",14965,7470,7495,14542,41,10,44,0,5,323,25,298,14735,230,0.4503,30279,30897,31094,13871,4012,,,-666666666,,8175,18,013
"Carroll County, Indiana",20007,9959,10048,19407,90,47,18,3,199,243,48,195,19219,788,0.3910,25647,26026,26433,11200,19166,27066,,,8836,11426,18,015
"Cass County, Indiana",38324,19227,19097,32533,562,122,566,53,3631,857,441,416,32933,5391,0.4249,22625,24375,25028,10795,13556,31595,23758,12240,11863,6345,18,017
"Clark County, Indiana",113993,55492,58501,100506,7917,138,891,15,1253,3273,77,3196,108160,5833,0.4108,25693,26546,26909,18949,23408,9990,20254,,17121,10429,18,019
"Clay County, Indiana",26568,12983,13585,25848,64,38,22,0,57,539,114,425,26224,344,0.4060,22913,23311,23429,6412,7525,11921,36405,-666666666,13556,6855,18,021
"Clinton County, Indiana",32692,16148,16544,30571,357,55,69,42,1177,421,128,293,27880,4812,0.3974,23260,24012,25355,12792,9390,23173,17157,78631,11579,8586,18,023
"Crawford County, Indiana",10582,5358,5224,10322,19,114,14,0,0,113,11,102,10428,154,0.3955,19756,19865,20030,6481,15305,6208,,-666666666,-666666666,23420,18,025
"Daviess County, Indiana",32583,16423,16160,31171,583,6,89,13,479,242,23,219,31075,1508,0.4202,21472,21914,22281,10045,13607,,13340,,7592,15122,18,027
"Dearborn County, Indiana",49552,24770,24782,48123,417,98,207,55,299,353,6,347,48968,584,0.4059,28471,28745,28835,21859,17874,20270,32196,,26530,6432,18,029
"Decatur County, Indiana",26340,13033,13307,25387,149,80,349,0,134,241,83,158,25854,486,0.3806,24175,24406,24559,11394,17144,15651,29103,-666666666,,7637,18,031
"DeKalb County, Indiana",42489,21142,21347,41184,153,36,155,0,266,695,24,671,41345,1144,0.4212,25132,25452,25406,25331,20333,9003,15329,-666666666,22364,11284,18,033
"Delaware County, Indiana",116463,56004,60459,103243,7124,182,1512,94,712,3596,126,3470,113982,2481,0.4583,21566,22372,22528,13613,16717,9105,20693,49005,14654,9666,18,035
"Dubois County, Indiana",42345,21183,21162,40218,177,40,280,0,1300,330,57,273,39514,2831,0.4174,27331,28376,28847,11515,3957,,7009,-666666666,7778,8802,18,037
"Elkhart County, Indiana",201640,99741,101899,176160,11296,379,2186,100,5855,5664,988,4676,171388,30252,0.4160,22387,23613,25409,12080,13693,22283,29435,21033,13661,7928,18,039
"Fayette County, Indiana",23608,11644,11964,22721,578,0,40,0,159,110,15,95,23377,231,0.4405,21716,22046,22087,14110,12111,-666666666,19403,-666666666,16482,12437,18,041
"Floyd County, Indiana",76290,36917,39373,68841,3937,269,810,0,795,1638,70,1568,74020,2270,0.4495,29350,30886,31039,17456,16174,21837,25423,-666666666,9041,9513,18,043
"Fountain County, Indiana",16741,8409,8332,16356,67,54,28,0,55,181,0,181,16346,395,0.4380,25086,25522,25766,12524,5724,6174,,-666666666,,5127,18,045
"Franklin County, Indiana",22887,11456,11431,22410,76,32,183,0,48,138,39,99,22637,250,0.4067,24748,24893,25007,14800,12480,39884,,-666666666,44840,23278,18,047
"Fulton County, Indiana",20412,10089,10323,19256,184,64,111,12,530,255,60,195,19418,994,0.4300,23507,23735,23939,12315,17157,10517,93114,,11871,6543,18,049
"Gibson County, Indiana",33684,16846,16838,32046,614,33,83,0,242,666,1,665,33201,483,0.4213,25990,26311,26418,15158,19024,22806,23069,-666666666,16898,20767,18,051
"Grant County, Indiana",68269,32725,35544,60506,4823,171,506,0,306,1957,175,1782,65497,2772,0.4149,20348,21257,21473,13834,15319,14822,11677,-666666666,13659,8427,18,053
"Greene County, Indiana",32633,16217,16416,31981,105,7,127,49,31,333,4,329,32228,405,0.4282,23189,23427,23536,14352,18241,,12889,,29903,7339,18,055
"Hamilton County, Indiana",303042,148054,154988,265639,10790,337,16749,20,2564,6943,559,6384,291692,11350,0.4353,42361,42875,43045,32267,32973,21796,55425,,20331,15020,18,057
"Hancock County, Indiana",71955,35160,36795,68579,1463,198,537,15,115,1048,49,999,70456,1499,0.3842,30011,30173,30350,21381,27222,8647,29949,,5813,30091,18,059
"Harrison County, Indiana",39370,19678,19692,38299,34,234,306,0,116,381,40,341,38713,657,0.4011,25319,25489,25661,11657,17041,33156,21369,-666666666,7762,12616,18,061
"Hendricks County, Indiana",155817,77782,78035,138569,9582,299,3864,0,1240,2263,270,1993,150324,5493,0.3723,31335,32556,32955,20161,25476,28676,20564,-666666666,12818,10296,18,063
"Henry County, Indiana",48953,25487,23466,46578,993,179,170,23,175,835,92,743,48170,783,0.4402,22182,22809,22953,9861,11700,15923,13359,,9860,5818,18,065
"Howard County, Indiana",82728,40000,42728,72872,5859,298,1094,98,592,1915,141,1774,80202,2526,0.4446,25507,26380,26525,21167,16886,20430,40237,19264,28713,10372,18,067
"Huntington County, Indiana",36696,18039,18657,35479,314,97,295,4,200,307,45,262,35942,754,0.3912,23396,23714,23870,11445,10758,18402,13134,,14726,16972,18,069
"Jackson County, Indiana",43637,21674,21963,40199,238,118,1006,0,1607,469,97,372,40960,2677,0.4097,23098,23523,23841,14817,12909,16126,25276,-666666666,17082,9561,18,071
"Jasper County, Indiana",33461,16556,16905,32002,304,60,124,0,556,415,30,385,31485,1976,0.3755,24839,25395,25724,15432,16486,,11985,-666666666,11357,11757,18,073
"Jay County, Indiana",21196,10402,10794,20769,78,55,78,1,13,202,5,197,20567,629,0.4074,20234,20328,20585,11031,6669,26369,37906,,,8162,18,075
"Jefferson County, Indiana",32482,15443,17039,30751,627,64,262,0,347,431,10,421,31682,800,0.4002,23006,23690,23785,12123,12707,14786,12106,-666666666,4714,11698,18,077
"Jennings County, Indiana",28023,14126,13897,27229,372,82,63,0,121,156,44,112,27390,633,0.3929,22374,22494,22416,23337,12574,,8356,-666666666,15970,4238,18,079
"Johnson County, Indiana",147567,72527,75040,136509,3128,336,3662,28,1961,1943,500,1443,142647,4920,0.4149,29877,30752,31078,15465,19361,13326,22776,,19498,10705,18,081
"Knox County, Indiana",37956,19294,18662,35803,1141,29,280,47,179,477,8,469,37296,660,0.4242,22976,23192,23350,13258,14386,,45366,,19578,17670,18,083
"Kosciusko County, Indiana",78461,38893,39568,73563,729,233,807,0,1826,1303,254,1049,72399,6062,0.4231,26854,27592,28328,13332,15226,10453,32271,-666666666,13487,9984,18,085
"LaGrange County, Indiana",38395,19459,18936,37605,86,15,35,9,33,612,88,524,36899,1496,0.4165,21774,21939,22336,10848,40872,5313,38371,,34336,7348,18,087
"Lake County, Indiana",489698,236906,252792,302867,120716,1504,6702,195,44866,12848,4175,8673,401357,88341,0.4483,25483,29833,31202,17965,18185,28123,40028,8994,17590,11422,18,089
"LaPorte County, Indiana",110993,57380,53613,92765,12162,316,627,35,2022,3066,713,2353,104246,6747,0.4392,24340,26845,27445,12647,11004,19015,22801,,17141,7226,18,091
"Lawrence County, Indiana",45696,22624,23072,44167,160,94,232,0,282,761,111,650,45003,693,0.4116,23743,24095,24089,14349,16549,23684,29297,-666666666,5298,9945,18,093
"Madison County, Indiana",129862,64976,64886,114056,10189,178,547,104,1521,3267,226,3041,125048,4814,0.4258,22997,24221,24588,12170,15627,24158,19785,,16116,7629,18,095
"Marion County, Indiana",932142,448928,483214,582047,254863,2786,25239,339,39799,27069,2746,24323,840486,91656,0.4826,25208,30180,31456,13405,17897,15196,23148,17759,10999,11074,18,097
"Marshall County, Indiana",46833,23262,23571,43839,283,138,192,29,1674,678,85,593,42471,4362,0.4200,23372,23925,24664,12333,12146,33283,31241,,13630,12861,18,099
"Martin County, Indiana",10218,5114,5104,9944,42,68,40,9,16,99,0,99,10196,22,0.4168,23913,24196,24202,68782,13081,6181,18065,,,6282,18,101
"Miami County, Indiana",36093,19190,16903,33011,1803,351,157,22,219,530,46,484,35089,1004,0.4252,21940,22934,23250,8918,8570,16798,9596,13450,8959,18276,18,103
"Monroe County, Indiana",143292,71286,72006,124252,4430,554,8966,61,842,4187,248,3939,138620,4672,0.5117,25488,26967,27172,18818,20458,16008,14952,39593,17462,12147,18,105
"Montgomery County, Indiana",38108,19274,18834,36620,340,107,240,4,86,711,203,508,36357,1751,0.3926,24095,24431,24935,11247,20229,17523,37228,25875,15840,6194,18,107
"Morgan County, Indiana",69504,34395,35109,67658,260,51,469,0,235,831,101,730,68525,979,0.3996,26556,26981,27043,17541,12086,25955,13856,-666666666,16836,6424,18,109
"Newton County, Indiana",14022,7075,6947,13548,47,19,70,22,156,160,16,144,13194,828,0.3942,24061,24427,24959,13947,45587,11400,,,15283,7915,18,111
"Noble County, Indiana",47587,23839,23748,46028,170,45,312,1,289,742,145,597,42833,4754,0.4087,23792,23933,24719,16263,9374,12133,47770,,17262,11475,18,113
"Ohio County, Indiana",6003,3003,3000,5811,139,0,0,0,46,7,0,7,5966,37,0.3554,25278,25430,25430,15989,23862,-666666666,-666666666,-666666666,12861,,18,115
"Orange County, Indiana",19579,9696,9883,18917,250,18,100,0,86,208,6,202,19318,261,0.4264,21295,21260,21383,7990,28340,,49206,-666666666,,6444,18,117
"Owen County, Indiana",21038,10665,10373,20518,135,58,104,0,13,210,0,210,20792,246,0.4009,22675,22595,22716,13604,31741,42322,19325,-666666666,,22296,18,119
"Parke County, Indiana",17033,8089,8944,16371,325,59,14,36,32,196,0,196,16789,244,0.4579,22247,22548,22710,11293,1200,86446,,,25375,8393,18,121
"Perry County, Indiana",19301,10316,8985,18287,596,25,57,0,35,301,17,284,19064,237,0.4044,21634,22463,22437,10457,6626,,16279,-666666666,,2807,18,123
"Pike County, Indiana",12554,6277,6277,12222,100,0,125,0,0,107,5,102,12498,56,0.3853,24367,24851,24955,,5446,-666666666,,-666666666,-666666666,15237,18,125
"Porter County, Indiana",167016,82416,84600,153059,5908,328,2351,152,2029,3189,660,2529,151354,15662,0.4214,30615,31252,32250,19950,21661,29000,39831,26614,22411,15418,18,127
"Posey County, Indiana",25527,12774,12753,24789,344,0,122,0,66,206,0,206,25254,273,0.4335,30396,30892,30924,22096,22159,-666666666,10580,-666666666,,3879,18,129
"Pulaski County, Indiana",12910,6544,6366,12417,45,19,52,0,160,217,8,209,12550,360,0.4321,23958,24468,24496,17559,9158,19589,7192,-666666666,13190,10201,18,131
"Putnam County, Indiana",37626,19799,17827,35313,1341,48,336,0,181,407,28,379,36641,985,0.4039,23040,24198,24610,5358,3093,21581,8742,-666666666,10392,5894,18,133
"Randolph County, Indiana",25403,12346,13057,24524,236,12,49,0,266,316,34,282,24584,819,0.4328,22817,23258,23583,10834,13506,,19890,-666666666,9200,7871,18,135
"Ripley County, Indiana",28633,14138,14495,27716,113,161,285,0,148,210,23,187,28133,500,0.3773,23980,24246,24332,16760,22550,21883,11704,-666666666,24437,7660,18,137
"Rush County, Indiana",16873,8272,8601,16367,208,0,29,0,122,147,24,123,16632,241,0.4395,24267,24307,24244,35923,20614,-666666666,,-666666666,9711,41685,18,139
"St. Joseph County, Indiana",267696,129850,137846,211802,34636,1138,5628,268,6073,8151,1113,7038,245899,21797,0.4645,24748,27207,28121,13257,14138,18268,35150,19279,13424,8272,18,141
"Scott County, Indiana",23734,11672,12062,23127,59,44,94,0,129,281,43,238,23295,439,0.4075,23103,23384,23513,11923,19015,,,-666666666,14476,6111,18,143
"Shelby County, Indiana",44404,21912,22492,41852,573,110,291,0,1127,451,21,430,42657,1747,0.4005,25478,25974,26031,15051,14135,10422,55840,-666666666,11121,13738,18,145
"Spencer County, Indiana",20777,10530,10247,20061,132,53,32,16,291,192,12,180,20202,575,0.3933,25914,26272,26570,12272,18150,18577,16463,,20523,5779,18,147
"Starke County, Indiana",23069,11361,11708,22277,96,32,70,0,275,319,79,240,22272,797,0.4139,21343,21699,21855,12563,13820,,14219,-666666666,10660,10882,18,149
"Steuben County, Indiana",34279,17401,16878,33336,85,15,163,10,63,607,0,607,33128,1151,0.4094,25497,25829,26360,9767,11016,22993,18441,,9570,12782,18,151
"Sullivan County, Indiana",21026,11324,9702,19637,952,42,67,0,45,283,53,230,20676,350,0.4223,20219,21264,21387,7453,1873,44126,,-666666666,,13118,18,153
"Switzerland County, Indiana",10484,5434,5050,10241,64,0,16,0,49,114,0,114,10296,188,0.4040,20698,20781,20700,23730,30944,-666666666,,-666666666,,11563,18,155
"Tippecanoe County, Indiana",183397,93774,89623,154153,8585,230,13923,54,2793,3659,419,3240,168769,14628,0.4711,24221,25714,26700,14329,13632,18896,19773,,17623,8504,18,157
"Tipton County, Indiana",15447,7611,7836,14895,26,2,0,38,164,322,98,224,15064,383,0.3913,27556,27915,28019,18158,23619,,-666666666,,31420,9557,18,159
"Union County, Indiana",7251,3652,3599,6973,12,0,40,0,1,225,0,225,7250,1,0.3894,22918,23573,23573,,,-666666666,,-666666666,,6724,18,161
"Vanderburgh County, Indiana",181692,87909,93783,156287,16344,404,1923,229,1474,5031,221,4810,177192,4500,0.4675,25666,27558,27775,14483,14598,13060,30513,10442,10455,7151,18,163
"Vermillion County, Indiana",15752,7742,8010,15453,59,45,16,0,26,153,0,153,15578,174,0.4077,22932,23103,23263,9049,33697,17900,,-666666666,,7710,18,165
"Vigo County, Indiana",108099,54944,53155,94538,6333,244,2058,39,854,4033,359,3674,105391,2708,0.4624,22079,23020,23088,18762,14281,13489,33445,,17700,7984,18,167
"Wabash County, Indiana",32177,15775,16402,30763,269,205,38,0,384,518,114,404,31398,779,0.4003,23745,23980,24027,15955,16387,33287,99997,-666666666,16981,9238,18,169
"Warren County, Indiana",8309,4119,4190,8145,57,12,1,0,14,80,4,76,8196,113,0.3748,28690,28912,29096,15185,,,,-666666666,,15166,18,171
"Warrick County, Indiana",61427,30350,31077,57989,941,103,1342,18,156,878,99,779,60375,1052,0.4303,31021,31112,31238,21743,16982,26109,49717,,29382,10407,18,173
"Washington County, Indiana",27792,13783,14009,27299,13,95,45,0,18,322,12,310,27437,355,0.4211,22096,22194,22217,19308,,,18440,-666666666,,20232,18,175
"Wayne County, Indiana",67423,32580,34843,60513,3372,118,583,0,1037,1800,45,1755,65554,1869,0.4684,22227,22858,23005,9415,17265,16603,42815,-666666666,13013,9294,18,177
"Wells County, Indiana",27836,13760,14076,26968,201,89,193,0,256,129,12,117,27115,721,0.3879,24544,24987,25242,9010,3457,23781,22154,-666666666,7397,2944,18,179
"White County, Indiana",24265,12061,12204,22663,112,46,61,0,947,436,107,329,22432,1833,0.4104,25859,26704,27256,12371,17966,3228,18862,-666666666,14409,12224,18,181
"Whitley County, Indiana",33354,16660,16694,32300,130,153,122,0,36,613,102,511,32739,615,0.3888,27062,27519,27572,16946,9885,26024,11472,-666666666,17764,10533,18,183
"Adair County, Iowa",7330,3612,3718,7188,21,1,35,0,8,77,9,68,7213,117,0.4180,27358,27395,27506,18011,18152,,10397,-666666666,,34165,19,001
"Adams County, Iowa",3822,1890,1932,3720,19,4,33,0,3,43,5,38,3791,31,0.4116,26991,27436,27528,10894,,,18694,-666666666,,6763,19,003
"Allamakee County, Iowa",14001,7106,6895,13497,118,32,61,2,64,227,23,204,13209,792,0.4337,27027,27489,28476,11357,9525,22719,8562,,18284,16317,19,005
"Appanoose County, Iowa",12602,6265,6337,12289,61,6,62,0,2,182,11,171,12385,217,0.4613,23617,23862,24018,14807,13759,,16952,-666666666,,13380,19,007
"Audubon County, Iowa",5793,2843,2950,5636,22,38,11,0,0,86,0,86,5758,35,0.4666,30085,30375,30391,7877,,6300,,-666666666,-666666666,30323,19,009
"Benton County, Iowa",25720,12853,12867,25147,140,10,79,0,47,297,20,277,25365,355,0.4281,30888,31122,31396,6630,10388,31250,100978,-666666666,16079,4376,19,011
"Black Hawk County, Iowa",132821,65049,67772,113015,11778,420,2608,299,1874,2827,290,2537,127328,5493,0.4472,26571,28371,28648,17308,14325,15916,31004,8471,18427,10466,19,013
"Boone County, Iowa",26411,13295,13116,25618,324,60,36,11,44,318,0,318,25785,626,0.4066,28412,28696,29097,12888,20710,31985,32669,,32489,10889,19,015
"Bremer County, Iowa",24663,12171,12492,23758,265,60,216,39,110,215,68,147,24324,339,0.4174,31001,31442,31590,29701,14348,15875,16610,,56849,13795,19,017
"Buchanan County, Iowa",21031,10453,10578,20519,72,76,104,0,83,177,11,166,20730,301,0.4697,30216,30837,30986,13530,14006,8538,3909,-666666666,4281,1813,19,019
"Buena Vista County, Iowa",20445,10363,10082,16319,601,4,1724,224,1260,313,63,250,15399,5046,0.4423,25035,27347,31246,12824,13777,,20593,10250,12567,11693,19,021
"Butler County, Iowa",14933,7469,7464,14648,45,43,84,11,11,91,0,91,14756,177,0.4064,27085,26855,26959,15734,20078,,74865,,,6056,19,023
"Calhoun County, Iowa",9876,5101,4775,9500,164,31,26,0,13,142,22,120,9696,180,0.4588,26210,26806,27021,9402,10760,6948,34738,-666666666,27454,6751,19,025
"Carroll County, Iowa",20555,10009,10546,19969,292,14,16,0,70,194,67,127,20091,464,0.4330,28307,28805,28975,15943,13360,,25650,-666666666,18870,5008,19,027
"Cass County, Iowa",13433,6633,6800,13117,35,50,71,23,18,119,25,94,13117,316,0.4216,26411,26607,26816,19242,35363,26944,16449,,,2871,19,029
"Cedar County, Iowa",18389,9038,9351,17852,108,27,149,0,57,196,34,162,18055,334,0.3739,29271,29630,29716,20281,17664,18622,15889,-666666666,18547,17770,19,031
"Cerro Gordo County, Iowa",43303,21146,22157,41093,682,118,488,0,229,693,118,575,41396,1907,0.4496,28763,29314,29534,20206,12679,19514,35964,-666666666,21876,10693,19,033
"Cherokee County, Iowa",11752,5865,5887,11431,83,56,49,0,15,118,0,118,11387,365,0.4352,28783,29260,29848,14150,8004,6189,14818,-666666666,,15742,19,035
"Chickasaw County, Iowa",12164,6124,6040,11946,90,30,40,0,20,38,9,29,11895,269,0.4182,26915,27152,27401,15182,10804,24930,12740,-666666666,,6989,19,037
"Clarke County, Iowa",9273,4585,4688,8757,27,0,78,0,228,183,0,183,8154,1119,0.3990,23742,23807,25425,10082,,-666666666,32504,-666666666,19178,24875,19,039
"Clay County, Iowa",16478,8093,8385,15770,73,8,30,13,209,375,4,371,15951,527,0.4362,27883,28555,28732,13932,17048,12475,,,9305,14459,19,041
"Clayton County, Iowa",17735,8875,8860,17377,110,40,80,0,0,128,8,120,17404,331,0.4315,26960,27241,27586,10028,9043,13535,19075,-666666666,-666666666,13229,19,043
"Clinton County, Iowa",47972,23508,24464,45020,1284,125,313,0,183,1047,48,999,46556,1416,0.4341,27116,28185,28506,13064,12596,28077,7005,-666666666,17245,6577,19,045
"Crawford County, Iowa",17147,8720,8427,15849,286,202,50,29,440,291,0,291,12470,4677,0.4957,26693,25991,30386,13681,123404,7496,15086,7207,16768,2161,19,047
"Dallas County, Iowa",78074,38507,39567,71336,912,38,2984,79,884,1841,140,1701,73296,4778,0.4425,40468,41599,42881,18542,23574,43221,31396,,20521,14255,19,049
"Davis County, Iowa",8768,4325,4443,8605,16,0,24,0,0,123,26,97,8658,110,0.4496,24405,24708,24634,24593,,-666666666,18917,-666666666,-666666666,7362,19,051
"Decatur County, Iowa",8210,4108,4102,7815,163,37,43,18,21,113,13,100,7990,220,0.4465,20808,21363,21699,5563,9916,6200,16781,2206,1519,10976,19,053
"Delaware County, Iowa",17445,8710,8735,17154,33,5,63,0,13,177,3,174,17235,210,0.4243,29978,30348,30595,8467,9861,,7254,-666666666,32085,6498,19,055
"Des Moines County, Iowa",40114,19749,20365,36446,2239,68,179,0,92,1090,16,1074,38967,1147,0.4412,25151,26542,26920,13339,10043,20640,36133,-666666666,14540,9045,19,057
"Dickinson County, Iowa",17046,8536,8510,16622,62,42,51,16,57,196,34,162,16751,295,0.4455,36042,36549,36719,18779,17429,29374,3704,,17844,12121,19,059
"Dubuque County, Iowa",96359,47634,48725,89975,2571,48,1230,338,290,1907,82,1825,94233,2126,0.4346,28526,29684,29948,12438,9923,7060,21931,14274,9975,9132,19,061
"Emmet County, Iowa",9820,4828,4992,9443,141,46,30,11,55,94,32,62,8930,890,0.4649,27807,28487,29629,15197,4858,,39350,,18627,6950,19,063
"Fayette County, Iowa",20391,10269,10122,19497,270,109,154,0,66,295,83,212,19936,455,0.4404,26002,26870,27113,7047,4843,4951,12603,-666666666,9862,6375,19,065
"Floyd County, Iowa",16004,7866,8138,15163,272,66,263,2,43,195,43,152,15627,377,0.4449,26929,27568,27776,16820,17408,,23879,,27153,2979,19,067
"Franklin County, Iowa",10393,5266,5127,9591,139,8,24,0,510,121,74,47,9160,1233,0.4305,24909,26039,27329,10212,3122,20913,10458,-666666666,12702,14961,19,069
"Fremont County, Iowa",7019,3508,3511,6765,41,50,0,0,83,80,7,73,6843,176,0.4423,29553,30125,30288,12394,8515,19506,-666666666,-666666666,11010,17566,19,071
"Greene County, Iowa",9083,4442,4641,8887,14,16,44,5,0,117,4,113,8851,232,0.4182,26103,26469,26781,14359,19221,,19286,,-666666666,3135,19,073
"Grundy County, Iowa",12373,6076,6297,12169,42,4,77,0,8,73,3,70,12222,151,0.4321,32953,33219,33287,25998,,,10266,-666666666,,22338,19,075
"Guthrie County, Iowa",10691,5354,5337,10418,26,31,7,0,68,141,0,141,10437,254,0.4517,29938,30372,30689,12407,19319,18145,16886,-666666666,11093,12196,19,077
"Hamilton County, Iowa",15227,7535,7692,14213,97,0,387,0,369,161,8,153,14370,857,0.4384,28076,28582,29085,11609,13799,-666666666,38040,-666666666,8502,12906,19,079
"Hancock County, Iowa",11006,5555,5451,10661,86,19,40,9,34,157,27,130,10595,411,0.4110,27732,28155,28648,15736,9540,5389,13160,,48650,7395,19,081
"Hardin County, Iowa",17324,8648,8676,16615,215,35,118,0,120,221,8,213,16625,699,0.4078,27657,28469,28864,17895,2617,,9170,-666666666,22341,6868,19,083
"Harrison County, Iowa",14335,7101,7234,13978,7,66,44,7,35,198,59,139,14107,228,0.4033,27984,28330,28483,17089,,7836,20991,,33360,11406,19,085
"Henry County, Iowa",19941,10147,9794,18325,419,58,528,11,246,354,14,340,19047,894,0.4240,24380,25093,25622,13218,15540,30233,17748,,23288,8193,19,087
"Howard County, Iowa",9430,4689,4741,9271,31,0,24,0,13,91,0,91,9286,144,0.4172,25567,25899,26235,4509,7597,-666666666,12413,-666666666,,3948,19,089
"Humboldt County, Iowa",9607,4672,4935,9416,15,19,28,0,4,125,0,125,9253,354,0.4476,28654,29048,29549,15385,,,31693,-666666666,,5071,19,091
"Ida County, Iowa",7041,3522,3519,6885,6,56,22,0,21,51,1,50,6893,148,0.4623,29750,30146,30463,13228,8317,14877,11445,-666666666,14619,9251,19,093
"Iowa County, Iowa",16326,8101,8225,15972,105,8,26,10,49,156,0,156,15942,384,0.3964,28640,29096,29301,17139,11150,31525,,,4088,5697,19,095
"Jackson County, Iowa",19529,9711,9818,18947,70,15,78,120,33,266,0,266,19265,264,0.4220,25865,26240,26324,16261,24021,16627,17981,14452,,10298,19,097
"Jasper County, Iowa",36715,18811,17904,35174,550,71,191,41,74,614,68,546,36034,681,0.4019,26507,27136,27363,7552,13814,10130,23301,,5908,6762,19,099
"Jefferson County, Iowa",17662,9395,8267,14839,1011,2,825,0,423,562,0,562,17141,521,0.4661,25120,27908,28706,5155,18141,,2813,-666666666,819,15057,19,101
"Johnson County, Iowa",142006,70409,71597,118240,8666,199,8737,151,2996,3017,221,2796,134448,7558,0.4904,31981,34461,34817,20541,15002,22085,26543,16887,17690,14908,19,103
"Jones County, Iowa",20481,10580,9901,19578,431,124,104,0,49,195,2,193,20141,340,0.4366,27891,28907,29121,10343,2755,8337,,-666666666,13771,9072,19,105
"Keokuk County, Iowa",10234,5166,5068,10026,1,7,51,7,35,107,0,107,10087,147,0.4175,24650,24855,24922,17390,,,7614,,,13252,19,107
"Kossuth County, Iowa",15226,7610,7616,14818,69,27,87,0,79,146,17,129,14916,310,0.4184,29086,29511,29845,11515,9588,,14297,-666666666,18078,15045,19,109
"Lee County, Iowa",35172,17813,17359,32906,907,48,133,0,185,993,123,870,33976,1196,0.4118,23470,23980,24126,21402,16742,21152,57386,-666666666,29512,7188,19,111
"Linn County, Iowa",218076,107727,110349,195251,10174,416,4667,60,1637,5871,433,5438,211549,6527,0.4294,31854,33324,33573,18196,18285,17900,32176,27938,17723,11181,19,113
"Louisa County, Iowa",11251,5752,5499,10414,142,31,379,13,233,39,0,39,9459,1792,0.4190,26093,27035,29076,15178,14718,38565,12399,,15722,9774,19,115
"Lucas County, Iowa",8700,4370,4330,8498,11,27,0,0,0,164,0,164,8663,37,0.4319,26119,26472,26493,21551,,,-666666666,-666666666,-666666666,9872,19,117
"Lyon County, Iowa",11730,6010,5720,11385,6,70,29,8,124,108,20,88,11444,286,0.4047,27874,28275,28326,15635,,24071,21090,,16360,2918,19,119
"Madison County, Iowa",15661,7830,7831,15267,86,5,172,18,29,84,0,84,15411,250,0.4028,29430,29860,30018,15303,3181,26400,14678,,32621,13621,19,121
"Mahaska County, Iowa",22324,11323,11001,21361,334,29,238,0,95,267,5,262,21899,425,0.4459,25823,26169,26322,17981,11780,15886,34980,-666666666,29257,7342,19,123
"Marion County, Iowa",33197,16457,16740,31849,210,94,356,0,185,503,26,477,32595,602,0.3989,27020,27498,27686,9317,18463,26026,21700,-666666666,4804,12470,19,125
"Marshall County, Iowa",40735,20641,20094,34008,511,97,1258,15,3779,1067,201,866,32671,8064,0.3904,25197,27330,29365,11537,18020,29077,18430,,11325,16709,19,127
"Mills County, Iowa",14841,7534,7307,14460,111,121,22,0,9,118,0,118,14433,408,0.3910,29492,29750,29805,28009,12267,18460,,-666666666,,26826,19,129
"Mitchell County, Iowa",10757,5351,5406,10528,9,26,40,0,6,148,44,104,10617,140,0.3938,25990,26346,26452,16931,,,9963,-666666666,,6004,19,131
"Monona County, Iowa",9013,4451,4562,8741,50,110,10,0,12,90,0,90,8863,150,0.4543,26394,26673,26670,24927,31360,8157,,-666666666,,23667,19,133
"Monroe County, Iowa",7964,4030,3934,7749,6,0,18,0,146,45,0,45,7765,199,0.4117,25233,25337,25678,13141,4967,-666666666,,-666666666,24653,,19,135
"Montgomery County, Iowa",10380,4965,5415,9913,0,24,0,0,167,276,47,229,10028,352,0.4278,23626,23964,24155,10453,-666666666,,-666666666,-666666666,13144,17872,19,137
"Muscatine County, Iowa",42949,21329,21620,39253,745,66,474,12,1186,1213,163,1050,35589,7360,0.4202,27029,27810,30029,14805,25339,55429,22388,,18919,11030,19,139
"O'Brien County, Iowa",14055,7044,7011,13281,68,36,121,5,381,163,41,122,13453,602,0.4665,30933,32018,32350,9455,10679,6511,16992,,11781,12439,19,141
"Osceola County, Iowa",6154,3105,3049,5871,25,11,25,6,155,61,0,61,5728,426,0.4065,25936,26294,26977,13033,12680,20182,18212,,14686,29551,19,143
"Page County, Iowa",15552,8036,7516,14668,379,55,180,0,44,226,16,210,15089,463,0.4470,25461,26069,26568,9276,12924,16862,27694,-666666666,19275,8533,19,145
"Palo Alto County, Iowa",9155,4567,4588,8833,166,12,46,0,16,82,23,59,8957,198,0.4110,26776,27253,27479,14428,14795,,14772,-666666666,12606,10084,19,147
"Plymouth County, Iowa",24972,12302,12670,23828,122,46,142,58,505,271,8,263,23966,1006,0.3939,28975,29677,29966,15084,9562,78437,11892,3131,12691,12404,19,149
"Pocahontas County, Iowa",7061,3504,3557,6778,103,6,16,10,49,99,13,86,6814,247,0.4378,27599,28273,28675,11926,11792,,19063,,25261,1581,19,151
"Polk County, Iowa",459159,225935,233224,390415,29390,1277,18813,366,6735,12163,1117,11046,422477,36682,0.4481,32232,34708,36180,15090,16470,12999,26174,15549,15879,11786,19,153
"Pottawattamie County, Iowa",93198,46015,47183,87907,1352,304,636,5,1240,1754,64,1690,86452,6746,0.4320,27948,28639,29027,21433,15986,20376,25626,,18455,11410,19,155
"Poweshiek County, Iowa",18622,8900,9722,17632,333,17,373,5,35,227,0,227,18055,567,0.4239,26583,27544,28099,7156,9996,5218,9368,,15137,8256,19,157
"Ringgold County, Iowa",5054,2463,2591,4911,11,20,21,0,57,34,3,31,4946,108,0.4635,26175,26548,26718,8496,3509,32630,16629,-666666666,,14159,19,159
"Sac County, Iowa",10034,4925,5109,9800,60,0,0,4,52,118,10,108,9773,261,0.4037,27088,27477,27885,8212,10813,-666666666,-666666666,,10494,10487,19,161
"Scott County, Iowa",171116,84119,86997,146989,13254,503,4126,17,1858,4369,431,3938,160364,10752,0.4471,30037,31949,32862,18183,17194,22953,23143,31859,24711,14242,19,163
"Shelby County, Iowa",11944,5852,6092,11484,49,16,37,0,211,147,0,147,11597,347,0.4190,28178,28531,28667,16146,27484,26731,37824,-666666666,15654,16520,19,165
"Sioux County, Iowa",34621,17444,17177,32150,146,81,246,4,1609,385,93,292,31212,3409,0.3943,27037,28170,29154,11131,4705,25263,24304,,11697,7106,19,167
"Story County, Iowa",94834,49349,45485,83040,2136,211,6523,29,320,2575,75,2500,91844,2990,0.4661,26032,27425,27791,14775,16392,15088,18492,,17710,10279,19,169
"Tama County, Iowa",17423,8610,8813,15442,88,1290,60,9,214,320,54,266,15991,1432,0.4005,26144,27939,28985,11825,12545,12920,15190,,11075,8843,19,171
"Taylor County, Iowa",6209,3129,3080,5960,12,16,44,0,131,46,3,43,5749,460,0.4434,26188,26863,27648,11476,19892,13950,10861,-666666666,8292,10315,19,173
"Union County, Iowa",12539,6042,6497,12208,124,35,81,7,0,84,0,84,12201,338,0.4137,25140,25450,25685,16431,6248,58586,16028,,-666666666,4917,19,175
"Van Buren County, Iowa",7380,3779,3601,7229,43,7,3,0,6,92,0,92,7282,98,0.4017,23765,24119,24282,6774,6942,,,-666666666,,6904,19,177
"Wapello County, Iowa",35242,17353,17889,32003,831,68,323,95,1446,476,20,456,31633,3609,0.4445,23116,24135,25004,12111,13996,23959,20121,5943,12116,9258,19,179
"Warren County, Iowa",48170,23532,24638,46619,193,113,230,51,200,764,8,756,47005,1165,0.3980,31525,31813,32102,19048,24163,5542,24296,5431,31503,23547,19,181
"Washington County, Iowa",22115,10972,11143,21332,195,49,103,11,178,247,7,240,20870,1245,0.3980,27933,28399,29257,11800,19617,,26438,,11770,9779,19,183
"Wayne County, Iowa",6403,3109,3294,6264,41,21,4,0,0,73,0,73,6326,77,0.4149,22461,22605,22852,2755,19285,41200,,-666666666,-666666666,7293,19,185
"Webster County, Iowa",37050,19089,17961,33912,1672,140,433,3,380,510,25,485,35436,1614,0.4434,23921,24970,25472,10126,7853,17554,38918,,10301,5500,19,187
"Winnebago County, Iowa",10580,5157,5423,10088,79,81,119,1,40,172,21,151,10167,413,0.4153,25917,26402,26536,18877,6852,19610,19809,,14298,16099,19,189
"Winneshiek County, Iowa",20789,10393,10396,20124,178,41,244,0,72,130,58,72,20352,437,0.3927,27240,27157,27185,22359,9158,44380,57226,-666666666,20508,6852,19,191
"Woodbury County, Iowa",102426,50605,51821,88291,3149,1570,2832,133,3390,3061,383,2678,86791,15635,0.4369,24469,26119,28250,12041,14409,13822,18938,26440,14531,8700,19,193
"Worth County, Iowa",7562,3751,3811,7347,68,6,14,1,5,121,17,104,7357,205,0.4091,25661,26155,26494,9826,4382,,24279,,,9285,19,195
"Wright County, Iowa",12891,6428,6463,12022,63,26,73,0,530,177,36,141,11532,1359,0.4527,27111,28041,29137,10923,9627,,56985,-666666666,10174,11419,19,197
"Allen County, Kansas",12951,6420,6531,12117,245,35,21,14,65,454,12,442,12529,422,0.4153,21577,22217,22423,16204,16579,21434,14210,,18957,8580,20,001
"Anderson County, Kansas",7858,3899,3959,7504,10,176,0,0,0,168,16,152,7822,36,0.3953,21851,22529,22579,2072,25420,6498,-666666666,-666666666,-666666666,7431,20,003
"Atchison County, Kansas",16557,8046,8511,15023,652,83,37,10,41,711,22,689,16092,465,0.4512,23151,23863,23954,17328,26090,18081,7349,,4634,8104,20,005
"Barber County, Kansas",4831,2472,2359,4623,35,18,27,0,9,119,11,108,4679,152,0.4371,26040,26389,26774,14118,,,16519,-666666666,30444,20060,20,007
"Barton County, Kansas",27214,13553,13661,25106,357,77,51,57,983,583,6,577,23357,3857,0.4486,25474,26495,28412,10339,13290,16571,59057,,10085,15155,20,009
"Bourbon County, Kansas",14751,7276,7475,13701,516,136,122,0,28,248,0,248,14401,350,0.4374,21158,21977,22264,10802,10537,21357,11042,-666666666,4064,4775,20,011
"Brown County, Kansas",9810,4729,5081,8408,152,814,65,11,22,338,0,338,9430,380,0.4208,23247,24472,24926,10824,24583,16508,19691,,5505,10404,20,013
"Butler County, Kansas",66264,33269,32995,62088,1477,610,525,11,208,1345,83,1262,63344,2920,0.4176,27888,28484,28700,22740,11092,22914,44649,,22473,14777,20,015
"Chase County, Kansas",2694,1357,1337,2577,32,43,0,0,6,36,0,36,2585,109,0.4281,24353,25054,25632,10461,9441,,-666666666,-666666666,19200,3300,20,017
"Chautauqua County, Kansas",3470,1755,1715,3043,9,235,0,0,0,183,0,183,3412,58,0.4511,23398,24533,24589,12357,,15324,-666666666,-666666666,-666666666,15343,20,019
"Cherokee County, Kansas",20737,10184,10553,18749,127,665,63,7,75,1051,3,1048,20264,473,0.4067,20371,20808,20838,14852,23314,18993,17459,,5456,14078,20,021
"Cheyenne County, Kansas",2679,1341,1338,2502,0,0,40,0,102,35,3,32,2510,169,0.3993,27608,28750,29180,11232,-666666666,-666666666,14003,-666666666,9425,14480,20,023
"Clark County, Kansas",2131,1078,1053,1951,20,39,16,8,43,54,0,54,1878,253,0.4123,24322,25026,26316,12450,30295,23464,,,,21780,20,025
"Clay County, Kansas",8346,4090,4256,8042,60,49,46,0,11,138,2,136,8146,200,0.4521,27715,28273,28498,13182,4160,25437,,-666666666,,15507,20,027
"Cloud County, Kansas",9302,4633,4669,8828,71,28,66,0,149,160,0,160,9005,297,0.4215,24677,23995,24089,21397,160145,,10000,-666666666,25585,11056,20,029
"Coffey County, Kansas",8433,4215,4218,8083,78,64,57,13,15,123,10,113,8225,208,0.4152,30242,30409,30744,16089,18494,14992,4996,,55573,43293,20,031
"Comanche County, Kansas",1898,912,986,1841,0,0,13,0,34,10,0,10,1779,119,0.4197,24574,24809,24201,30899,-666666666,-666666666,,-666666666,14715,,20,033
"Cowley County, Kansas",35977,18085,17892,31538,1159,793,578,5,651,1253,108,1145,32288,3689,0.4285,22249,23509,24430,12568,12339,13554,19738,,14652,10229,20,035
"Crawford County, Kansas",39281,19575,19706,36152,908,207,671,0,216,1127,15,1112,37274,2007,0.4586,20642,21534,22029,11319,11559,13157,9017,-666666666,11168,9437,20,037
"Decatur County, Kansas",2886,1431,1455,2776,12,19,0,0,11,68,43,25,2804,82,0.4947,29729,30340,30402,13802,15758,32511,-666666666,-666666666,,10579,20,039
"Dickinson County, Kansas",19384,9705,9679,18342,173,177,61,0,151,480,81,399,18525,859,0.4172,24454,24852,25167,16366,13957,33801,11772,-666666666,14995,14176,20,041
"Doniphan County, Kansas",7793,3938,3855,7179,293,89,18,0,14,200,5,195,7586,207,0.4070,23986,25156,25434,13292,8344,22246,,-666666666,,8005,20,043
"Douglas County, Kansas",116352,57945,58407,97456,4483,2564,5345,37,1174,5293,482,4811,109638,6714,0.4763,28302,29982,30539,19301,19711,15833,25151,1695,23424,15134,20,045
"Edwards County, Kansas",2975,1539,1436,2812,40,4,8,0,82,29,1,28,2384,591,0.4226,26567,27321,29973,15467,6010,34725,26725,-666666666,18162,4407,20,047
"Elk County, Kansas",2635,1315,1320,2487,3,52,13,0,13,67,12,55,2529,106,0.3898,22040,22146,22696,9505,,32140,,-666666666,41292,9527,20,049
"Ellis County, Kansas",29032,14529,14503,27621,314,40,408,0,54,595,62,533,27440,1592,0.4539,27103,27884,28625,12508,15068,33325,11688,-666666666,10083,8873,20,051
"Ellsworth County, Kansas",6375,3624,2751,5708,290,48,26,0,136,167,7,160,5991,384,0.4140,23851,25760,26347,11029,5856,2877,20277,-666666666,13888,4523,20,053
"Finney County, Kansas",36983,18835,18148,28064,888,328,1519,0,4934,1250,392,858,19075,17908,0.4149,22551,24991,32360,14666,16775,17627,16657,-666666666,15012,10077,20,055
"Ford County, Kansas",34492,17844,16648,30690,794,140,460,6,1659,743,266,477,16179,18313,0.4162,20749,21443,31468,12936,14036,15199,21406,,14602,13591,20,057
"Franklin County, Kansas",25663,12513,13150,23816,417,109,20,0,595,706,68,638,24649,1014,0.4094,24597,25613,25797,11604,11087,27810,15975,-666666666,8407,11694,20,059
"Geary County, Kansas",36818,19465,17353,25772,6240,357,1130,267,513,2539,124,2415,31292,5526,0.3955,21309,22798,24529,13671,21513,12628,23109,10247,15763,8394,20,061
"Gove County, Kansas",2682,1354,1328,2577,26,11,21,0,5,42,3,39,2592,90,0.4348,26746,26949,27530,11400,,24145,6248,-666666666,,15948,20,063
"Graham County, Kansas",2577,1278,1299,2369,78,4,38,0,0,88,0,88,2496,81,0.4342,27569,28056,28638,11372,31317,,16000,-666666666,-666666666,16867,20,065
"Grant County, Kansas",7748,4026,3722,6205,0,23,0,0,1370,150,96,54,4169,3579,0.4140,24173,26456,31900,15308,-666666666,,-666666666,-666666666,14268,22039,20,067
"Gray County, Kansas",6037,3002,3035,5939,37,0,0,17,24,20,0,20,5149,888,0.3823,26536,26565,28250,16330,,-666666666,-666666666,,27738,42665,20,069
"Greeley County, Kansas",1235,602,633,1110,8,6,2,0,86,23,3,20,978,257,0.4047,26040,28034,30555,11526,,,,-666666666,7302,8687,20,071
"Greenwood County, Kansas",6304,3101,3203,5996,10,13,0,0,68,217,0,217,6065,239,0.4430,23972,24759,25131,9719,,23892,-666666666,-666666666,3762,9436,20,073
"Hamilton County, Kansas",2567,1368,1199,2234,61,2,0,0,236,34,2,32,1645,922,0.4127,21863,22709,27570,11899,14969,,-666666666,-666666666,16406,15594,20,075
"Harper County, Kansas",5798,2939,2859,5596,7,129,0,0,13,53,0,53,5432,366,0.4469,25944,26322,27304,11971,15957,18834,-666666666,-666666666,25323,4804,20,077
"Harvey County, Kansas",34814,17027,17787,32534,615,211,241,40,374,799,22,777,30851,3963,0.4044,25320,25870,27297,14202,18320,13579,21064,23793,22824,13941,20,079
"Haskell County, Kansas",4087,2066,2021,3583,0,111,10,1,353,29,11,18,2906,1181,0.3977,22886,24194,27471,12457,-666666666,11471,,,11901,15490,20,081
"Hodgeman County, Kansas",1919,967,952,1860,0,3,32,0,0,24,0,24,1784,135,0.4573,33661,34329,35699,16822,-666666666,,18275,-666666666,-666666666,5096,20,083
"Jackson County, Kansas",13365,6670,6695,11608,77,930,81,44,9,616,55,561,12802,563,0.3996,26027,27715,27987,12984,14997,15752,17562,33452,,11770,20,085
"Jefferson County, Kansas",18880,9593,9287,18061,111,137,0,0,25,546,44,502,18431,449,0.3572,26328,26699,26827,15148,31586,21317,-666666666,-666666666,21552,14491,20,087
"Jewell County, Kansas",3003,1501,1502,2914,4,6,16,2,20,41,0,41,2932,71,0.4407,23282,23768,24017,7162,,13417,,,8235,5429,20,089
"Johnson County, Kansas",572428,279962,292466,497049,25490,1506,26088,232,5172,16891,1304,15587,530482,41946,0.4500,41415,43476,45130,20183,26159,32430,39004,24377,19586,15208,20,091
"Kearny County, Kansas",3943,2061,1882,3221,34,25,17,0,510,136,20,116,2740,1203,0.4443,23213,25448,28376,13166,29071,,,-666666666,13122,11270,20,093
"Kingman County, Kansas",7697,3904,3793,7468,33,47,1,0,21,127,0,127,7462,235,0.4239,28911,28718,29266,13203,104927,21809,,-666666666,44248,20277,20,095
"Kiowa County, Kansas",2520,1236,1284,2383,35,4,36,0,20,42,0,42,2368,152,0.4416,24895,25759,26575,9039,4931,,19817,-666666666,5300,6026,20,097
"Labette County, Kansas",20833,10291,10542,18433,691,200,59,0,177,1273,11,1262,19932,901,0.4172,21648,22743,23075,12374,17114,19007,,-666666666,11977,10593,20,099
"Lane County, Kansas",1687,829,858,1666,9,7,0,0,0,5,0,5,1598,89,0.4254,31329,31385,32084,18569,,,-666666666,-666666666,-666666666,,20,101
"Leavenworth County, Kansas",78785,42238,36547,65585,6889,572,1221,120,1302,3096,407,2689,73503,5282,0.4085,28743,30550,31227,16567,22985,15254,20878,89982,20433,9981,20,103
"Lincoln County, Kansas",3134,1573,1561,3059,30,20,5,0,0,20,0,20,3050,84,0.4192,25070,25464,25852,11336,6220,,,-666666666,-666666666,16210,20,105
"Linn County, Kansas",9524,4695,4829,9165,62,86,33,0,11,167,8,159,9293,231,0.4900,27368,27656,28078,10865,37095,13855,19848,-666666666,,16134,20,107
"Logan County, Kansas",2800,1384,1416,2672,0,12,3,0,17,96,4,92,2659,141,0.4596,27837,28627,29621,10261,-666666666,,,-666666666,27341,7322,20,109
"Lyon County, Kansas",33401,16250,17151,29539,821,152,676,0,834,1379,137,1242,26508,6893,0.4719,23317,24662,25079,20859,19319,12147,9931,-666666666,15566,9384,20,111
"McPherson County, Kansas",29164,14453,14711,27620,299,158,184,19,318,566,39,527,28025,1139,0.3965,28722,29031,29277,22445,16626,26024,39896,,30305,17236,20,113
"Marion County, Kansas",12213,6086,6127,11666,84,89,28,0,14,332,25,307,11832,381,0.4127,24234,24657,24914,12019,9843,7200,26096,-666666666,,18324,20,115
"Marshall County, Kansas",9963,4971,4992,9638,40,24,41,16,54,150,11,139,9733,230,0.4463,26978,27423,27626,14175,39628,,20476,,14250,6639,20,117
"Meade County, Kansas",4310,2177,2133,3830,39,0,38,4,327,72,15,57,3656,654,0.4006,24253,24909,25997,15263,27151,-666666666,18068,,17323,22606,20,119
"Miami County, Kansas",32787,16153,16634,31370,452,204,128,0,44,589,85,504,31830,957,0.4135,30184,30798,31153,16282,11594,26864,24623,-666666666,,14990,20,121
"Mitchell County, Kansas",6299,3229,3070,6153,22,18,60,0,8,38,0,38,6170,129,0.4365,27432,27830,28267,5765,,,13948,-666666666,15438,6539,20,123
"Montgomery County, Kansas",33765,16677,17088,28863,1762,1079,328,37,162,1534,2,1532,31715,2050,0.4421,22181,23120,23751,14031,12229,16072,18523,,25959,20971,20,125
"Morris County, Kansas",5694,2835,2859,5460,5,7,30,0,43,149,0,149,5449,245,0.4017,25135,25695,26178,12383,,13771,8387,-666666666,14358,12194,20,127
"Morton County, Kansas",3033,1596,1437,2598,19,5,4,0,237,170,43,127,2383,650,0.4218,23115,23326,24610,19380,16889,,,-666666666,28812,11864,20,129
"Nemaha County, Kansas",10177,5092,5085,9888,64,46,33,1,13,132,0,132,10014,163,0.4154,26208,26576,26807,10671,25342,10426,22106,,18192,6564,20,131
"Neosho County, Kansas",16358,7966,8392,15552,151,54,24,5,65,507,0,507,15547,811,0.4512,22759,23190,23829,11953,12874,14439,,,37137,12744,20,133
"Ness County, Kansas",3047,1563,1484,2989,15,5,5,0,4,29,2,27,2730,317,0.4406,28184,28606,30883,9071,12220,,,-666666666,,,20,135
"Norton County, Kansas",5558,3204,2354,5104,150,31,19,9,50,195,72,123,5281,277,0.3752,23039,24694,25188,6472,785,6258,,,22424,1759,20,137
"Osage County, Kansas",16001,8018,7983,15379,42,83,41,0,34,422,22,400,15554,447,0.4203,25880,26397,26561,17194,29390,11439,30261,-666666666,,9813,20,139
"Osborne County, Kansas",3746,1868,1878,3638,30,20,29,0,3,26,5,21,3677,69,0.4755,27824,27915,28269,5955,12317,56560,,-666666666,,10646,20,141
"Ottawa County, Kansas",6004,3154,2850,5807,5,16,10,0,16,150,1,149,5840,164,0.3966,26749,27307,27614,16207,,6094,,-666666666,20956,9397,20,143
"Pawnee County, Kansas",6840,3895,2945,6184,319,12,0,0,95,230,18,212,6325,515,0.4072,25193,27334,28463,9215,5575,,-666666666,-666666666,8125,3193,20,145
"Phillips County, Kansas",5484,2672,2812,5294,19,9,15,1,9,137,21,116,5317,167,0.3924,25364,25787,26171,13256,4663,16133,,,,14685,20,147
"Pottawatomie County, Kansas",22920,11326,11594,21543,294,194,182,0,205,502,22,480,21718,1202,0.3954,27199,27645,28391,12220,16830,28353,33436,-666666666,12458,17457,20,149
"Pratt County, Kansas",9729,4858,4871,9218,42,140,26,0,49,254,27,227,9063,666,0.4530,25745,26667,27698,9464,2157,18276,,-666666666,6741,6611,20,151
"Rawlins County, Kansas",2557,1293,1264,2465,6,38,3,0,20,25,0,25,2421,136,0.3948,27250,27516,28185,10435,,33384,,-666666666,10980,11760,20,153
"Reno County, Kansas",63803,32151,31652,58721,1895,387,357,40,651,1752,175,1577,58140,5663,0.4304,24313,25241,26094,15046,12936,20449,19793,,18748,9775,20,155
"Republic County, Kansas",4768,2337,2431,4641,6,6,33,0,0,82,12,70,4696,72,0.4200,26029,26505,26622,9440,,,,-666666666,-666666666,4484,20,157
"Rice County, Kansas",9949,5020,4929,9050,200,21,61,14,371,232,36,196,8845,1104,0.3961,22596,23532,24387,12186,19278,,6515,13250,12154,11704,20,159
"Riley County, Kansas",75026,39816,35210,62136,4844,308,3648,200,816,3074,430,2644,69188,5838,0.4762,25087,26606,27391,15165,21357,23440,18693,15695,12241,12035,20,161
"Rooks County, Kansas",5160,2500,2660,4998,25,11,34,2,13,77,9,68,5034,126,0.4228,24919,25160,25424,17414,,3764,27721,,64038,9230,20,163
"Rush County, Kansas",3144,1557,1587,3068,1,12,11,0,2,50,0,50,3045,99,0.4160,25002,25246,25212,25842,,7083,,-666666666,,16110,20,165
"Russell County, Kansas",6988,3511,3477,6674,80,27,0,52,0,155,0,155,6789,199,0.4034,24181,24797,25134,9722,26005,9237,-666666666,7769,-666666666,4812,20,167
"Saline County, Kansas",55547,27433,28114,48578,1825,195,1345,14,1807,1783,237,1546,49612,5935,0.4481,26477,27770,29031,14203,19940,13051,26019,,19077,7432,20,169
"Scott County, Kansas",4958,2385,2573,4703,0,42,30,0,128,55,6,49,4212,746,0.3417,31280,30281,31872,24491,-666666666,,,-666666666,47291,43125,20,171
"Sedgwick County, Kansas",508221,251174,257047,405562,46205,4940,21966,131,10652,18765,1770,16995,437624,70597,0.4549,26672,28874,31221,14105,17643,18620,23525,35561,16039,13073,20,173
"Seward County, Kansas",23185,11823,11362,13868,992,176,682,0,6807,660,373,287,9510,13675,0.4216,20844,24480,34868,13120,21973,25271,23324,-666666666,14118,8379,20,175
"Shawnee County, Kansas",178567,86494,92073,147823,13639,1576,2065,127,4301,9036,680,8356,157664,20903,0.4404,27534,29623,31324,13545,18838,25100,31460,9504,14680,12382,20,177
"Sheridan County, Kansas",2522,1303,1219,2473,4,35,0,0,5,5,0,5,2420,102,0.4049,29604,29916,30630,13217,,11983,-666666666,-666666666,,,20,179
"Sherman County, Kansas",6038,3048,2990,5603,66,23,40,0,244,62,9,53,5322,716,0.3930,24494,25330,26381,12732,23686,,,-666666666,10995,3789,20,181
"Smith County, Kansas",3701,1820,1881,3661,7,0,7,0,3,23,5,18,3631,70,0.4780,27870,28126,28227,19729,,-666666666,,-666666666,,,20,183
"Stafford County, Kansas",4284,2170,2114,4087,35,12,17,0,68,65,0,65,3715,569,0.4159,25046,25662,28024,8860,13343,28700,17847,-666666666,10485,9080,20,185
"Stanton County, Kansas",2115,994,1121,1720,18,6,7,0,202,162,7,155,1420,695,0.3636,22383,25403,28458,13143,22667,27667,,-666666666,11684,3032,20,187
"Stevens County, Kansas",5738,2903,2835,4945,7,45,13,8,619,101,1,100,3749,1989,0.4360,23579,25348,29882,12323,29700,33093,,,11234,10649,20,189
"Sumner County, Kansas",23509,11647,11862,22202,233,291,62,0,157,564,64,500,22278,1231,0.4260,24764,25353,25810,18410,6769,17104,,-666666666,40785,11079,20,191
"Thomas County, Kansas",7909,3901,4008,7434,103,71,27,12,133,129,65,64,7501,408,0.4597,26241,26997,27406,11009,9840,10055,7933,,17261,14986,20,193
"Trego County, Kansas",2927,1431,1496,2835,4,40,14,0,0,34,0,34,2903,24,0.3658,29651,29582,29684,13921,,22178,,-666666666,-666666666,2632,20,195
"Wabaunsee County, Kansas",6960,3510,3450,6684,21,25,14,0,18,198,22,176,6724,236,0.3590,25194,25599,25943,18664,,18496,33179,-666666666,4667,14741,20,197
"Wallace County, Kansas",1584,799,785,1536,0,6,1,0,29,12,0,12,1508,76,0.4885,28875,29395,29787,12662,-666666666,5467,,-666666666,,,20,199
"Washington County, Kansas",5613,2863,2750,5425,27,16,9,0,46,90,15,75,5429,184,0.3971,24241,24757,25083,11498,,17438,,-666666666,15150,7264,20,201
"Wichita County, Kansas",2168,1063,1105,2033,8,22,0,0,83,22,0,22,1451,717,0.3945,26194,26653,32890,12556,,20236,-666666666,-666666666,13898,36905,20,203
"Wilson County, Kansas",8956,4371,4585,8493,43,65,57,0,24,274,0,274,8706,250,0.4390,23869,24113,24294,15456,16779,16769,61535,-666666666,,13194,20,205
"Woodson County, Kansas",3186,1601,1585,2999,20,12,8,0,11,136,4,132,3099,87,0.4285,20499,21164,21185,9610,,8817,,-666666666,,5981,20,207
"Wyandotte County, Kansas",161777,79712,82065,99287,38556,1053,5883,280,10682,6036,1283,4753,117119,44658,0.4276,19282,21370,25652,12485,17715,15119,13341,4442,14409,10775,20,209
"Adair County, Kentucky",19156,9484,9672,18164,593,26,48,0,88,237,11,226,18803,353,0.4495,18463,18788,18880,10778,15084,,3402,-666666666,7774,7994,21,001
"Allen County, Kentucky",20421,10146,10275,19701,310,6,72,0,176,156,0,156,20043,378,0.4333,20607,20498,20644,11231,33237,,20339,-666666666,17372,13718,21,003
"Anderson County, Kentucky",21867,10625,11242,20862,558,0,84,0,73,290,62,228,21525,342,0.3906,24891,25295,25283,23415,14498,-666666666,,-666666666,,24484,21,005
"Ballard County, Kentucky",8216,4081,4135,7741,298,36,38,0,3,100,21,79,8120,96,0.4353,24459,25343,25423,11208,13082,3031,3689,-666666666,,6266,21,007
"Barren County, Kentucky",43287,21084,22203,40179,1771,128,205,0,227,777,150,627,42007,1280,0.4390,20130,20582,20843,9957,14357,10857,37950,-666666666,15693,8022,21,009
"Bath County, Kentucky",12113,6015,6098,11648,189,9,23,0,95,149,0,149,11930,183,0.4977,19590,19589,19722,21074,20424,,28209,-666666666,38558,6348,21,011
"Bell County, Kentucky",27676,13503,14173,26288,934,9,101,0,40,304,9,295,27557,119,0.4854,13654,13845,13842,14939,9929,,26820,-666666666,,5890,21,013
"Boone County, Kentucky",125656,62107,63549,115329,3473,214,3059,0,935,2646,0,2646,120672,4984,0.4111,31593,31607,32108,22309,29398,161286,45270,-666666666,13834,13860,21,015
"Bourbon County, Kentucky",20004,9772,10232,18057,1435,7,55,0,308,142,0,142,18677,1327,0.4553,24433,25457,26296,11076,16303,,11233,-666666666,10499,12970,21,017
"Boyd County, Kentucky",48716,24164,24552,45988,1279,85,188,0,119,1057,73,984,47932,784,0.5091,25939,26164,26254,11587,22095,3626,68415,-666666666,,17623,21,019
"Boyle County, Kentucky",29650,14774,14876,26342,2088,55,235,0,99,831,44,787,28724,926,0.4819,23276,24059,24457,10299,17768,12524,26151,-666666666,3935,14510,21,021
"Bracken County, Kentucky",8404,4188,4216,8272,2,0,8,0,72,50,0,50,8274,130,0.4612,21569,21843,21894,9151,,-666666666,,-666666666,,,21,023
"Breathitt County, Kentucky",13476,6742,6734,13166,81,15,60,0,20,134,0,134,13361,115,0.5063,15798,15755,15816,2743,2649,25000,53683,-666666666,,12301,21,025
"Breckinridge County, Kentucky",20000,10026,9974,19145,353,0,76,0,45,381,0,381,19757,243,0.4111,19984,20115,20205,10684,20813,-666666666,31957,-666666666,6420,11838,21,027
"Bullitt County, Kentucky",77727,38657,39070,74875,486,105,407,96,362,1396,19,1377,76407,1320,0.3813,25805,26099,26215,14829,28412,18132,21073,,12588,12908,21,029
"Butler County, Kentucky",12828,6440,6388,12368,146,44,0,0,163,107,10,97,12389,439,0.4326,20591,20689,20974,12670,29862,,-666666666,-666666666,,17735,21,031
"Caldwell County, Kentucky",12758,6123,6635,11805,780,0,0,25,0,148,12,136,12562,196,0.4764,23308,23985,24234,7757,16020,-666666666,-666666666,,-666666666,7146,21,033
"Calloway County, Kentucky",38302,18356,19946,35037,1386,116,653,0,89,1021,109,912,37328,974,0.4985,21109,21863,22109,8824,19683,15373,12870,-666666666,13435,3763,21,035
"Campbell County, Kentucky",91456,44729,46727,85812,3056,67,690,31,433,1367,136,1231,89781,1675,0.4468,29834,30924,31117,15932,12437,40904,16676,,15765,11541,21,037
"Carlisle County, Kentucky",4954,2408,2546,4782,92,24,3,0,6,47,13,34,4843,111,0.4369,23456,23981,24176,11657,14127,,,-666666666,,,21,039
"Carroll County, Kentucky",10776,5520,5256,9669,273,21,39,0,605,169,5,164,10052,724,0.4594,21639,22736,22809,12687,9240,,23003,-666666666,13633,9720,21,041
"Carter County, Kentucky",27292,13473,13819,26736,243,37,32,4,23,217,0,217,26965,327,0.4312,19170,19385,19506,8807,2770,14905,,,,13135,21,043
"Casey County, Kentucky",15928,7854,8074,15477,106,54,44,0,61,186,61,125,15498,430,0.4673,18146,18329,18477,11119,9086,9419,20025,-666666666,14603,11332,21,045
"Christian County, Kentucky",73936,39157,34779,53122,15149,467,1100,267,698,3133,175,2958,68530,5406,0.4498,19962,22329,22749,14420,15164,13072,20292,10701,10359,6864,21,047
"Clark County, Kentucky",35706,17464,18242,33112,1860,32,216,0,155,331,17,314,34723,983,0.4416,25674,26246,26556,14393,16708,,13858,-666666666,20282,30227,21,049
"Clay County, Kentucky",21160,11267,9893,19817,849,71,13,13,139,258,56,202,20705,455,0.5069,14255,14582,14693,6345,11399,13951,,,3117,6049,21,051
"Clinton County, Kentucky",10172,5087,5085,9966,72,0,23,0,14,97,65,32,9893,279,0.4894,18444,18653,18850,7214,3025,-666666666,,-666666666,14800,4233,21,053
"Crittenden County, Kentucky",9211,4652,4559,8964,117,8,5,0,11,106,0,106,9132,79,0.4577,21735,22124,22243,6805,7279,,,-666666666,,6337,21,055
"Cumberland County, Kentucky",6780,3363,3417,6415,223,0,27,0,0,115,0,115,6766,14,0.4785,18362,18855,18874,,12205,-666666666,,-666666666,-666666666,1381,21,057
"Daviess County, Kentucky",98724,47998,50726,90333,4593,136,1138,0,387,2137,127,2010,96018,2706,0.4491,25026,25984,26427,9260,16229,12874,26859,-666666666,8635,6211,21,059
"Edmonson County, Kentucky",12086,5991,6095,11634,204,21,21,0,0,206,29,177,11935,151,0.4380,20194,20598,20695,2709,9158,54376,,-666666666,-666666666,4069,21,061
"Elliott County, Kentucky",7661,4321,3340,7453,179,7,4,0,12,6,0,6,7644,17,0.4756,14218,14546,14549,,2859,,,-666666666,,,21,063
"Estill County, Kentucky",14406,7062,7344,14110,17,21,0,1,7,250,7,243,14366,40,0.4551,16763,16917,16953,6738,20788,23757,-666666666,,,6887,21,065
"Fayette County, Kentucky",311529,152953,158576,236242,45319,1022,10891,129,8537,9389,940,8449,290207,21322,0.4962,30502,34126,35036,14855,18710,12641,33494,20529,12181,11505,21,067
"Fleming County, Kentucky",14543,7180,7363,14002,195,7,14,0,108,217,77,140,14372,171,0.5094,22222,22406,22408,10775,35635,,,-666666666,15977,3226,21,069
"Floyd County, Kentucky",38144,18695,19449,37313,279,39,114,0,42,357,36,321,37869,275,0.5087,18345,18248,18288,6174,5671,22159,128242,-666666666,,4920,21,071
"Franklin County, Kentucky",49982,24386,25596,41377,5149,108,881,10,737,1720,319,1401,48529,1453,0.4087,27252,29342,29436,17515,18117,14265,24139,,20242,9470,21,073
"Fulton County, Kentucky",6323,3141,3182,4503,1653,4,22,0,14,127,11,116,6286,37,0.4790,18067,19434,19429,8000,15257,,19277,-666666666,,7829,21,075
"Gallatin County, Kentucky",8543,4288,4255,8046,35,0,65,0,204,193,0,193,8106,437,0.3838,21452,21995,22288,10411,29171,-666666666,,-666666666,8395,12817,21,077
"Garrard County, Kentucky",17051,8359,8692,16392,207,24,27,0,35,366,11,355,16666,385,0.4319,23796,24037,24373,8534,32842,,,-666666666,,8590,21,079
"Grant County, Kentucky",24705,12263,12442,23439,146,48,21,0,591,460,17,443,24076,629,0.4062,19395,19809,19891,14255,6845,6096,,-666666666,12311,13635,21,081
"Graves County, Kentucky",37379,18309,19070,33979,1690,62,151,151,568,778,54,724,35162,2217,0.4633,21277,22404,22698,11300,11963,22298,22591,11209,4483,6165,21,083
"Grayson County, Kentucky",26092,13029,13063,25112,363,122,46,21,208,220,71,149,25773,319,0.4797,20783,20428,20487,39523,37439,6167,31983,,52338,11661,21,085
"Green County, Kentucky",11123,5447,5676,10594,249,0,43,0,0,237,15,222,11022,101,0.4774,20974,21473,21624,,12093,-666666666,32856,-666666666,-666666666,5811,21,087
"Greenup County, Kentucky",36255,17640,18615,35170,283,80,152,0,59,511,14,497,35882,373,0.4544,24446,24592,24474,32244,25420,10696,38667,-666666666,27507,11450,21,089
"Hancock County, Kentucky",8716,4500,4216,8433,100,0,8,0,3,172,18,154,8599,117,0.4076,22041,22235,22381,5067,22353,-666666666,,-666666666,,12841,21,091
"Hardin County, Kentucky",107573,53666,53907,85745,12482,255,2321,401,1283,5086,300,4786,101685,5888,0.4207,25561,26104,26344,18827,27842,21852,29038,21745,22368,10508,21,093
"Harlan County, Kentucky",28031,13647,14384,26775,685,36,115,28,125,267,45,222,27802,229,0.4863,16080,16267,16300,5134,12327,13050,12285,,8190,12252,21,095
"Harrison County, Kentucky",18629,9133,9496,17709,375,32,16,0,191,306,25,281,18211,418,0.4679,22024,22711,22802,10012,10289,,,-666666666,,8308,21,097
"Hart County, Kentucky",18510,9146,9364,17268,882,62,43,3,32,220,0,220,18193,317,0.4726,19566,19123,19139,16299,31678,30206,23521,,,4989,21,099
"Henderson County, Kentucky",46362,22480,23882,40972,3347,80,161,0,538,1264,136,1128,45323,1039,0.4594,23752,25009,25257,13692,17031,10599,18692,-666666666,16063,5536,21,101
"Henry County, Kentucky",15528,7699,7829,14488,539,42,0,11,262,186,5,181,15021,507,0.4018,22499,22940,23142,7496,21408,19279,-666666666,,5572,17217,21,103
"Hickman County, Kentucky",4691,2195,2496,4138,430,0,33,0,6,84,2,82,4650,41,0.3768,18416,19333,19498,,13572,-666666666,,-666666666,,4108,21,105
"Hopkins County, Kentucky",46359,22520,23839,41761,2928,148,235,0,228,1059,109,950,45508,851,0.4365,22672,23382,23427,16677,19661,14815,30570,-666666666,15160,3981,21,107
"Jackson County, Kentucky",13357,6646,6711,13275,19,3,0,0,0,60,0,60,13357,0,0.4572,16713,16689,16689,-666666666,,,-666666666,-666666666,-666666666,14028,21,109
"Jefferson County, Kentucky",759724,366994,392730,552489,159215,1114,19339,375,5030,22162,1811,20351,723156,36568,0.4829,29758,33661,34399,18840,18770,25320,30471,22688,19012,13569,21,111
"Jessamine County, Kentucky",51015,24991,26024,46814,1914,168,685,22,468,944,67,877,49481,1534,0.4902,27409,28512,28832,10612,15591,11958,26428,22082,7901,9925,21,113
"Johnson County, Kentucky",23280,11432,11848,22740,103,28,172,0,93,144,45,99,23109,171,0.4518,18290,18118,18109,16654,14026,,53297,-666666666,,1905,21,115
"Kenton County, Kentucky",163393,80736,82657,147685,7147,190,2005,73,2284,4009,313,3696,158596,4797,0.4422,28785,30176,30194,20407,16922,21066,24269,,13497,9765,21,117
"Knott County, Kentucky",15884,7887,7997,15478,152,0,11,20,0,223,44,179,15829,55,0.4840,17761,17836,17850,,11371,-666666666,,,-666666666,17474,21,119
"Knox County, Kentucky",31740,15460,16280,30820,461,106,136,0,3,214,0,214,31408,332,0.4815,15479,15715,15805,6718,9298,7316,3396,-666666666,,6747,21,121
"Assumption Parish, Louisiana",22973,11284,11689,15581,6881,141,48,0,154,168,13,155,22384,589,0.4732,24207,29534,29961,14889,12322,11890,44881,-666666666,18530,26627,22,007
"Avoyelles Parish, Louisiana",41252,20732,20520,27595,12594,505,137,30,119,272,25,247,40547,705,0.4920,19595,23899,24183,8968,10537,15706,29195,,10450,8564,22,009
"Beauregard Parish, Louisiana",36435,18600,17835,30060,4781,289,180,3,191,931,20,911,35136,1299,0.4457,23141,24005,24378,14087,18938,28283,20518,,21893,15636,22,011
"Bienville Parish, Louisiana",13924,6712,7212,7740,5765,14,2,0,215,188,60,128,13678,246,0.4985,22123,28644,28191,34483,14607,,,-666666666,3864,6759,22,013
"Bossier Parish, Louisiana",124720,61707,63013,90705,26788,721,1991,206,1370,2939,402,2537,116783,7937,0.4443,27210,30893,31817,16311,16893,19533,26847,18672,14389,16303,22,015
"Caddo Parish, Louisiana",253125,120312,132813,119554,123126,879,3053,81,2351,4081,987,3094,246295,6830,0.5147,25206,34604,34998,22319,16183,20433,35415,362142,19136,12326,22,017
"Calcasieu Parish, Louisiana",197233,96206,101027,139481,49002,683,2555,11,1249,4252,316,3936,191251,5982,0.4653,25249,28663,28827,21424,16693,27180,28375,,20414,11100,22,019
"Caldwell Parish, Louisiana",9997,5287,4710,8155,1641,91,28,0,8,74,7,67,9721,276,0.5299,19774,21860,22117,12738,10104,10396,33661,-666666666,,11035,22,021
"Cameron Parish, Louisiana",6739,3290,3449,6424,107,0,35,0,166,7,0,7,6397,342,0.4074,31007,31972,31301,31848,5363,-666666666,,-666666666,,,22,023
"Catahoula Parish, Louisiana",10145,5415,4730,6745,3324,8,15,0,11,42,7,35,10015,130,0.5207,21870,27834,27899,19922,9970,,,-666666666,,,22,025
"Claiborne Parish, Louisiana",16452,9408,7044,7589,8308,90,5,3,28,429,30,399,16224,228,0.5033,16417,22913,23017,1769,11121,17113,,,,4997,22,027
"Concordia Parish, Louisiana",20288,10295,9993,11776,8338,13,27,24,49,61,0,61,20027,261,0.5043,17110,22486,22571,17919,9613,,,,,,22,029
"De Soto Parish, Louisiana",27047,13053,13994,15986,10111,233,101,12,140,464,91,373,26300,747,0.4885,23284,28644,28863,17969,15109,24769,19854,,22556,16468,22,031
"East Baton Rouge Parish, Louisiana",445337,213365,231972,214016,203768,824,14383,89,4923,7334,270,7064,428097,17240,0.5004,29146,39612,40367,23477,19018,35408,27517,14125,18086,15270,22,033
"East Carroll Parish, Louisiana",7419,4256,3163,2015,5277,0,0,0,0,127,23,104,7361,58,0.5026,11133,21896,21977,10455,7239,-666666666,-666666666,-666666666,-666666666,,22,035
"East Feliciana Parish, Louisiana",19756,10746,9010,10617,8881,32,51,0,47,128,0,128,19464,292,0.4327,21850,28202,28605,11336,13562,,149933,-666666666,,31698,22,037
"Evangeline Parish, Louisiana",33765,17283,16482,23128,9260,62,118,0,641,556,43,513,32693,1072,0.4960,18440,23059,23269,5903,8741,21563,11121,-666666666,3456,6298,22,039
"Franklin Parish, Louisiana",20464,9963,10501,13474,6777,7,11,0,0,195,0,195,20401,63,0.4871,18178,23058,23140,3875,8909,,,-666666666,-666666666,2475,22,041
"Grant Parish, Louisiana",22372,12543,9829,17887,3207,277,54,0,332,615,278,337,21038,1334,0.4449,18376,20872,21506,5300,9234,3108,3233,-666666666,6655,8014,22,043
"Iberia Parish, Louisiana",73799,36031,37768,45666,23044,68,2056,0,854,2111,99,2012,70950,2849,0.4924,23737,29031,29433,17026,14041,23481,33166,-666666666,14962,9438,22,045
"Iberville Parish, Louisiana",33159,16812,16347,16352,16298,67,17,0,229,196,0,196,32335,824,0.4813,22397,31267,31624,15417,14013,4791,,-666666666,4940,7852,22,047
"Jackson Parish, Louisiana",15999,8165,7834,10871,4837,4,72,0,165,50,7,43,15754,245,0.4573,19293,22598,22719,18925,11993,,7699,-666666666,,80426,22,049
"Jefferson Parish, Louisiana",435204,211528,223676,277542,115424,1737,18169,149,13555,8628,1211,7417,374920,60284,0.4722,28067,33128,35374,19607,17976,21079,27836,8183,18910,16871,22,051
"Jefferson Davis Parish, Louisiana",31399,15351,16048,25191,5177,215,107,0,53,656,42,614,30720,679,0.4875,22665,24935,25197,14377,13597,24485,26903,-666666666,45736,3905,22,053
"Lafayette Parish, Louisiana",234963,114864,120099,164408,59975,449,3776,4,1504,4847,429,4418,224632,10331,0.4892,30403,36093,36957,19372,16731,46812,26513,,20513,11187,22,055
"Lafourche Parish, Louisiana",97688,47946,49742,77672,12975,2147,799,27,1714,2354,104,2250,93498,4190,0.4414,25299,27886,28075,20643,14442,20528,24544,,18931,9295,22,057
"LaSalle Parish, Louisiana",14927,7767,7160,12779,1844,148,2,12,19,123,0,123,14548,379,0.4879,19434,21317,21874,1545,7031,,,,,28732,22,059
"Lincoln Parish, Louisiana",47480,23134,24346,25626,19378,66,844,0,786,780,61,719,46153,1327,0.5392,21452,29242,29472,11358,12327,14936,10969,-666666666,16531,9054,22,061
"Livingston Parish, Louisiana",135925,66559,69366,123634,8128,401,626,8,1233,1895,305,1590,131359,4566,0.4290,26558,27395,27464,21020,17048,49521,20741,,17696,15504,22,063
"Madison Parish, Louisiana",11803,5884,5919,4244,7445,9,0,0,20,85,0,85,11575,228,0.5008,14564,20330,20593,14234,11353,,-666666666,-666666666,16960,2334,22,065
"Morehouse Parish, Louisiana",26739,12774,13965,13408,12881,21,92,0,147,190,83,107,26419,320,0.5043,18222,23569,23727,4728,13089,9100,7027,-666666666,,7504,22,067
"Natchitoches Parish, Louisiana",39258,18654,20604,21408,15874,500,251,0,397,828,53,775,38434,824,0.5513,19178,24757,24722,23093,12075,23403,14324,-666666666,12970,12999,22,069
"Orleans Parish, Louisiana",382922,182959,199963,130323,229143,776,11208,96,5144,6232,741,5491,361971,20951,0.5702,28444,49476,51928,24965,16808,30345,29414,17182,20013,21589,22,071
"Ouachita Parish, Louisiana",156398,74967,81431,93835,58684,430,1481,14,737,1217,222,995,153113,3285,0.4989,21866,27957,28136,18915,11885,23549,37109,,19521,15611,22,073
"Plaquemines Parish, Louisiana",23584,11585,11999,16385,4887,256,844,0,524,688,30,658,22119,1465,0.4625,25359,29686,30176,16237,14590,30716,23413,-666666666,9839,11019,22,075
"Pointe Coupee Parish, Louisiana",22366,10791,11575,13927,7874,53,26,0,161,325,0,325,21844,522,0.4932,25670,32173,32701,13437,15526,,30788,-666666666,9665,4225,22,077
"Rapides Parish, Louisiana",132373,63960,68413,84669,42345,790,2034,52,284,2199,269,1930,128513,3860,0.4747,22904,26782,27251,14285,15091,17483,32789,53902,18721,16648,22,079
"Red River Parish, Louisiana",8757,4230,4527,5079,3271,36,6,17,53,295,26,269,8590,167,0.5482,23748,32022,32210,13026,12782,,,,,3347,22,081
"Richland Parish, Louisiana",20692,10072,10620,12874,7525,14,22,0,79,178,33,145,20275,417,0.4767,19347,24421,24711,17258,10583,,6677,-666666666,7554,29156,22,083
"Sabine Parish, Louisiana",24144,12018,12126,16992,4043,1911,93,13,76,1016,64,952,23262,882,0.4876,22725,26621,26998,16708,11588,16983,13640,,9945,14372,22,085
"St. Bernard Parish, Louisiana",44091,21801,22290,31388,9678,293,996,35,686,1015,194,821,39823,4268,0.4377,19990,22382,22869,15521,13730,12434,16691,,9115,19103,22,087
"St. Charles Parish, Louisiana",52708,25783,26925,37063,13895,120,523,14,516,577,82,495,49710,2998,0.4280,28146,32041,32578,23203,18372,23478,21441,,25579,22388,22,089
"St. Helena Parish, Louisiana",10714,5205,5509,4775,5697,120,46,0,2,74,0,74,10701,13,0.4904,19134,26097,26132,13200,13258,,29267,-666666666,,8653,22,091
"St. James Parish, Louisiana",21581,10403,11178,10486,10789,23,54,0,63,166,96,70,21259,322,0.4521,25275,32475,32724,12934,18661,,,-666666666,6011,4745,22,093
"St. John the Baptist Parish, Louisiana",43888,21472,22416,18026,24192,27,343,58,467,775,273,502,41473,2415,0.4243,22775,28798,29464,19568,18289,,21675,11703,14162,29857,22,095
"St. Landry Parish, Louisiana",83699,40138,43561,47063,34476,54,305,0,405,1396,159,1237,82096,1603,0.5131,19008,24738,24854,17530,11637,42883,15076,-666666666,15651,8822,22,097
"St. Martin Parish, Louisiana",53385,26391,26994,35215,15651,415,527,17,425,1135,30,1105,51956,1429,0.4584,23597,27770,28018,14749,15613,21466,9628,,25948,10941,22,099
"St. Mary Parish, Louisiana",53053,26204,26849,31942,16655,572,902,8,1256,1718,113,1605,49622,3431,0.4641,21989,26306,27164,16096,14956,25789,19182,,18850,12510,22,101
"St. Tammany Parish, Louisiana",246269,119732,126537,206165,28550,1103,3809,86,1919,4637,492,4145,233371,12898,0.4590,31792,33846,34617,20207,20146,16482,32312,2844,31376,16077,22,103
"Tangipahoa Parish, Louisiana",127115,61684,65431,85433,37307,459,998,17,325,2576,141,2435,122140,4975,0.4707,22554,27121,27642,17360,13207,17311,17086,,17455,10010,22,105
"Tensas Parish, Louisiana",4793,2335,2458,2096,2669,0,0,0,16,12,0,12,4710,83,0.4999,16171,24119,24805,6554,10065,-666666666,-666666666,-666666666,5875,,22,107
"Terrebonne Parish, Louisiana",113099,55881,57218,80429,21574,6068,948,63,1150,2867,48,2819,107622,5477,0.4568,24069,27407,28017,17553,15168,17658,26585,44460,24301,9599,22,109
"Union Parish, Louisiana",22460,11100,11360,16056,5745,15,32,43,279,290,64,226,21439,1021,0.4738,20090,23739,24343,9815,11176,,,,6611,5931,22,111
"Vermilion Parish, Louisiana",59524,28756,30768,48363,8421,312,1331,0,162,935,31,904,57646,1878,0.4513,23521,26005,26474,11879,12784,14725,16679,-666666666,20159,4989,22,113
"Vernon Parish, Louisiana",52101,27428,24673,39884,7476,649,886,227,1015,1964,237,1727,47335,4766,0.4220,22297,23275,23880,16875,19357,20542,27078,22651,19192,13628,22,115
"Washington Parish, Louisiana",46367,22871,23496,31155,13821,124,98,5,228,936,30,906,45427,940,0.4900,17957,21102,21351,8161,11721,20800,14397,,10135,7211,22,117
"Webster Parish, Louisiana",40335,19558,20777,25658,13895,189,101,25,52,415,60,355,39632,703,0.4804,19512,23661,23999,8061,12139,15126,8806,,10708,13798,22,119
"West Baton Rouge Parish, Louisiana",25017,12436,12581,14832,9518,69,155,0,105,338,0,338,24305,712,0.4448,27245,32560,32534,27243,19827,,28968,-666666666,,10538,22,121
"West Carroll Parish, Louisiana",11370,5750,5620,9242,1817,31,5,0,161,114,0,114,11027,343,0.5012,21459,24146,22838,52914,8930,14752,,-666666666,,20396,22,123
"Livingston County, Missouri",15057,6773,8284,14194,423,90,79,26,55,190,20,170,14828,229,0.4660,22804,23270,23467,3407,7463,12292,91882,,2442,6967,29,117
"McDonald County, Missouri",22720,11570,11150,20197,421,610,307,313,173,699,41,658,20123,2597,0.4288,18761,19091,19984,14986,12278,14652,8381,8376,56917,16495,29,119
"Macon County, Missouri",15399,7595,7804,14569,355,44,64,0,45,322,42,280,15216,183,0.4111,19941,20459,20509,11858,11521,15020,24958,-666666666,18071,5741,29,121
"Madison County, Missouri",12403,6087,6316,11844,178,60,79,0,0,242,0,242,12299,104,0.4319,19009,18800,18681,45926,,21820,81811,-666666666,-666666666,14286,29,123
"Maries County, Missouri",8987,4453,4534,8805,44,87,16,0,0,35,0,35,8817,170,0.4092,20922,21171,21375,10806,3325,10714,,-666666666,-666666666,11237,29,125
"Marion County, Missouri",28858,13914,14944,26255,1469,124,261,11,40,698,0,698,28407,451,0.4211,22303,22950,22849,18518,17635,6419,39073,,,5293,29,127
"Mercer County, Missouri",3702,1856,1846,3594,17,0,19,5,16,51,0,51,3655,47,0.3968,20701,21128,21180,12204,2365,-666666666,,,11969,4698,29,129
"Miller County, Missouri",25011,12354,12657,24074,134,322,106,0,173,202,1,201,24574,437,0.4709,22397,22914,23034,9975,3923,15189,1296,-666666666,6607,9151,29,131
"Mississippi County, Missouri",14112,7568,6544,10359,3348,107,0,5,16,277,56,221,13844,268,0.4913,17049,20141,20406,7290,8289,20693,-666666666,,,4866,29,133
"Moniteau County, Missouri",15840,8295,7545,14720,533,47,14,0,182,344,17,327,15133,707,0.3993,21068,21915,22317,12380,7943,32589,18571,-666666666,18905,4819,29,135
"Monroe County, Missouri",8642,4333,4309,8200,253,72,20,23,0,74,0,74,8518,124,0.3800,21069,21525,21724,7901,11363,11551,20075,,-666666666,9504,29,137
"Montgomery County, Missouri",11820,5885,5935,11340,178,5,31,7,22,237,0,237,11624,196,0.4196,21301,21721,21876,12383,18174,,,,17650,7190,29,139
"Morgan County, Missouri",20182,10136,10046,19426,188,58,15,0,67,428,18,410,19770,412,0.4691,19555,19997,20032,14469,10883,,,-666666666,,8100,29,141
"New Madrid County, Missouri",18229,8758,9471,14828,2902,36,15,0,41,407,35,372,17932,297,0.4680,19011,20454,20462,17366,12375,,,-666666666,25080,7967,29,143
"Newton County, Missouri",58741,29291,29450,53379,529,1317,706,543,303,1964,101,1863,55815,2926,0.4635,23874,24466,25124,11002,12452,23135,27907,12836,19829,13590,29,145
"Nodaway County, Missouri",23026,11399,11627,21666,631,78,299,84,24,244,36,208,22677,349,0.4521,19378,19910,20046,7215,10681,5324,11351,19435,13613,9507,29,147
"Oregon County, Missouri",10922,5384,5538,10455,19,139,50,0,41,218,0,218,10749,173,0.4584,18080,18113,18122,17042,11305,7727,,-666666666,22176,11422,29,149
"Osage County, Missouri",13704,7153,6551,13458,103,40,8,4,40,51,21,30,13602,102,0.3689,24097,24349,24298,27560,6677,20265,,,,5553,29,151
"Ozark County, Missouri",9450,4739,4711,9106,5,6,0,0,46,287,0,287,9293,157,0.4102,16706,17032,17104,4421,,,-666666666,-666666666,7354,8192,29,153
"Pemiscot County, Missouri",17599,8318,9281,12332,4748,61,0,2,156,300,24,276,17171,428,0.4628,17681,20569,20668,13862,10424,12080,-666666666,,16112,15755,29,155
"Perry County, Missouri",19152,9481,9671,18682,93,79,123,0,16,159,0,159,18755,397,0.3863,24658,24934,25148,16001,6774,13563,10601,-666666666,,20394,29,157
"Pettis County, Missouri",42193,20704,21489,38333,1248,60,184,37,1024,1307,211,1096,38711,3482,0.4249,20643,21316,21987,9980,14504,19540,18524,,9683,15243,29,159
"Phelps County, Missouri",44833,23404,21429,40714,1222,418,1552,0,59,868,20,848,43772,1061,0.4751,22400,22905,22938,16574,11893,26331,23085,-666666666,13878,11000,29,161
"Pike County, Missouri",18475,10249,8226,16548,1179,75,43,12,166,452,9,443,18078,397,0.4113,19900,20873,21067,5865,12112,16437,4005,,11445,10059,29,163
"Platte County, Missouri",94970,46798,48172,82413,6573,348,2449,20,800,2367,156,2211,89638,5332,0.4217,36160,37533,38192,25242,29466,24834,25283,32995,29475,22165,29,165
"Polk County, Missouri",31113,15225,15888,29793,264,270,91,0,84,611,0,611,30405,708,0.4207,20553,20755,20938,12453,5324,25793,8341,-666666666,28362,15705,29,167
"Pulaski County, Missouri",53302,30338,22964,39973,7470,516,954,181,1716,2492,286,2206,47721,5581,0.3803,20464,21813,21609,20595,16716,11965,24257,20102,21444,9719,29,169
"Putnam County, Missouri",4877,2448,2429,4752,17,7,28,0,4,69,29,40,4808,69,0.4180,20636,20665,20668,14397,,,13193,-666666666,,3577,29,171
"Ralls County, Missouri",10225,5191,5034,9902,123,58,4,3,1,134,6,128,10094,131,0.3840,24099,24346,24483,10829,17889,32250,,,,8940,29,173
"Randolph County, Missouri",25081,13155,11926,22676,1283,106,128,20,94,774,58,716,24601,480,0.4313,18615,19423,19599,10905,11134,8049,8530,,28533,9517,29,175
"Ray County, Missouri",22921,11340,11581,21920,346,110,47,3,104,391,41,350,22394,527,0.3943,24429,24733,24939,9971,15634,32700,51836,,6600,14425,29,177
"Reynolds County, Missouri",6530,3374,3156,6250,112,54,6,8,15,85,0,85,6445,85,0.4436,20792,21147,21327,4265,4622,19315,,,,20007,29,179
"Ripley County, Missouri",13936,6897,7039,13458,24,30,12,0,27,385,12,373,13769,167,0.4311,17986,18198,18379,4559,5925,,,-666666666,21744,10413,29,181
"St. Charles County, Missouri",379856,186762,193094,343464,16761,736,8873,133,1818,8071,484,7587,368141,11715,0.3930,34021,34948,35348,20009,26458,28364,33003,29035,16580,15942,29,183
"St. Clair County, Missouri",9444,4750,4694,9055,73,38,26,0,34,218,2,216,9243,201,0.4330,19370,19601,19458,20616,4575,2208,95719,-666666666,,10242,29,185
"Ste. Genevieve County, Missouri",17937,9037,8900,17245,193,0,16,359,10,114,0,114,17754,183,0.3796,24013,24549,24621,17320,9399,-666666666,,,,4006,29,186
"St. Francois County, Missouri",66230,35676,30554,61766,3137,161,105,0,97,964,115,849,65280,950,0.4238,20016,20656,20690,25478,6352,37111,23015,-666666666,15586,20749,29,187
"St. Louis County, Missouri",1000560,474388,526172,692735,235920,1622,38459,222,6908,24694,1795,22899,973552,27008,0.4862,36518,42854,43272,25434,20172,26657,39094,26359,18376,16744,29,189
"Saline County, Missouri",23214,11587,11627,19929,1226,34,61,232,825,907,195,712,21013,2201,0.4140,20446,21573,21983,12560,17890,52400,15077,4215,10875,11139,29,195
"Schuyler County, Missouri",4396,2155,2241,4293,47,3,0,0,0,53,0,53,4381,15,0.4516,19152,19297,19338,,9402,,-666666666,-666666666,-666666666,16109,29,197
"Scotland County, Missouri",4893,2388,2505,4788,82,0,0,0,0,23,0,23,4877,16,0.4981,23626,24027,23869,70356,1084,-666666666,-666666666,-666666666,-666666666,20570,29,199
"Scott County, Missouri",38994,18943,20051,33414,4726,143,33,0,192,486,45,441,38177,817,0.4547,22034,23571,23718,14435,13051,19945,34912,-666666666,7806,9111,29,201
"Shannon County, Missouri",8256,4056,4200,7896,16,133,0,0,31,180,0,180,8110,146,0.4519,19290,19544,19434,20821,,13056,-666666666,-666666666,,16721,29,203
"Shelby County, Missouri",6148,3065,3083,5988,112,1,4,3,7,33,14,19,6055,93,0.4064,21521,21950,22055,12190,4677,,,,,3739,29,205
"Stoddard County, Missouri",29788,14509,15279,28952,459,38,14,0,34,291,22,269,29320,468,0.4364,21174,21285,21370,14863,22388,9200,,-666666666,,10510,29,207
"Stone County, Missouri",31197,15297,15900,30109,43,261,9,12,198,565,53,512,30581,616,0.4291,23705,24009,24092,17372,6523,16447,,,21186,12612,29,209
"Sullivan County, Missouri",6416,3255,3161,5947,87,30,48,0,202,102,18,84,5241,1175,0.3997,20579,21221,22227,14839,19829,11837,12133,-666666666,12273,6788,29,211
"Taney County, Missouri",53853,26219,27634,49835,462,358,437,19,1311,1431,116,1315,50961,2892,0.4313,20929,21083,21428,12140,20413,15135,45637,,15125,14862,29,213
"Texas County, Missouri",25690,13201,12489,23898,451,602,29,0,80,630,17,613,25177,513,0.4329,17367,18256,18391,10395,3137,5261,12476,-666666666,5674,7096,29,215
"Vernon County, Missouri",20836,10209,10627,19959,200,97,142,0,2,436,8,428,20411,425,0.4297,21246,21803,21997,8753,5884,14265,7524,-666666666,,8869,29,217
"Warren County, Missouri",33290,16777,16513,31302,703,56,124,83,349,673,11,662,32236,1054,0.4218,24870,25732,26022,11811,12842,44368,15304,9637,12083,5994,29,219
"Washington County, Missouri",25002,12835,12167,23702,594,96,9,13,5,583,18,565,24923,79,0.4459,18472,18895,18766,58427,4023,38465,,,,13119,29,221
"Wayne County, Missouri",13341,6640,6701,12944,90,51,8,0,2,246,8,238,13146,195,0.4233,18378,18519,18646,9667,14019,20912,,-666666666,,11085,29,223
"Webster County, Missouri",37075,18883,18192,35389,458,153,112,66,307,590,74,516,36379,696,0.4171,20424,20638,20738,11196,14296,17271,22479,,14863,17897,29,225
"Worth County, Missouri",2061,984,1077,2013,0,0,0,0,0,48,11,37,2028,33,0.3912,23292,23280,23322,18633,-666666666,-666666666,-666666666,-666666666,-666666666,23808,29,227
"Wright County, Missouri",18378,9003,9375,17779,115,30,63,0,83,308,0,308,18074,304,0.4855,18502,17485,17586,11348,133282,9583,145257,-666666666,17755,9462,29,229
"St. Louis city, Missouri",316030,152766,163264,144226,151372,734,9660,162,2825,7051,447,6604,303814,12216,0.5186,25434,36742,38013,18328,15559,24388,22732,13333,17080,13555,29,510
"Beaverhead County, Montana",9317,4649,4668,8876,8,209,154,0,15,55,0,55,8959,358,0.5067,26609,27507,28117,12954,,9118,3779,-666666666,26233,12309,30,001
"Big Horn County, Montana",13214,6522,6692,4188,13,8594,12,4,14,389,24,365,12523,691,0.4331,17352,28142,30031,11754,,12276,,,31257,11813,30,003
"Blaine County, Montana",6609,3283,3326,3126,15,3269,0,8,34,157,12,145,6451,158,0.4317,17080,22637,22824,6665,80540,11709,-666666666,,15282,11218,30,005
"Broadwater County, Montana",5692,2928,2764,5367,10,86,80,0,23,126,16,110,5622,70,0.4234,29598,30248,30299,40261,,13862,,-666666666,,21623,30,007
"Carbon County, Montana",10340,5171,5169,10038,1,133,24,0,0,144,0,144,10094,246,0.4304,30461,30838,31349,11353,,22086,34896,-666666666,-666666666,11292,30,009
"West Feliciana Parish, Louisiana",15384,9325,6059,8192,7004,45,19,0,19,105,6,99,15143,241,0.4712,22335,33215,33972,4072,10041,,,-666666666,,2626,22,125
"Winn Parish, Louisiana",14695,7735,6960,9762,4605,137,0,0,75,116,4,112,14422,273,0.5011,18358,23443,23532,14770,8019,15188,-666666666,-666666666,,9157,22,127
"Androscoggin County, Maine",107376,52566,54810,99069,1884,147,832,2,220,5222,108,5114,105515,1861,0.4338,25788,26914,27065,13969,8703,12747,20441,,18650,12113,23,001
"Aroostook County, Maine",69405,34255,35150,66055,597,1144,320,6,161,1122,82,1040,68669,736,0.4454,22483,22823,22889,17094,20434,10267,25795,,36247,13152,23,003
"Cumberland County, Maine",288204,140167,148037,265918,7833,650,5899,4,1132,6768,252,6516,282666,5538,0.4638,35066,36548,36763,19759,11973,22460,21772,,20484,18816,23,005
"Franklin County, Maine",30270,14841,15429,29281,131,126,145,39,85,463,6,457,29886,384,0.4346,23596,23951,23955,21288,7891,19698,16381,,19069,8716,23,007
"Hancock County, Maine",54483,26530,27953,52462,320,211,518,15,19,938,10,928,53772,711,0.4702,30042,30384,30551,17085,27579,14669,30577,,27253,15211,23,009
"Kennebec County, Maine",120953,58816,62137,115938,1139,685,1006,51,476,1658,70,1588,119223,1730,0.4335,26418,26835,26831,21284,10779,24012,25308,12425,14709,13472,23,011
"Knox County, Maine",39717,19601,20116,38340,247,195,259,0,41,635,34,601,39224,493,0.4130,28413,28926,29058,12448,14663,19694,13095,-666666666,9944,12890,23,013
"Lincoln County, Maine",34165,16771,17394,33153,51,159,517,0,20,265,0,265,33813,352,0.4315,30022,30392,30474,21651,19918,14304,17826,-666666666,9670,20415,23,015
"Oxford County, Maine",57299,28391,28908,55427,196,283,343,0,101,949,9,940,56611,688,0.4219,21674,22029,22051,19636,8725,12110,15513,-666666666,13853,9519,23,017
"Penobscot County, Maine",152978,75521,77457,145472,1174,1751,1724,28,258,2571,80,2491,151083,1895,0.4484,25035,25312,25333,18980,18446,15369,36316,30039,9037,12967,23,019
"Piscataquis County, Maine",17044,8470,8574,16401,88,94,64,0,69,328,40,288,16834,210,0.4283,22398,22850,22917,11970,11014,7621,29730,-666666666,6967,8920,23,021
"Sagadahoc County, Maine",35134,17052,18082,33609,255,143,240,0,30,857,21,836,34616,518,0.4193,31085,31556,31605,23905,25215,28085,37511,-666666666,,13009,23,023
"Somerset County, Maine",51363,25361,26002,49743,274,215,161,26,23,921,26,895,50856,507,0.4305,21961,22141,22209,12995,16833,14141,17613,,9087,16761,23,025
"Waldo County, Maine",39071,19311,19760,37789,232,75,282,2,77,614,3,611,38625,446,0.4372,25270,25583,25668,23712,7911,30140,9887,,69817,13477,23,027
"Washington County, Maine",31925,15779,16146,29167,137,1438,154,14,172,843,28,815,31344,581,0.4540,23113,23752,23877,15023,36642,15247,28802,,20924,11917,23,029
"York County, Maine",200536,97912,102624,192652,1745,697,2179,24,267,2972,72,2900,197414,3122,0.4322,31574,32094,32268,20088,20414,14513,25241,28321,33767,12916,23,031
"Allegany County, Maryland",73060,38077,34983,64695,6021,118,580,34,167,1445,96,1349,71827,1233,0.4542,22029,23914,24041,10258,5571,8337,23305,35403,6346,8318,24,001
"Anne Arundel County, Maryland",559737,276842,282895,416331,89001,1222,20103,383,12470,20227,1358,18869,520335,39402,0.4159,42382,46400,47437,25246,32638,34362,39520,23998,21747,18946,24,003
"Baltimore County, Maryland",825666,391102,434564,519063,226879,2110,47772,394,7828,21620,2162,19458,784816,40850,0.4454,35777,40348,41353,20858,28657,28228,31456,25986,17992,17622,24,005
"Calvert County, Maryland",90527,44966,45561,73873,11124,77,1371,0,530,3552,110,3442,87435,3092,0.3794,39897,42162,42437,28785,32452,,40008,-666666666,22230,19411,24,009
"Caroline County, Maryland",32653,15822,16831,26419,4411,30,187,16,623,967,88,879,30552,2101,0.4206,24311,25931,26650,12325,19165,24303,16502,,14384,11665,24,011
"Carroll County, Maryland",167535,82892,84643,155174,5538,306,2734,57,552,3174,522,2652,162439,5096,0.4035,38408,39320,39703,24665,27845,34100,33214,21047,27944,19294,24,013
"Cecil County, Maryland",102175,50603,51572,90516,6847,245,1367,42,962,2196,84,2112,98088,4087,0.4069,30676,31981,32330,19622,21901,10248,27318,28650,19581,13528,24,015
"Charles County, Maryland",154357,74489,79868,73744,65796,1026,4760,162,1169,7700,370,7330,146418,7939,0.3891,37680,42333,42837,31557,34545,46643,41182,23480,33441,17483,24,017
"Dorchester County, Maryland",32451,15519,16932,21527,9101,27,352,0,567,877,60,817,30935,1516,0.4682,28055,32488,32827,19534,19890,31515,22281,-666666666,17871,12753,24,019
"Frederick County, Maryland",243465,120072,123393,197960,22196,646,10701,146,4187,7629,842,6787,222980,20485,0.4002,38280,40619,41790,24250,28319,54850,34673,28384,22871,18878,24,021
"Garrett County, Maryland",29677,14701,14976,28842,187,45,93,6,15,489,65,424,29376,301,0.4423,25096,25565,25635,9474,5627,23816,16418,,,7317,24,023
"Harford County, Maryland",249776,122076,127700,199268,33742,443,6478,8,2806,7031,897,6134,239568,10208,0.4065,36411,38648,38952,26633,28112,33666,34732,,29074,17500,24,025
"Howard County, Maryland",308447,151100,157347,183599,56504,499,51545,132,4356,11812,880,10932,288852,19595,0.3966,49667,56696,58569,30158,39119,33913,44681,26537,22027,23735,24,027
"Kent County, Maryland",19819,9539,10280,16302,2949,36,207,0,24,301,4,297,18949,870,0.4547,30080,33014,33599,20884,17515,24164,8999,-666666666,9621,11120,24,029
"Montgomery County, Maryland",1026371,494612,531759,566239,182774,2857,149770,503,81619,42609,7448,35161,835821,190550,0.4603,49906,62929,69614,24268,32770,32758,46246,29101,18196,25340,24,031
"Prince George's County, Maryland",897693,431752,465941,173881,570138,3449,38063,269,86885,25008,3809,21199,747425,150268,0.3951,33220,36500,43610,18208,35270,24146,30149,40366,16970,25973,24,033
"Queen Anne's County, Maryland",48712,24151,24561,43698,3522,39,364,24,272,793,49,744,47044,1668,0.4091,39593,41370,42083,21381,26155,28005,27034,,19276,13245,24,035
"St. Mary's County, Maryland",110675,55176,55499,87669,15568,217,2964,31,616,3610,170,3440,105539,5136,0.3967,36814,39477,40175,25025,25677,64029,43312,,27002,14988,24,037
"Somerset County, Maryland",25899,13936,11963,13719,10837,69,269,14,384,607,110,497,24962,937,0.4695,17143,23148,23558,6150,10691,,12305,,5991,5635,24,039
"Talbot County, Maryland",37668,17733,19935,31262,4172,79,525,38,348,1244,154,1090,35370,2298,0.5073,40533,44547,46374,16500,19475,19363,37477,,18273,19618,24,041
"Washington County, Maryland",149571,76043,73528,124903,15402,313,2383,69,1040,5461,342,5119,143288,6283,0.4354,27586,29991,30343,15751,14721,47713,25605,24371,14221,11148,24,043
"Wicomico County, Maryland",101527,48364,53163,69094,25001,214,3232,64,979,2943,202,2741,96559,4968,0.4416,26498,29609,30435,15042,19916,15437,31987,59984,12723,7994,24,045
"Worcester County, Maryland",51441,24999,26442,42568,7056,80,727,58,122,830,48,782,49715,1726,0.4552,32988,35701,36206,23466,17766,29104,29082,39338,37203,25948,24,047
"Baltimore city, Maryland",621000,292168,328832,187894,391160,1799,15712,342,10065,14028,1181,12847,591463,29537,0.5156,27129,43166,45086,19618,19636,21815,35780,22287,16915,19692,24,510
"Barnstable County, Massachusetts",214703,102542,112161,198374,5611,909,3066,184,2339,4220,776,3444,209042,5661,0.4604,39104,40503,40799,23259,20971,29927,26769,21538,24240,17429,25,001
"Berkshire County, Massachusetts",128563,62125,66438,117656,3405,299,1946,50,1795,3412,379,3033,123343,5220,0.4656,31417,32889,33160,16091,13647,10905,32294,10246,13719,9314,25,003
"Bristol County, Massachusetts",554868,268739,286129,479496,20917,660,11959,311,26646,14879,3446,11433,515949,38919,0.4539,30525,32304,32834,13038,22197,24277,29175,24304,14786,14581,25,005
"Dukes County, Massachusetts",17137,8231,8906,15094,634,272,53,0,266,818,0,818,16851,286,0.5239,40051,42892,43066,21582,27135,20483,7792,-666666666,28032,10142,25,007
"Essex County, Massachusetts",769362,370538,398824,615804,31174,1658,26351,241,75137,18997,3914,15083,624519,144843,0.4783,37210,41294,43541,16482,24446,17418,35304,18412,15745,15278,25,009
"Franklin County, Massachusetts",70916,34721,36195,66473,884,173,1143,59,504,1680,261,1419,68317,2599,0.4438,31689,32445,32784,17285,13140,21321,22214,,17894,23783,25,011
"Hampden County, Massachusetts",468072,225908,242164,373605,40303,1489,10075,153,30673,11774,2352,9422,358945,109127,0.4655,27057,29587,33287,13135,19818,11689,24352,22933,13136,12148,25,013
"Hampshire County, Massachusetts",161035,75315,85720,142579,4543,276,8326,75,1362,3874,542,3332,152575,8460,0.4640,31051,32760,33525,16093,16122,17250,20017,35920,15612,15708,25,015
"Middlesex County, Massachusetts",1567610,765170,802440,1228790,78698,2335,170159,444,40735,46449,6502,39947,1450528,117082,0.4710,45579,49180,50505,22929,26176,28438,41987,59759,19654,19810,25,017
"Nantucket County, Massachusetts",10694,5728,4966,9122,726,62,105,0,236,443,62,381,9426,1268,0.4600,46009,50096,53477,24734,21017,,22084,-666666666,22154,22640,25,019
"Norfolk County, Massachusetts",691218,331220,359998,553150,44123,641,69384,76,9004,14840,1570,13270,663632,27586,0.4806,47306,51096,51582,31029,28860,34180,37154,19657,21387,24788,25,021
"Plymouth County, Massachusetts",506657,246500,260157,428806,46072,790,6399,126,12602,11862,2329,9533,488643,18014,0.4445,37188,40154,40586,18606,20021,27550,37286,41521,18788,16732,25,023
"Suffolk County, Massachusetts",767719,371314,396405,425220,173090,2856,65734,122,52828,47869,5961,41908,600273,167446,0.5327,35844,47059,52146,18671,21859,19005,27562,17378,16948,20067,25,025
"Worcester County, Massachusetts",813589,401320,412269,689496,39053,1511,37036,161,24435,21897,4073,17824,728361,85228,0.4516,33272,35083,36489,16402,20259,22948,34504,51430,17134,15963,25,027
"Alcona County, Michigan",10461,5277,5184,10184,26,52,43,4,15,137,13,124,10316,145,0.4202,23380,23749,23879,11838,12131,13413,7698,,,9532,26,001
"Alger County, Michigan",9396,5167,4229,8032,688,253,26,0,9,388,20,368,9269,127,0.4220,20993,23004,23102,12698,831,24602,10027,-666666666,,13288,26,003
"Allegan County, Michigan",113666,56627,57039,107300,1625,597,743,21,1021,2359,554,1805,105617,8049,0.4129,25840,26367,27080,14824,16355,21833,19701,,21043,13671,26,005
"Alpena County, Michigan",28929,14258,14671,28013,172,133,116,9,40,446,28,418,28554,375,0.4314,22776,22961,23049,19962,9701,14393,26412,,104935,9972,26,007
"Antrim County, Michigan",23215,11544,11671,22263,79,218,62,0,177,416,82,334,22761,454,0.4583,28180,28834,28905,12047,10604,11099,17906,-666666666,5864,16465,26,009
"Arenac County, Michigan",15327,7751,7576,14803,76,205,59,0,21,163,13,150,15036,291,0.4252,21602,21744,21858,15368,4017,22345,23020,-666666666,32652,14081,26,011
"Baraga County, Michigan",8612,5262,3350,6341,1567,352,36,3,19,294,9,285,8490,122,0.4305,17664,22375,22508,7261,577,14614,26158,,13484,8982,26,013
"Barry County, Michigan",59316,29844,29472,57126,365,154,301,7,509,854,87,767,57788,1528,0.3846,25909,26254,26367,16892,14426,23521,22908,,16465,15001,26,015
"Bay County, Michigan",106107,52254,53853,100361,1586,335,620,11,477,2717,101,2616,100757,5350,0.4371,24753,25307,25543,19244,18018,22136,28380,,16740,9161,26,017
"Benzie County, Michigan",17462,8709,8753,16756,75,222,66,4,41,298,19,279,17065,397,0.4007,25506,25785,25975,17378,5591,15800,33927,,25422,18535,26,019
"Berrien County, Michigan",155134,75899,79235,121439,22985,487,2921,68,2609,4625,347,4278,147301,7833,0.4720,26309,29810,30403,13449,12301,23292,29626,11579,11768,10635,26,021
"Branch County, Michigan",43603,22540,21063,41096,1004,119,186,11,449,738,67,671,41713,1890,0.4089,21838,22445,22889,11230,7372,23510,23293,,15139,11478,26,023
"Calhoun County, Michigan",134691,65829,68862,110966,14563,969,2731,32,669,4761,399,4362,128182,6509,0.4402,23812,25534,26048,14725,16275,17397,22932,,16670,9141,26,025
"Cass County, Michigan",51795,26062,25733,45880,2486,595,398,23,714,1699,76,1623,49995,1800,0.4503,25955,27276,27566,11949,19404,20489,24676,,9554,9331,26,027
"Charlevoix County, Michigan",26172,12905,13267,24866,91,309,101,9,121,675,76,599,25721,451,0.4687,29581,30376,30498,14067,16829,16540,31159,,9639,11337,26,029
"Cheboygan County, Michigan",25579,12719,12860,23858,188,519,95,0,13,906,11,895,25255,324,0.4549,24220,24711,24831,12042,51071,17482,13804,-666666666,18308,10768,26,031
"Chippewa County, Michigan",38330,21209,17121,27370,2564,5573,385,28,83,2327,86,2241,37691,639,0.4312,20839,23441,23615,7607,6677,18827,23401,17446,5808,10805,26,033
"Clare County, Michigan",30608,15126,15482,29520,156,145,78,0,72,637,33,604,30038,570,0.4471,20418,20724,20860,11122,8038,29190,18715,-666666666,15369,8093,26,035
"Clinton County, Michigan",77245,38180,39065,72543,1173,131,1226,0,275,1897,150,1747,73882,3363,0.4311,31170,31829,32185,23246,26620,24321,31573,-666666666,26084,9725,26,037
"Crawford County, Michigan",13840,6983,6857,13314,70,39,93,0,75,249,45,204,13596,244,0.4028,22348,22923,23039,9518,5370,30056,5239,-666666666,11357,4874,26,039
"Delta County, Michigan",36570,18088,18482,34406,91,736,95,24,39,1179,85,1094,36153,417,0.4387,24182,24743,24745,18238,8235,17063,31982,,15672,7658,26,041
"Dickinson County, Michigan",25889,12837,13052,25007,140,175,139,0,15,413,97,316,25543,346,0.4532,25136,25528,25581,12855,13421,7437,31388,-666666666,18533,11024,26,043
"Eaton County, Michigan",108544,52977,55567,94521,6718,528,2061,49,1582,3085,188,2897,102943,5601,0.4065,28624,29715,30116,18872,24046,19345,30628,15133,15724,12251,26,045
"Emmet County, Michigan",33091,16364,16727,30628,220,737,189,72,80,1165,35,1130,32585,506,0.4700,30250,31336,31388,25780,18248,19661,27913,9283,27965,12500,26,047
"Genesee County, Michigan",413090,199181,213909,309146,83620,1601,4068,103,2118,12434,716,11718,399664,13426,0.4581,23755,26191,26565,15759,15839,18994,35729,77781,20871,13175,26,049
"Gladwin County, Michigan",25367,12741,12626,24704,88,162,125,0,27,261,35,226,25013,354,0.4386,22255,22394,22430,17444,47767,18346,2592,-666666666,29011,11639,26,051
"Gogebic County, Michigan",15650,8425,7225,14164,708,374,85,13,24,282,51,231,15462,188,0.4559,21464,22695,22799,8336,4968,12885,27118,,,13126,26,053
"Grand Traverse County, Michigan",90715,44604,46111,85831,1158,1103,594,96,377,1556,93,1463,88337,2378,0.4477,30024,30775,31090,17676,12448,19350,19098,34552,32971,12419,26,055
"Gratiot County, Michigan",41676,22119,19557,38051,2367,190,110,7,180,771,160,611,39328,2348,0.4532,20358,21698,22137,13096,2182,18116,40967,,13948,8807,26,057
"Hillsdale County, Michigan",46024,22964,23060,44692,286,142,127,0,62,715,42,673,45049,975,0.4363,22435,22707,22729,20720,12730,18126,21213,-666666666,20097,10598,26,059
"Houghton County, Michigan",36565,19817,16748,34184,282,154,1088,7,106,744,51,693,36036,529,0.4589,20248,20435,20534,31140,39873,23945,18345,,4397,8625,26,061
"Huron County, Michigan",32021,15928,16093,31183,125,137,196,0,101,279,17,262,31323,698,0.4295,24455,24635,24878,12960,17339,12177,31729,-666666666,18991,10478,26,063
"Ingham County, Michigan",284559,138257,146302,214036,31804,1087,16525,108,4969,16030,1537,14493,263079,21480,0.4794,26083,28657,29170,17014,19336,29945,23125,34186,17786,10415,26,065
"Ionia County, Michigan",64126,33776,30350,58465,2392,378,194,0,646,2051,431,1620,61152,2974,0.3949,21526,22493,22783,13857,8277,21891,21403,-666666666,18406,10358,26,067
"Iosco County, Michigan",25373,12625,12748,24405,178,240,153,15,27,355,21,334,24875,498,0.4383,23723,24120,24192,19475,12716,18626,14018,,11052,10833,26,069
"Iron County, Michigan",11393,5619,5774,10938,63,144,52,0,55,141,18,123,11203,190,0.4428,22454,22761,22862,11138,6279,26244,10460,-666666666,12293,10339,26,071
"Isabella County, Michigan",70574,34284,36290,62445,1755,1932,1179,0,275,2988,121,2867,67961,2613,0.4904,21387,21533,21811,13460,12982,30750,31651,-666666666,19707,13308,26,073
"Jackson County, Michigan",159483,81632,77851,139499,13659,741,1135,107,822,3520,404,3116,154176,5307,0.4415,24444,26104,26443,13240,12399,13989,25265,11362,11333,10778,26,075
"Kalamazoo County, Michigan",258605,126410,132195,210867,28060,705,6042,45,1801,11085,486,10599,246746,11859,0.4670,27370,29605,30007,17378,16604,19031,35719,,18909,9497,26,077
"Kalkaska County, Michigan",17259,8835,8424,16612,117,105,88,52,47,238,0,238,16966,293,0.4309,22508,22950,22800,29643,8826,21840,4388,,13198,12121,26,079
"Kent County, Michigan",629352,309450,319902,508965,60729,2921,16882,97,17585,22173,2445,19728,565437,63915,0.4596,28070,31004,32467,12869,15781,14844,24161,19054,13359,10813,26,081
"Keweenaw County, Michigan",2195,1138,1057,2161,20,9,3,0,0,2,0,2,2171,24,0.4564,26328,26609,26753,10192,8540,,,-666666666,-666666666,,26,083
"Lake County, Michigan",11415,5841,5574,9983,827,81,18,4,20,482,20,462,11123,292,0.4429,17178,18055,18227,10533,12909,12801,25028,,13950,7056,26,085
"Lapeer County, Michigan",88310,44709,43601,84523,1094,276,383,25,521,1488,343,1145,84328,3982,0.3992,25373,25847,26213,15902,2668,26291,33220,,18987,15559,26,087
"Leelanau County, Michigan",21764,10686,11078,20191,109,728,167,7,124,438,60,378,20892,872,0.4767,35954,37597,38234,13180,10328,14728,14805,,32288,11509,26,089
"Lenawee County, Michigan",98673,49994,48679,91338,2891,443,264,55,1238,2444,385,2059,91106,7567,0.4204,24512,25146,25607,16740,11090,20934,44350,,14602,20252,26,091
"Livingston County, Michigan",185841,93057,92784,179295,921,449,1751,81,526,2818,213,2605,181747,4094,0.3952,35156,35420,35628,22233,25980,26062,41276,15619,23710,21734,26,093
"Luce County, Michigan",6451,3784,2667,5131,482,522,2,4,35,275,33,242,6269,182,0.4060,18444,20549,20723,6649,2471,14200,,,5394,15700,26,095
"Mackinac County, Michigan",10998,5581,5417,8227,241,1775,96,0,15,644,38,606,10831,167,0.4314,25604,28689,28707,16129,7677,17530,22631,-666666666,,15569,26,097
"Macomb County, Michigan",859703,418599,441104,711089,91582,2136,30459,224,4116,20097,1218,18879,838676,21027,0.4253,28588,30347,30534,21592,20244,18778,24582,,20429,13070,26,099
"Manistee County, Michigan",24465,12691,11774,22401,698,483,100,9,23,751,59,692,23785,680,0.4252,23290,24388,24709,9310,6628,17284,19564,,10522,10336,26,101
"Marquette County, Michigan",67418,34041,33377,62911,1109,670,515,32,159,2022,146,1876,66477,941,0.4416,24275,25053,25208,7098,6320,20115,24509,5178,10155,12662,26,103
"Mason County, Michigan",28755,14295,14460,27466,251,259,168,0,75,536,167,369,27498,1257,0.4469,24643,25104,25532,14377,7986,20853,17686,-666666666,14847,14167,26,105
"Mecosta County, Michigan",43259,21816,21443,40303,1140,210,359,27,197,1023,56,967,42364,895,0.4476,20690,21269,21385,12626,13753,20611,16238,19644,5006,10239,26,107
"Menominee County, Michigan",23568,11917,11651,22286,65,535,66,0,36,580,41,539,23185,383,0.4408,24789,25474,25629,10404,13798,12839,51005,-666666666,16050,8304,26,109
"Midland County, Michigan",83559,41100,42459,78157,1216,380,1890,65,358,1493,240,1253,81469,2090,0.4654,31135,31514,31803,15503,15143,18527,42331,42062,17355,16160,26,111
"Missaukee County, Michigan",15032,7685,7347,14558,86,108,69,0,34,177,13,164,14652,380,0.4036,21124,21355,21591,11163,7451,15983,27099,-666666666,17924,10203,26,113
"Monroe County, Michigan",149945,73941,76004,142076,3489,621,928,6,561,2264,166,2098,144896,5049,0.4140,27809,28320,28683,17174,17063,27172,31425,,18435,13343,26,115
"Montcalm County, Michigan",62922,32440,30482,59322,1261,339,247,13,293,1447,390,1057,60827,2095,0.4095,20504,20810,20960,12861,16075,21506,39630,,10242,10581,26,117
"Montmorency County, Michigan",9317,4738,4579,9038,23,68,2,0,35,151,2,149,9201,116,0.4083,21621,21893,21895,14716,9978,23063,,-666666666,,10193,26,119
"Muskegon County, Michigan",172148,85520,86628,138915,23604,1256,940,58,885,6490,550,5940,162975,9173,0.4321,21614,23811,24309,13618,12299,11888,26221,22947,19179,9982,26,121
"Newaygo County, Michigan",47957,24143,23814,45028,650,267,165,0,959,888,119,769,45210,2747,0.4315,21905,22448,22828,12440,13337,16894,21076,-666666666,14065,10787,26,123
"Oakland County, Michigan",1235215,600602,634613,937568,170742,3268,80680,207,9390,33360,2425,30935,1188732,46483,0.4683,38992,41551,42168,23101,27700,27651,44134,58684,22479,18075,26,125
"Oceana County, Michigan",26152,13234,12918,24906,305,178,65,0,322,376,103,273,22381,3771,0.4186,20760,21155,22657,11493,11531,17952,17962,-666666666,10643,12537,26,127
"Ogemaw County, Michigan",21103,10562,10541,20439,64,252,113,0,50,185,15,170,20708,395,0.4347,21515,21621,21589,20782,9745,21969,27173,-666666666,13882,11891,26,129
"Ontonagon County, Michigan",6165,3160,3005,5928,17,67,47,3,29,74,13,61,6091,74,0.4135,22428,22733,22727,20330,20741,24249,4587,,,14012,26,131
"Osceola County, Michigan",23172,11692,11480,22365,218,172,70,2,19,326,9,317,22785,387,0.4308,19853,20229,20383,10749,6521,10484,12706,,,9547,26,133
"Oscoda County, Michigan",8374,4312,4062,8093,49,55,6,14,24,133,0,133,8264,110,0.4307,20047,20267,20333,9482,13669,8062,,,,16635,26,135
"Otsego County, Michigan",24198,11924,12274,23231,114,158,144,0,19,532,33,499,23817,381,0.4226,25655,26302,26390,14117,14497,24110,10192,-666666666,,5365,26,137
"Ottawa County, Michigan",276583,136286,140297,249851,4001,1263,7561,28,7630,6249,1027,5222,250925,25658,0.4156,27696,28996,29866,15658,13992,15576,19758,,15947,11026,26,139
"Presque Isle County, Michigan",12955,6459,6496,12585,67,52,49,0,21,181,9,172,12810,145,0.3994,23862,24158,24329,7654,6534,22235,29659,-666666666,18738,9167,26,141
"Roscommon County, Michigan",23900,11858,12042,23137,48,270,52,0,19,374,9,365,23536,364,0.4218,21807,22039,22230,10575,7388,12853,13450,-666666666,,16877,26,143
"Saginaw County, Michigan",195201,94684,100517,146532,36154,478,2315,57,3423,6242,873,5369,179198,16003,0.4563,24020,26993,27794,15406,14280,19794,41717,12677,18637,7455,26,145
"St. Clair County, Michigan",160069,79403,80666,149831,3416,305,1155,0,1157,4205,381,3824,155011,5058,0.4310,26377,27010,27227,17163,17538,19267,26326,-666666666,20635,13096,26,147
"St. Joseph County, Michigan",60923,30276,30647,55797,1537,290,314,20,1450,1515,112,1403,56467,4456,0.4138,22182,22976,23642,10944,14804,9436,33772,,12626,9639,26,149
"Sanilac County, Michigan",41761,20737,21024,40382,233,138,149,2,223,634,85,549,40241,1520,0.4246,22510,22860,23088,13306,13282,19488,19254,,16333,7300,26,151
"Schoolcraft County, Michigan",8186,4047,4139,7118,48,489,151,0,13,367,4,363,8114,72,0.4433,20975,21903,22064,4564,7479,18307,7279,-666666666,3546,14534,26,153
"Shiawassee County, Michigan",68800,33922,34878,66636,293,178,346,21,176,1150,65,1085,66901,1899,0.4079,23927,24184,24321,18117,13834,18846,24593,,17177,13620,26,155
"Tuscola County, Michigan",54014,27123,26891,52121,666,139,186,0,170,732,38,694,52300,1714,0.4036,22511,22805,23054,14050,9793,21061,40528,-666666666,15986,10339,26,157
"Van Buren County, Michigan",75216,37361,37855,65599,2552,589,409,19,2873,3175,760,2415,66934,8282,0.4432,23943,25610,26433,11622,15011,14782,29637,,11478,9059,26,159
"Washtenaw County, Michigan",358082,177102,180980,264906,42970,1076,30582,151,3054,15343,950,14393,342174,15908,0.4796,35888,39495,40110,22860,21605,19816,35239,9858,18450,19762,26,161
"Wayne County, Michigan",1767593,849914,917679,940071,694872,5950,52168,329,32715,41488,4882,36606,1667841,99752,0.4955,23666,29743,30706,14696,16218,19010,28535,25919,13345,13382,26,163
"Wexford County, Michigan",32829,16433,16396,31552,222,210,202,4,43,596,27,569,32249,580,0.4331,21200,21407,21475,13927,16355,12099,22157,,15670,15319,26,165
"Aitkin County, Minnesota",15722,8016,7706,14937,62,309,52,2,8,352,11,341,15536,186,0.4224,25780,26303,26421,14610,11363,17364,37179,,,12008,27,001
"Anoka County, Minnesota",341249,170762,170487,291633,17750,2246,14142,107,5092,10279,798,9481,327402,13847,0.3916,33051,35313,35762,15864,17247,21911,28251,138101,14412,13346,27,003
"Becker County, Minnesota",33375,16693,16682,29299,154,2517,165,10,118,1112,54,1058,32788,587,0.4267,27188,28760,28979,11040,13218,16849,22424,27080,14840,13128,27,005
"Beltrami County, Minnesota",45644,22773,22871,33600,416,9621,391,48,111,1457,19,1438,44699,945,0.4489,22845,26335,26516,4805,7196,12531,45376,11538,4296,10677,27,007
"Benton County, Minnesota",39457,19736,19721,37032,1046,167,437,0,32,743,19,724,38666,791,0.4116,25984,26720,27005,13278,13126,8998,31631,-666666666,37925,7403,27,009
"Big Stone County, Minnesota",5098,2494,2604,5038,9,0,0,0,4,47,0,47,5034,64,0.4418,27820,28012,28192,13258,,-666666666,-666666666,-666666666,,,27,011
"Blue Earth County, Minnesota",65524,32979,32545,60046,2166,263,1347,8,297,1397,110,1287,63508,2016,0.4533,27324,28322,28503,17958,12411,23040,28051,,12662,10836,27,013
"Brown County, Minnesota",25327,12563,12764,24587,57,56,166,15,238,208,3,205,24340,987,0.4138,28444,28876,29370,11630,3661,10905,26570,,10397,12410,27,015
"Carlton County, Minnesota",35482,18491,16991,31710,525,1838,216,7,63,1123,80,1043,34892,590,0.4034,25714,27025,27155,12321,12779,17868,9176,,18502,11193,27,017
"Carver County, Minnesota",97143,48209,48934,90204,1388,135,2672,75,534,2135,284,1851,93216,3927,0.4313,41759,43040,43901,16168,21166,19793,34662,,17946,18717,27,019
"Cass County, Minnesota",28633,14588,14045,24315,100,3174,166,13,36,829,17,812,28112,521,0.4302,26844,29372,29592,13496,14025,12512,15751,10385,29758,11482,27,021
"Chippewa County, Minnesota",12126,6006,6120,11265,65,177,81,130,213,195,8,187,11396,730,0.4088,27781,28808,29412,15690,16703,23025,12498,9640,18866,4692,27,023
"Chisago County, Minnesota",54041,27920,26121,51690,672,218,382,4,107,968,28,940,52997,1044,0.3668,30455,31092,31278,18009,6155,20167,26617,,13788,19067,27,025
"Clay County, Minnesota",61402,30311,31091,56626,1271,770,644,26,263,1802,204,1598,58819,2583,0.4143,27165,28326,28863,12309,13095,12942,13315,7027,16366,13498,27,027
"Clearwater County, Minnesota",8764,4440,4324,7564,29,805,40,11,12,303,46,257,8614,150,0.4545,23777,25476,25604,12023,46245,11462,28570,16582,45542,10700,27,029
"Cook County, Minnesota",5215,2606,2609,4527,15,429,48,20,68,108,7,101,5117,98,0.4635,32774,34607,34097,50472,23753,23815,10594,,24557,9519,27,031
"Cottonwood County, Minnesota",11557,5669,5888,10474,72,54,333,4,428,192,0,192,10771,786,0.4452,25967,27705,28236,8480,16547,23030,13173,,5856,2867,27,033
"Crow Wing County, Minnesota",63321,31646,31675,60995,389,747,288,0,46,856,31,825,62461,860,0.4539,29106,29542,29683,16344,16029,20021,21759,-666666666,22180,14744,27,035
"Dakota County, Minnesota",411402,202188,209214,344555,22082,1168,19126,52,11411,13008,1047,11961,384354,27048,0.4117,37266,40229,41021,17973,21738,22248,32210,40056,15277,13184,27,037
"Dodge County, Minnesota",20361,10198,10163,19633,67,54,181,0,158,268,21,247,19373,988,0.3903,30495,31122,31904,11581,11393,34220,14874,-666666666,13461,9172,27,039
"Douglas County, Minnesota",36862,18388,18474,35891,212,138,79,0,139,403,3,400,36330,532,0.4445,31640,31941,32132,14347,49527,14251,26716,-666666666,22315,5508,27,041
"Faribault County, Minnesota",14119,7060,7059,13762,28,11,47,0,78,193,15,178,13242,877,0.4387,28168,27709,28704,11847,5364,,10213,-666666666,17836,73211,27,043
"Fillmore County, Minnesota",20877,10470,10407,20497,87,16,91,2,33,151,0,151,20611,266,0.4178,27777,28084,28286,11518,16553,12600,10334,,19527,6868,27,045
"Freeborn County, Minnesota",30751,15350,15401,29129,406,88,439,7,325,357,39,318,27871,2880,0.4240,27332,28118,29546,12450,5866,18117,18974,,13609,12100,27,047
"Goodhue County, Minnesota",46450,23180,23270,44289,562,526,245,0,58,770,85,685,45004,1446,0.4335,31830,32458,33017,14220,5052,37985,22809,-666666666,25086,14438,27,049
"Grant County, Minnesota",5943,2972,2971,5792,2,26,7,0,12,104,11,93,5830,113,0.4396,29446,29771,29929,17533,,23473,13100,-666666666,,17641,27,051
"Hennepin County, Minnesota",1209265,596243,613022,891912,150522,7999,83228,487,32774,42343,3167,39176,1126953,82312,0.4854,39939,46688,48110,17146,16607,21623,32581,13135,16021,17465,27,053
"Houston County, Minnesota",18791,9390,9401,18267,87,39,76,5,34,283,0,283,18619,172,0.4052,29007,29353,29506,14865,18416,19726,31883,,43788,8811,27,055
"Hubbard County, Minnesota",20640,10302,10338,19464,136,442,125,4,60,409,30,379,20256,384,0.4156,26417,26972,27046,17627,3531,13094,27225,,23347,22451,27,057
"Isanti County, Minnesota",38461,19431,19030,36830,228,176,336,9,144,738,23,715,37778,683,0.3872,28676,29202,29353,16393,12318,18404,30545,,10906,12894,27,059
"Itasca County, Minnesota",45356,22906,22450,42163,224,1594,191,5,98,1081,93,988,44788,568,0.4109,25862,26551,26628,14173,7062,17595,32249,,13968,14997,27,061
"Jackson County, Minnesota",10163,5130,5033,9713,23,9,223,3,93,99,4,95,9830,333,0.4101,28958,29423,29954,11180,4174,,15412,,20117,29987,27,063
"Kanabec County, Minnesota",15918,8062,7856,15385,54,155,76,1,30,217,10,207,15672,246,0.4125,24582,24968,25152,10090,11070,24725,8487,,,9291,27,065
"Kandiyohi County, Minnesota",42510,21312,21198,37765,1566,234,308,0,2047,590,62,528,37517,4993,0.4353,28165,30360,31589,12870,9141,14720,11589,-666666666,11125,11267,27,067
"Kittson County, Minnesota",4436,2243,2193,4347,28,9,17,0,2,33,2,31,4350,86,0.4322,29939,30245,30537,15392,11321,20533,16153,-666666666,,14367,27,069
"Koochiching County, Minnesota",12930,6461,6469,12106,119,471,57,0,3,174,0,174,12905,25,0.4450,26814,27674,27659,33620,1213,15127,11323,-666666666,,21145,27,071
"Lac qui Parle County, Minnesota",6916,3453,3463,6723,70,14,28,0,26,55,10,45,6771,145,0.4607,30816,31367,31609,14919,8041,27614,15818,-666666666,11438,10073,27,073
"Lake County, Minnesota",10721,5481,5240,10390,96,56,0,7,45,127,3,124,10572,149,0.4145,31215,31651,31716,24583,13843,22743,-666666666,,25262,15970,27,075
"Lake of the Woods County, Minnesota",3901,2030,1871,3667,4,12,45,0,0,173,43,130,3853,48,0.3443,23234,23603,23602,,,,,-666666666,-666666666,13553,27,077
"Le Sueur County, Minnesota",27650,14005,13645,26471,213,95,125,2,451,293,8,285,26097,1553,0.4024,29714,30237,30833,14348,7510,32546,26077,,11382,27545,27,079
"Lincoln County, Minnesota",5793,2914,2879,5652,13,39,8,0,40,41,1,40,5700,93,0.4416,27946,28370,28456,11268,9631,16074,,-666666666,10688,7873,27,081
"Lyon County, Minnesota",25670,12840,12830,22857,763,139,902,0,770,239,11,228,24084,1586,0.4623,28860,30488,31107,9476,26950,13070,15887,-666666666,7079,7575,27,083
"McLeod County, Minnesota",35926,17807,18119,34309,59,75,221,0,698,564,19,545,33944,1982,0.3898,28241,28853,29305,14816,9768,29556,33335,-666666666,11240,11767,27,085
"Mahnomen County, Minnesota",5480,2765,2715,2615,19,2273,24,22,37,490,16,474,5292,188,0.4350,20233,27368,27829,6153,,13115,12554,9541,19789,16623,27,087
"Marshall County, Minnesota",9406,4793,4613,9168,21,32,20,2,27,136,8,128,9021,385,0.3885,28194,28615,29252,12587,16362,22163,23815,,18256,5932,27,089
"Martin County, Minnesota",20193,9989,10204,19708,54,19,152,2,33,225,8,217,19391,802,0.4282,29034,29334,29902,14888,5393,12037,39721,,7955,5920,27,091
"Meeker County, Minnesota",23094,11734,11360,22500,125,73,88,23,71,214,23,191,22289,805,0.4028,27974,28413,28856,12748,13401,9736,11183,,14794,7903,27,093
"Mille Lacs County, Minnesota",25788,12944,12844,23495,136,1322,110,0,75,650,76,574,25260,528,0.4036,24489,25298,25509,15480,11002,15589,10171,-666666666,72184,13093,27,095
"Morrison County, Minnesota",32850,16617,16233,31929,196,49,167,0,130,379,49,330,32359,491,0.4352,26442,26857,26997,12428,5731,26727,12947,-666666666,12824,12736,27,097
"Mower County, Minnesota",39248,19689,19559,35964,1327,43,833,45,299,737,27,710,34955,4293,0.4516,27459,28510,30835,10378,13915,15140,17621,,18628,12757,27,099
"Murray County, Minnesota",8463,4197,4266,8191,35,25,66,33,39,74,5,69,8178,285,0.4184,29084,29060,29575,11059,13763,,23832,,8726,18051,27,101
"Nicollet County, Minnesota",33226,16586,16640,31025,951,74,508,0,252,416,46,370,31842,1384,0.4005,28089,29155,29595,16531,7306,9278,26444,-666666666,13950,9980,27,103
"Nobles County, Minnesota",21729,11130,10599,17329,907,98,1303,10,1731,351,21,330,16068,5661,0.4231,24188,26199,30358,12993,14148,,18464,,14478,26800,27,105
"Norman County, Minnesota",6638,3332,3306,6172,50,98,31,14,61,212,5,207,6318,320,0.4177,26270,26928,27385,11162,5116,24798,28377,,6248,19429,27,107
"Olmsted County, Minnesota",150104,73514,76590,127969,7903,418,8948,14,1495,3357,189,3168,143147,6957,0.4473,36143,38253,39145,18456,15253,20928,36960,,18909,12461,27,109
"Otter Tail County, Minnesota",57694,28994,28700,55163,782,206,377,7,449,710,16,694,55903,1791,0.4331,28781,29508,29803,16919,11411,26420,13656,10086,15530,8723,27,111
"Pennington County, Minnesota",14156,7121,7035,13268,234,209,108,42,57,238,34,204,13677,479,0.4106,26992,27336,27690,16594,32851,17588,23662,,37277,13531,27,113
"Pine County, Minnesota",29067,15548,13519,26585,615,705,149,13,177,823,64,759,28264,803,0.4217,22817,23727,24014,8622,12376,16487,13971,,10160,11325,27,115
"Pipestone County, Minnesota",9285,4533,4752,8609,125,124,91,0,121,215,1,214,8794,491,0.4558,27489,28698,29089,10750,8645,12485,27575,-666666666,12973,6818,27,117
"Polk County, Minnesota",31550,15931,15619,29368,446,373,240,16,318,789,99,690,29670,1880,0.4315,27231,28402,28946,15799,11834,13427,13162,13031,12606,9353,27,119
"Pope County, Minnesota",10975,5543,5432,10679,49,47,38,0,57,105,2,103,10845,130,0.4234,30485,31045,31088,15829,8516,17883,24121,-666666666,6207,4979,27,121
"Ramsey County, Minnesota",531528,258733,272795,363250,59572,3401,72239,174,10430,22462,1621,20841,492543,38985,0.4603,31256,38276,39745,16059,16335,20013,16837,12107,16297,12457,27,123
"Red Lake County, Minnesota",4042,2056,1986,3846,23,66,12,0,27,68,12,56,3913,129,0.4014,25732,26455,26874,12290,,9842,19175,-666666666,30741,6319,27,125
"Redwood County, Minnesota",15578,7830,7748,13931,102,768,490,0,140,147,3,144,15127,451,0.4246,26716,28133,28442,12443,10605,18147,10036,-666666666,19239,11037,27,127
"Renville County, Minnesota",14995,7603,7392,14000,45,204,75,0,504,167,40,127,13849,1146,0.4487,30089,31192,32106,11994,14269,14295,10943,-666666666,14812,15903,27,129
"Rice County, Minnesota",65116,33132,31984,57784,2718,271,1432,49,1708,1154,166,988,60057,5059,0.4304,27856,29934,30824,12951,9823,12658,15803,11582,11980,9012,27,131
"Rock County, Minnesota",9554,4668,4886,9208,75,64,88,0,45,74,0,74,9308,246,0.4226,27634,28171,28488,10983,14227,18206,19416,-666666666,10298,2961,27,133
"Roseau County, Minnesota",15609,7999,7610,14569,117,220,443,2,25,233,3,230,15443,166,0.4090,27307,28136,28217,12624,8991,14549,17782,,11808,16485,27,135
"St. Louis County, Minnesota",200353,100702,99651,185370,3053,3826,2111,77,612,5304,156,5148,197410,2943,0.4507,28013,29172,29311,14494,8748,15744,18970,26909,17292,12315,27,137
"Scott County, Minnesota",139490,69528,69962,118278,4202,979,8235,173,3209,4414,372,4042,132873,6617,0.3936,37113,39398,39654,19492,21733,49613,31251,20611,13669,16381,27,139
"Sherburne County, Minnesota",91188,46610,44578,85480,1901,471,1032,11,445,1848,38,1810,88955,2233,0.3664,31182,32060,32290,16760,8214,17642,27510,,13579,23444,27,141
"Sibley County, Minnesota",14957,7555,7402,14476,70,29,97,3,137,145,13,132,13720,1237,0.4000,28811,29287,30650,12921,10586,9766,24798,,17227,7797,27,143
"Stearns County, Minnesota",153661,77355,76306,138458,6908,537,3064,22,2001,2671,262,2409,148916,4745,0.4294,27792,29385,29656,13924,10161,19978,19378,,12993,12967,27,145
"Steele County, Minnesota",36541,18073,18468,33101,1079,50,433,5,1363,510,94,416,33905,2636,0.4122,28736,30508,30926,14439,8733,6590,15269,,13311,11167,27,147
"Stevens County, Minnesota",9762,4884,4878,9121,82,187,164,14,38,156,0,156,9315,447,0.4509,26625,26793,27303,13089,137260,5668,2979,,6650,15176,27,149
"Swift County, Minnesota",9483,4775,4708,9073,172,21,17,0,139,61,2,59,9076,407,0.4384,28969,29604,30058,15547,9984,,10229,-666666666,17965,25820,27,151
"Todd County, Minnesota",24335,12419,11916,23266,69,58,116,0,345,481,47,434,23036,1299,0.4155,24410,24850,25472,11554,10349,18362,17630,-666666666,18636,11677,27,153
"Traverse County, Minnesota",3397,1635,1762,3149,15,137,0,0,16,80,3,77,3320,77,0.4449,30992,32391,32680,15643,8280,16808,-666666666,-666666666,,8354,27,155
"Wabasha County, Minnesota",21327,10627,10700,20755,46,51,88,0,62,325,0,325,20714,613,0.4204,31464,31591,32003,17075,9624,31394,20817,-666666666,26635,30279,27,157
"Wadena County, Minnesota",13755,6809,6946,13260,111,119,35,0,28,202,0,202,13519,236,0.4227,22283,22849,23046,10606,9539,7617,6071,-666666666,13775,4799,27,159
"Waseca County, Minnesota",19034,8996,10038,17752,509,133,93,0,225,322,87,235,17955,1079,0.4194,27179,27783,28477,21172,10884,6373,17544,-666666666,61892,6796,27,161
"Washington County, Minnesota",248745,123093,125652,216007,9796,944,12605,111,1910,7372,935,6437,239252,9493,0.4127,39873,41944,42490,23070,22894,31163,34717,19008,20616,16991,27,163
"Watonwan County, Minnesota",10996,5414,5582,9970,70,50,131,0,691,84,12,72,8507,2489,0.4219,26273,27428,30061,15181,6587,24190,15360,-666666666,15110,15757,27,165
"Wilkin County, Minnesota",6479,3258,3221,6174,47,99,0,0,7,152,4,148,6397,82,0.4083,27814,28502,28656,11721,9574,13743,-666666666,-666666666,,15758,27,167
"Winona County, Minnesota",51145,25238,25907,48034,755,170,1342,12,232,600,75,525,49745,1400,0.4288,25967,26621,26973,12682,10305,16342,18177,,24050,14391,27,169
"Wright County, Minnesota",129922,65372,64550,123077,1480,419,1412,9,1195,2330,353,1977,126420,3502,0.3746,31154,31805,32116,15042,15907,23997,28064,,16393,17077,27,171
"Yellow Medicine County, Minnesota",10038,5115,4923,9288,24,331,61,0,134,200,3,197,9622,416,0.4063,27686,28420,28832,12139,18838,21489,11013,-666666666,19307,15612,27,173
"Adams County, Mississippi",31747,15901,15846,13522,17056,33,42,0,708,386,45,341,29209,2538,0.5069,18091,25434,28723,4220,12881,,,-666666666,9249,7930,28,001
"Alcorn County, Mississippi",37309,18354,18955,31596,4310,96,92,0,471,744,98,646,36155,1154,0.4430,20006,21518,21724,9581,12683,,9640,-666666666,12497,5452,28,003
"Amite County, Mississippi",12692,6302,6390,7312,5332,3,18,0,0,27,0,27,12657,35,0.4804,17954,22153,22250,,12271,,,-666666666,-666666666,10156,28,005
"Attala County, Mississippi",19085,8996,10089,10489,8169,5,58,0,106,258,25,233,18714,371,0.5160,20283,25943,26026,9197,13441,,34359,-666666666,14025,6520,28,007
"Benton County, Mississippi",8378,4159,4219,5116,3098,33,0,0,116,15,0,15,8188,190,0.4801,20261,25043,22973,70139,13039,,-666666666,-666666666,8961,,28,009
"Bolivar County, Mississippi",33615,15773,17842,11054,21634,74,289,0,486,78,0,78,32912,703,0.5092,16595,27047,27083,12159,11267,4592,36621,-666666666,6177,15103,28,011
"Calhoun County, Mississippi",14724,7018,7706,9939,4006,0,5,74,490,210,2,208,13910,814,0.4497,17203,19725,20180,7081,12866,-666666666,,19273,8078,1557,28,013
"Carroll County, Mississippi",10301,5229,5072,6685,3444,24,53,0,0,95,13,82,10249,52,0.4755,22519,26943,27066,8040,12342,,,-666666666,-666666666,6414,28,015
"Chickasaw County, Mississippi",17357,8437,8920,9441,7533,8,90,0,77,208,28,180,16629,728,0.4996,18514,23764,24593,10165,11944,,43202,-666666666,12496,10302,28,017
"Choctaw County, Mississippi",8320,4037,4283,5637,2613,21,11,6,5,27,0,27,8298,22,0.4495,18434,21986,22033,3945,10653,,,,,8778,28,019
"Claiborne County, Mississippi",9209,4309,4900,1162,7905,19,80,0,14,29,0,29,9087,122,0.4934,12944,27166,27166,4607,10959,12621,,-666666666,,6179,28,021
"Clarke County, Mississippi",16203,7616,8587,10442,5627,16,15,0,25,78,13,65,16040,163,0.4436,20431,24264,24514,6746,13546,,,-666666666,26016,8827,28,023
"Clay County, Mississippi",20147,9343,10804,8153,11734,60,135,0,14,51,0,51,19890,257,0.4906,19097,28880,29354,13515,12543,,7090,-666666666,,,28,025
"Coahoma County, Mississippi",24804,11476,13328,5460,19158,9,63,0,5,109,0,109,24753,51,0.5119,16066,33112,33123,31402,11321,,6359,-666666666,,925,28,027
"Copiah County, Mississippi",28780,13820,14960,13159,14848,3,86,0,461,223,30,193,27949,831,0.5031,18188,27210,27590,8633,10610,,11895,-666666666,9291,10685,28,029
"Covington County, Mississippi",19503,9299,10204,12044,7276,0,35,13,0,135,0,135,19358,145,0.4373,16941,20350,20427,15832,11404,-666666666,27283,,-666666666,6459,28,031
"DeSoto County, Mississippi",170890,82763,88127,120860,42384,233,2273,26,2028,3086,516,2570,162781,8109,0.4002,27135,29912,30700,14883,20853,23189,24749,29423,18461,12423,28,033
"Forrest County, Mississippi",76274,36332,39942,45561,28087,192,701,3,485,1245,52,1193,73930,2344,0.4929,20194,24800,25240,13226,13761,8463,10378,,12092,7335,28,035
"Franklin County, Mississippi",7818,3811,4007,4993,2792,1,3,0,0,29,3,26,7737,81,0.4768,22769,26045,26319,,17083,,,-666666666,-666666666,,28,037
"George County, Mississippi",23313,11736,11577,20833,1630,52,287,0,215,296,0,296,22768,545,0.4501,20640,22172,22417,6658,9032,,6647,-666666666,6183,4447,28,039
"Greene County, Mississippi",13941,8190,5751,10134,3569,35,0,0,4,199,4,195,13795,146,0.4338,15659,19366,19537,8908,5457,21920,-666666666,-666666666,,6573,28,041
"Grenada County, Mississippi",21518,10281,11237,11918,9417,54,8,0,7,114,0,114,21492,26,0.5089,20562,26402,26413,,13529,,,-666666666,,,28,043
"Hancock County, Mississippi",46028,22404,23624,40096,4407,17,101,0,585,822,41,781,44334,1694,0.4246,23221,24263,24400,17995,15607,,31254,-666666666,24015,11390,28,045
"Harrison County, Mississippi",198570,98115,100455,136866,47258,959,5661,17,2463,5346,251,5095,188001,10569,0.4467,22517,25519,26145,15717,15470,22618,22136,,14912,11870,28,047
"Hinds County, Mississippi",244596,114238,130358,64420,174477,279,2032,96,1731,1561,110,1451,240880,3716,0.4983,21672,36795,37231,14452,16184,14258,27072,30653,12430,15028,28,049
"Holmes County, Mississippi",18547,8830,9717,2965,15393,17,54,0,30,88,0,88,18489,58,0.5535,12408,25772,26085,4203,9889,,,-666666666,,,28,051
"Humphreys County, Mississippi",8822,4177,4645,1936,6698,9,9,0,77,93,0,93,8585,237,0.5266,13977,23413,23670,17283,11044,,71111,-666666666,7452,27100,28,053
"Issaquena County, Mississippi",1352,831,521,530,814,0,0,0,8,0,0,0,1344,8,0.6066,17282,19727,19727,,15821,-666666666,-666666666,-666666666,,-666666666,28,055
"Itawamba County, Mississippi",23511,11643,11868,21481,1608,1,58,6,135,222,25,197,23173,338,0.4663,19707,20387,20456,11905,13835,,10978,,12262,3854,28,057
"Jackson County, Mississippi",140850,69209,71641,101277,30621,498,3084,0,2217,3153,238,2915,133094,7756,0.4568,24350,27412,27538,21243,16208,13173,25759,-666666666,19527,8843,28,059
"Jasper County, Mississippi",16538,8038,8500,7576,8859,1,4,0,17,81,2,79,16484,54,0.4802,19363,26450,26573,,13516,,,-666666666,,1268,28,061
"Jefferson County, Mississippi",7528,3732,3796,1003,6488,0,37,0,0,0,0,0,7518,10,0.4958,13703,29682,29981,,11291,-666666666,,-666666666,-666666666,-666666666,28,063
"Jefferson Davis County, Mississippi",11771,5705,6066,4513,7209,0,0,0,28,21,0,21,11731,40,0.5012,16859,22814,22875,,13033,-666666666,-666666666,-666666666,,14876,28,065
"Jones County, Mississippi",68313,33207,35106,47162,19807,204,378,0,209,553,17,536,65422,2891,0.4914,20957,25084,25962,10685,11205,15728,38827,-666666666,11790,11494,28,067
"Kemper County, Mississippi",10128,4931,5197,3596,6106,379,0,0,0,47,0,47,9977,151,0.4412,14715,20885,21721,,11564,8307,-666666666,-666666666,-666666666,,28,069
"Lafayette County, Mississippi",52193,25377,26816,37679,12503,45,1001,31,295,639,81,558,50961,1232,0.5179,23833,26367,26631,17106,17246,,20211,,23911,10076,28,071
"Lamar County, Mississippi",59623,28686,30937,45452,11863,85,848,0,606,769,65,704,58155,1468,0.4765,28101,31238,31404,17508,18080,34835,22270,-666666666,10035,17200,28,073
"Lauderdale County, Mississippi",79233,38430,40803,43076,33691,118,625,35,568,1120,113,1007,77524,1709,0.4828,21575,28194,28403,18996,13455,3603,17658,,22895,15074,28,075
"Lawrence County, Mississippi",12603,6176,6427,8320,4164,6,0,0,25,88,0,88,12522,81,0.4883,20700,23939,23671,48278,14365,,-666666666,-666666666,,13576,28,077
"Leake County, Mississippi",23011,11492,11519,11898,9618,1333,74,0,17,71,0,71,22024,987,0.4920,18178,23505,25072,6671,12664,11932,10343,-666666666,,,28,079
"Lee County, Mississippi",85281,40811,44470,58381,24326,166,659,15,679,1055,158,897,83219,2062,0.4592,22741,26447,26826,11240,14687,8654,28615,,14796,7170,28,081
"Leflore County, Mississippi",30500,14123,16377,7504,22219,0,251,0,348,178,0,178,29739,761,0.5388,15370,28136,29156,13618,10940,-666666666,20282,-666666666,18261,17707,28,083
"Lincoln County, Mississippi",34691,16606,18085,23665,10688,6,242,0,0,90,0,90,34342,349,0.4640,19418,22278,22548,4259,13219,,20936,-666666666,-666666666,,28,085
"Lowndes County, Mississippi",59785,28561,31224,32205,26031,119,552,13,274,591,20,571,58640,1145,0.4649,22143,29211,29429,19263,13602,23176,23350,,9663,17896,28,087
"Madison County, Mississippi",101791,48681,53110,57847,38863,169,2464,8,1791,649,97,552,98985,2806,0.4875,35435,46150,46286,19348,20287,26993,43765,,11620,23295,28,089
"Marion County, Mississippi",25810,12554,13256,16991,8323,62,108,0,160,166,0,166,25448,362,0.5114,19707,22548,22589,31547,13745,,11575,-666666666,47249,10137,28,091
"Marshall County, Mississippi",36196,17809,18387,17811,17306,40,37,3,586,413,59,354,34954,1242,0.4221,19104,22270,22742,12740,15995,16525,,,21247,10628,28,093
"Monroe County, Mississippi",36029,17184,18845,24510,10979,11,33,13,21,462,0,462,35643,386,0.4471,19905,22642,22733,15019,14307,,87079,,,3002,28,095
"Montgomery County, Mississippi",10353,4916,5437,5558,4638,0,26,0,0,131,2,129,10202,151,0.4797,19706,25381,25848,8399,13204,-666666666,,-666666666,-666666666,13033,28,097
"Neshoba County, Mississippi",29474,14131,15343,17721,6266,4773,127,0,46,541,38,503,28918,556,0.4672,19030,23003,23250,8900,13289,12262,18997,-666666666,,14381,28,099
"Newton County, Mississippi",21652,10184,11468,13708,6568,1045,51,0,31,249,48,201,21278,374,0.5036,20896,26265,26497,12193,12411,8518,3678,-666666666,,6996,28,101
"Noxubee County, Mississippi",11098,5256,5842,3345,7682,51,3,0,17,0,0,0,10659,439,0.4804,16108,22692,25389,4121,13266,,,-666666666,,-666666666,28,103
"Oktibbeha County, Mississippi",49424,24879,24545,28642,18276,51,1465,0,305,685,9,676,48620,804,0.5399,20128,25265,25465,15784,12369,41339,20595,-666666666,18584,10434,28,105
"Panola County, Mississippi",34319,16579,17740,16648,17270,8,4,0,46,343,39,304,33764,555,0.4684,20098,27722,28068,10679,13111,,,-666666666,,2521,28,107
"Pearl River County, Mississippi",55167,27310,27857,46508,7157,117,178,0,353,854,26,828,53548,1619,0.4365,20653,22023,22176,15479,11892,14990,28744,-666666666,15203,20834,28,109
"Perry County, Mississippi",12174,5925,6249,9601,2436,0,8,0,17,112,2,110,12018,156,0.4529,18188,19233,19416,8671,14338,-666666666,,-666666666,,6156,28,111
"Pike County, Mississippi",39939,18925,21014,17907,21160,167,194,5,259,247,9,238,39369,570,0.4891,17316,22947,23046,11240,12550,4093,48031,,8459,11860,28,113
"Pontotoc County, Mississippi",30862,15393,15469,24863,4671,32,97,0,807,392,84,308,28976,1886,0.4440,19743,21132,21620,8810,15585,15150,22735,-666666666,7947,5135,28,115
"Prentiss County, Mississippi",25339,12355,12984,21263,3403,0,46,0,163,464,0,464,25011,328,0.4678,18313,19750,19848,10633,11597,-666666666,,-666666666,15260,2290,28,117
"Quitman County, Mississippi",7634,3670,3964,2174,5379,0,7,0,31,43,5,38,7545,89,0.4829,14928,24555,24826,,11062,-666666666,,-666666666,,,28,119
"Rankin County, Mississippi",147930,71428,76502,114061,29405,211,1683,51,858,1661,65,1596,144165,3765,0.4119,27822,30122,30389,19959,19998,17135,27471,,23536,11346,28,121
"Scott County, Mississippi",28268,13707,14561,16393,10683,225,308,0,649,10,0,10,25229,3039,0.4688,17203,21506,23352,10729,10803,8895,23241,-666666666,13839,,28,123
"Sharkey County, Mississippi",4662,2148,2514,1189,3442,4,19,0,8,0,0,0,4644,18,0.4400,15430,28851,28851,31394,10769,,,-666666666,,-666666666,28,125
"Simpson County, Mississippi",27279,13309,13970,17111,9659,101,5,0,91,312,15,297,26796,483,0.4742,18495,22389,22580,11522,12024,,,-666666666,11820,9838,28,127
"Smith County, Mississippi",16137,7733,8404,12078,4005,0,15,0,2,37,3,34,16094,43,0.5312,22129,25508,25497,28340,12158,-666666666,,-666666666,,5108,28,129
"Stone County, Mississippi",17995,9197,8798,14161,3506,117,24,0,0,187,0,187,17680,315,0.4172,19588,20985,21169,12556,14953,16929,,-666666666,-666666666,4110,28,131
"Sunflower County, Mississippi",27424,14350,13074,6906,20228,58,25,0,104,103,9,94,26990,434,0.5014,14111,24298,24930,7844,10670,,12344,-666666666,12454,12219,28,133
"Tallahatchie County, Mississippi",14776,8726,6050,5564,6889,74,214,28,1948,59,14,45,12533,2243,0.4550,12747,22259,23412,251,9034,,1644,,289,6917,28,135
"Tate County, Mississippi",28338,13846,14492,18983,8663,16,73,13,123,467,26,441,27640,698,0.4453,20948,25408,25686,15083,11991,,,,9744,9138,28,137
"Tippah County, Mississippi",22061,10819,11242,17821,3741,13,75,12,153,246,40,206,21011,1050,0.4496,19453,20697,21168,20161,13007,,1813,,13371,38441,28,139
"Tishomingo County, Mississippi",19503,9461,10042,18502,470,69,22,0,260,180,0,180,18967,536,0.4179,18790,19210,19348,9610,12477,,,-666666666,10180,4216,28,141
"Tunica County, Mississippi",10407,4809,5598,2057,8050,0,57,0,214,29,0,29,10228,179,0.4857,16950,24505,24505,,15329,-666666666,19325,-666666666,6511,,28,143
"Union County, Mississippi",27989,13672,14317,22993,4075,51,218,24,154,474,56,418,26769,1220,0.4468,19723,21249,21840,7608,13242,36586,,,7752,5751,28,145
"Walthall County, Mississippi",14812,7253,7559,7864,6782,0,48,0,25,93,0,93,14735,77,0.5277,18255,23866,23770,28012,11994,-666666666,8808,-666666666,,9642,28,147
"Warren County, Mississippi",47834,22725,25109,23482,23123,55,391,0,279,504,10,494,46832,1002,0.4734,22110,29993,30114,19233,14501,49176,19112,-666666666,6762,11764,28,149
"Washington County, Mississippi",48824,22920,25904,12883,34990,47,269,0,269,366,98,268,48154,670,0.5224,17800,29165,29364,16797,13478,29928,35171,-666666666,19437,15386,28,151
"Wayne County, Mississippi",20517,9871,10646,12099,8082,53,75,0,56,152,0,152,20220,297,0.4954,20460,25979,26206,11104,12413,26383,24044,-666666666,,9982,28,153
"Webster County, Mississippi",9922,4872,5050,7852,1903,21,16,0,22,108,5,103,9785,137,0.4801,20722,22781,22915,15397,13228,,14581,-666666666,12514,6178,28,155
"Wilkinson County, Mississippi",9233,4888,4345,2584,6598,0,3,0,35,13,0,13,9201,32,0.4961,14183,22977,22977,,10808,-666666666,,-666666666,,,28,157
"Winston County, Mississippi",18519,9046,9473,9476,8869,89,0,0,73,12,0,12,18308,211,0.5164,21943,30564,30774,42451,12921,16510,-666666666,-666666666,,,28,159
"Yalobusha County, Mississippi",12380,5937,6443,7272,4941,55,25,0,48,39,0,39,12198,182,0.4373,18802,21267,21383,18684,15040,19115,,-666666666,,,28,161
"Yazoo County, Mississippi",27719,15297,12422,10499,16376,74,135,0,301,334,45,289,26712,1007,0.5431,16756,21145,21740,9557,14205,13536,21022,-666666666,6792,11821,28,163
"Adair County, Missouri",25547,12038,13509,23649,565,61,523,94,89,566,141,425,24916,631,0.4906,19804,20287,20616,7801,12480,10639,8887,,54943,8542,29,001
"Andrew County, Missouri",17347,8574,8773,16691,261,64,76,40,24,191,24,167,16962,385,0.4175,26661,26810,26918,21774,24714,50345,21286,,,8816,29,003
"Atchison County, Missouri",5380,2656,2724,5263,27,15,19,0,1,55,7,48,5314,66,0.4259,26710,26840,26819,30826,17341,,7589,-666666666,,27040,29,005
"Audrain County, Missouri",25868,11710,14158,23048,1534,59,68,5,250,904,150,754,25125,743,0.4218,19692,20740,20894,10245,13346,,16865,,4932,9264,29,007
"Barry County, Missouri",35716,17958,17758,33203,65,171,541,0,926,810,7,803,32638,3078,0.4211,19431,19883,20595,9638,7748,18359,16809,-666666666,9750,14882,29,009
"Barton County, Missouri",12075,5991,6084,11347,28,218,69,3,132,278,43,235,11790,285,0.4723,22513,22971,23121,8161,10954,20308,,,7814,13565,29,011
"Bates County, Missouri",16513,8097,8416,15791,165,92,30,9,129,297,10,287,16181,332,0.4161,22250,22671,22790,12978,17424,17075,,,13345,8926,29,013
"Benton County, Missouri",18825,9336,9489,18246,70,65,34,5,39,366,25,341,18485,340,0.4373,19487,19777,19890,13048,15517,15269,13632,,30492,5898,29,015
"Bollinger County, Missouri",12282,6181,6101,12007,35,98,31,0,0,111,0,111,12153,129,0.4495,19987,20131,20212,12694,8746,13015,13326,-666666666,-666666666,15966,29,017
"Boone County, Missouri",172773,83740,89033,141402,14222,348,7319,153,1618,7711,313,7398,167279,5494,0.4841,27689,29771,30017,19324,17887,11267,25834,16088,21337,11646,29,019
"Buchanan County, Missouri",89415,44984,44431,79397,4596,246,896,129,782,3369,298,3071,83958,5457,0.4395,23189,24221,24746,15756,15767,21709,25874,6934,23842,8848,29,021
"Butler County, Missouri",42887,20730,22157,38864,2268,218,290,10,178,1059,10,1049,42066,821,0.4626,20042,20480,20618,9701,13983,12693,69363,,4924,7659,29,023
"Caldwell County, Missouri",9057,4610,4447,8712,70,34,21,0,45,175,12,163,8877,180,0.4030,23273,23472,23555,19964,8934,42579,,-666666666,21960,15163,29,025
"Callaway County, Missouri",44693,22841,21852,40975,1690,132,402,6,191,1297,56,1241,43816,877,0.4101,23475,24467,24544,21805,13974,21556,24121,,831,7918,29,027
"Camden County, Missouri",44152,21895,22257,42611,314,227,274,0,280,446,0,446,43005,1147,0.4544,24484,24978,25297,7794,7725,26782,5545,-666666666,4044,12323,29,029
"Cape Girardeau County, Missouri",78089,37830,40259,68802,5986,214,1125,17,299,1646,64,1582,76325,1764,0.4618,25348,26951,26983,18313,15329,13236,12389,,11310,8057,29,031
"Carroll County, Missouri",9009,4366,4643,8658,82,2,25,0,31,211,0,211,8882,127,0.4795,24484,25184,25427,5515,14261,,,-666666666,,3645,29,033
"Carter County, Missouri",6249,2998,3251,5966,5,107,0,0,14,157,6,151,6111,138,0.4757,21296,21827,21991,7996,,9485,-666666666,-666666666,,9859,29,035
"Cass County, Missouri",101324,49752,51572,93058,3546,452,709,25,720,2814,266,2548,97124,4200,0.4034,29197,29706,30023,21421,31546,25031,19800,,35670,10895,29,037
"Cedar County, Missouri",13932,6940,6992,13476,9,5,8,24,37,373,22,351,13669,263,0.4499,18932,19224,19409,7485,,,,,,11524,29,039
"Chariton County, Missouri",7615,3769,3846,7313,181,14,5,0,3,99,2,97,7554,61,0.4590,23029,23600,23693,7230,10525,28500,,-666666666,,4656,29,041
"Christian County, Missouri",82053,39892,42161,78504,482,538,483,40,290,1716,114,1602,79785,2268,0.4033,25342,25833,26063,12670,13611,20275,15408,,12581,12612,29,043
"Clark County, Missouri",6860,3468,3392,6689,19,25,3,0,0,124,0,124,6842,18,0.4515,25149,25501,25570,,4016,28764,,-666666666,-666666666,9291,29,045
"Clay County, Missouri",233135,114237,118898,201570,13340,1094,4885,398,3649,8199,1197,7002,218053,15082,0.4062,30531,31977,32539,19939,20688,25038,29837,51013,21009,15391,29,047
"Clinton County, Missouri",20494,10286,10208,19482,351,134,118,0,116,293,13,280,20099,395,0.3818,26551,27017,26985,26485,20145,10496,15685,-666666666,30207,13513,29,049
"Cole County, Missouri",76603,38731,37872,63844,8795,347,962,59,1143,1453,42,1411,74527,2076,0.4187,26557,29452,29718,14705,11036,13965,30914,,7777,9114,29,051
"Cooper County, Missouri",17613,9266,8347,15711,1113,49,60,17,137,526,35,491,17332,281,0.4288,22822,24389,24451,13417,9872,14808,38885,,8577,6572,29,053
"Crawford County, Missouri",24545,12098,12447,23953,53,109,25,2,2,401,0,401,24103,442,0.4604,20373,20696,20853,12236,8704,4983,17192,,,7177,29,055
"Dade County, Missouri",7590,3871,3719,7265,27,35,10,4,17,232,0,232,7446,144,0.4189,20624,20904,21099,12475,,13277,,,,14561,29,057
"Dallas County, Missouri",16508,8209,8299,15733,14,151,19,0,127,464,42,422,16193,315,0.3929,17378,17643,17796,4572,,14484,,-666666666,14734,10328,29,059
"Daviess County, Missouri",8257,4172,4085,8023,95,26,7,0,25,81,21,60,8139,118,0.4226,21356,21723,21801,13288,8376,10638,,-666666666,25320,3700,29,061
"DeKalb County, Missouri",12706,8016,4690,10749,1298,124,42,7,41,445,12,433,12215,491,0.4269,17584,20116,20742,5724,1090,7725,67043,,1354,4220,29,063
"Dent County, Missouri",15578,7764,7814,15006,87,117,64,0,25,279,0,279,15343,235,0.4595,19929,19967,20165,12818,39518,26419,,-666666666,,8305,29,065
"Douglas County, Missouri",13467,6749,6718,13227,12,41,2,0,144,41,0,41,13296,171,0.4463,17261,17191,17177,10002,28325,58354,,-666666666,5985,35702,29,067
"Dunklin County, Missouri",31271,15043,16228,26668,3017,115,108,0,736,627,3,624,29341,1930,0.4699,18203,19313,19752,11307,12653,6908,19213,-666666666,13936,4597,29,069
"Franklin County, Missouri",102063,50830,51233,98344,967,96,533,57,607,1459,95,1364,100391,1672,0.4305,26272,26380,26392,17772,17077,45722,42983,,9017,25557,29,071
"Gasconade County, Missouri",14875,7389,7486,14539,77,45,46,0,2,166,0,166,14685,190,0.4417,24355,24427,24613,10611,18034,10760,30543,-666666666,,22883,29,073
"Gentry County, Missouri",6745,3242,3503,6558,71,14,31,0,30,41,17,24,6672,73,0.4043,20726,20928,20940,11093,15918,7979,28881,-666666666,,1773,29,075
"Greene County, Missouri",285449,139153,146296,259031,9313,1498,5261,382,2458,7506,678,6828,275785,9664,0.4598,24537,25572,25796,14750,13238,18690,19175,19715,12197,12067,29,077
"Grundy County, Missouri",10231,4950,5281,9874,74,65,29,7,11,171,17,154,10029,202,0.4397,20746,21179,21339,9745,5069,14248,,,,9557,29,079
"Harrison County, Missouri",8649,4305,4344,8404,71,12,2,2,43,115,2,113,8473,176,0.4048,20434,20831,20978,9538,6356,8733,,,,7368,29,081
"Henry County, Missouri",21930,10847,11083,21025,321,161,39,5,69,310,2,308,21460,470,0.4384,23510,23977,24249,8417,12975,21583,17951,,,9440,29,083
"Hickory County, Missouri",9267,4523,4744,8962,14,87,22,4,19,159,0,159,9138,129,0.4280,18694,19026,19021,18512,10214,6186,,,13189,9615,29,085
"Holt County, Missouri",4537,2274,2263,4386,18,42,31,0,0,60,0,60,4528,9,0.4122,23949,24278,24277,25956,,34148,,-666666666,-666666666,7295,29,087
"Howard County, Missouri",10148,5075,5073,9327,531,55,22,15,22,176,0,176,10009,139,0.4264,22192,22978,23142,9512,13223,14325,54418,3613,,8897,29,089
"Howell County, Missouri",40265,19617,20648,38572,123,186,234,0,263,887,22,865,39477,788,0.4583,19293,19320,19414,9868,13213,13883,53254,-666666666,4477,15490,29,091
"Iron County, Missouri",10220,5071,5149,9794,194,71,12,8,10,131,8,123,10044,176,0.4213,19270,19491,19584,13343,17245,7294,,,,9492,29,093
"Jackson County, Missouri",683643,330662,352981,455236,162364,3457,11944,1703,28416,20523,2680,17843,624266,59377,0.4703,27665,32366,33325,14771,19095,18921,24903,47702,12906,13046,29,095
"Jasper County, Missouri",117376,57174,60202,106701,2612,1553,1293,288,1451,3478,286,3192,108505,8871,0.4524,22767,23304,24140,11891,12282,20189,36883,17811,15115,13687,29,097
"Jefferson County, Missouri",222453,110600,111853,214052,2190,552,1647,37,600,3375,355,3020,218499,3954,0.3888,26021,26315,26403,18910,17040,21307,33216,4727,13508,12893,29,099
"Johnson County, Missouri",54229,27952,26277,48456,2409,367,820,183,192,1802,101,1701,52115,2114,0.4123,22589,23317,23518,18059,16311,18050,25276,20649,28516,10668,29,101
"Knox County, Missouri",3997,2025,1972,3857,14,0,9,27,16,74,6,68,3958,39,0.4426,21471,21898,21898,10823,,-666666666,,,19944,5661,29,103
"Laclede County, Missouri",35505,17608,17897,33975,168,282,129,4,83,864,28,836,34707,798,0.4259,19552,19572,19765,14112,8635,22972,20767,,45865,17094,29,105
"Lafayette County, Missouri",32789,16121,16668,30905,655,83,153,22,127,844,39,805,31920,869,0.3974,25008,25396,25665,14870,22386,23622,7941,,27443,15869,29,107
"Lawrence County, Missouri",38204,19079,19125,36230,205,191,208,0,746,624,15,609,35528,2676,0.4246,19973,20470,21060,8375,15656,18424,14748,-666666666,5532,12011,29,109
"Lewis County, Missouri",10146,5094,5052,9562,294,59,21,15,22,173,3,170,9973,173,0.4091,20646,21347,21381,17466,12485,3236,12057,2613,,5700,29,111
"Lincoln County, Missouri",54286,27178,27108,51519,977,185,245,62,356,942,41,901,53069,1217,0.3925,22833,23370,23531,11951,12509,27888,11898,,4641,12706,29,113
"Linn County, Missouri",12319,5900,6419,11820,53,22,27,0,113,284,59,225,12080,239,0.4183,20860,21204,21133,15390,16143,17750,80281,-666666666,2605,9273,29,115
"Rockingham County, North Carolina",91898,44313,47585,69614,17041,477,491,85,2263,1927,277,1650,86479,5419,0.4361,21298,23383,23767,12233,15868,18257,20238,,11267,7097,37,157
"Rowan County, North Carolina",138694,68575,70119,108360,22329,312,1252,11,3933,2497,313,2184,127503,11191,0.4440,22463,24536,25095,14362,15865,15884,21187,,10688,11455,37,159
"Rutherford County, North Carolina",66701,32392,34309,56997,6893,325,346,5,1386,749,84,665,64021,2680,0.4413,19688,20968,21071,10774,12680,18441,23255,,6656,9918,37,161
"Sampson County, North Carolina",63713,31190,32523,39660,16240,1219,296,11,4477,1810,204,1606,52086,11627,0.4721,19871,23580,26402,9353,15061,18484,15531,8464,9781,8436,37,163
"Scotland County, North Carolina",35711,17684,18027,16249,13730,3777,286,8,519,1142,46,1096,34734,977,0.4741,16192,22162,22405,11546,11036,12623,13563,,9765,8733,37,165
"Stanly County, North Carolina",60610,30158,30452,51212,6369,208,1117,15,497,1192,65,1127,58265,2345,0.4213,22103,23587,24197,8475,14588,13990,17907,,13859,7299,37,167
"Stokes County, North Carolina",46453,22749,23704,43386,1932,271,143,15,217,489,66,423,45154,1299,0.4180,22013,22200,22498,9267,18032,33880,36140,,16717,13256,37,169
"Surry County, North Carolina",72767,35422,37345,66972,2689,276,436,47,1189,1158,204,954,65545,7222,0.4681,21411,22115,23227,9557,15841,15059,13789,10474,10866,9298,37,171
"Swain County, North Carolina",14234,6940,7294,9143,186,3952,52,0,136,765,101,664,13561,673,0.4684,20256,22053,21958,11761,4056,16953,,-666666666,8104,22283,37,173
"Transylvania County, North Carolina",33062,15910,17152,29879,1273,117,227,17,1009,540,64,476,32038,1024,0.4353,25394,26770,26943,10382,15910,23146,15859,,7996,9384,37,175
"Tyrrell County, North Carolina",4128,2325,1803,2302,1512,85,14,0,192,23,0,23,3704,424,0.4695,17042,22900,23831,8435,9608,9521,,-666666666,8860,18696,37,177
"Union County, North Carolina",217614,107221,110393,177613,25260,724,4880,23,5052,4062,434,3628,194221,23393,0.4603,31185,32854,34763,15001,23468,28292,38812,,11839,21295,37,179
"Vance County, North Carolina",44508,20766,23742,19355,22162,752,213,10,1207,809,140,669,41329,3179,0.4762,18703,23312,24246,9296,15505,10171,10108,,10102,6755,37,181
"Wake County, North Carolina",998576,485068,513508,669687,205682,3405,62010,451,30586,26755,2994,23761,899776,98800,0.4463,35752,41063,43443,17105,23286,26865,37260,19206,13984,21468,37,183
"Warren County, North Carolina",20324,10196,10128,8046,10328,980,104,0,323,543,60,483,19531,793,0.4804,19563,28153,28741,10802,14092,14015,22163,-666666666,8108,12655,37,185
"Washington County, North Carolina",12503,5815,6688,5815,6079,18,0,0,253,338,165,173,11892,611,0.4833,20423,27264,27426,9934,15375,,-666666666,-666666666,,5596,37,187
"Watauga County, North Carolina",52745,26315,26430,49587,632,170,452,21,640,1243,184,1059,50946,1799,0.5248,22892,23775,24035,9564,10447,16626,9163,11352,7978,7704,37,189
"Wayne County, North Carolina",124447,61002,63445,74099,38504,289,1538,14,6004,3999,527,3472,110822,13625,0.4500,21674,25973,27312,10158,16653,28749,26234,,8389,8057,37,191
"Wilkes County, North Carolina",68888,33902,34986,62792,2945,133,318,65,1613,1022,245,777,64817,4071,0.4634,20145,20917,21263,9434,16519,19564,15926,18872,6141,6696,37,193
"Wilson County, North Carolina",81617,38626,42991,41325,31846,515,627,63,5391,1850,332,1518,73588,8029,0.4679,22519,29644,30619,10512,16181,13623,32346,,10238,7888,37,195
"Yadkin County, North Carolina",37819,18602,19217,34612,1285,111,22,0,1222,567,118,449,33809,4010,0.4496,21820,22810,23680,10616,15595,4949,,-666666666,8398,8384,37,197
"Yancey County, North Carolina",17599,8609,8990,16991,206,76,36,5,148,137,20,117,16742,857,0.4577,21508,21899,22428,7162,13386,31396,,,,7377,37,199
"Adams County, North Dakota",2348,1187,1161,2203,24,53,38,0,15,15,0,15,2328,20,0.4317,32594,33355,33456,20390,27275,13023,16287,-666666666,,,38,001
"Barnes County, North Dakota",11033,5427,5606,10405,88,217,40,14,86,183,4,179,10831,202,0.4701,34244,35578,35725,15130,23630,5953,16508,5086,7167,15881,38,003
"Benson County, North Dakota",6802,3492,3310,2885,0,3756,7,4,0,150,0,150,6636,166,0.5130,20561,35197,35271,11984,-666666666,9690,40171,,-666666666,9757,38,005
"Billings County, North Dakota",936,533,403,891,8,11,0,0,8,18,18,0,906,30,0.4509,40549,41898,42087,,,,-666666666,-666666666,,,38,007
"Bottineau County, North Dakota",6650,3488,3162,6239,56,187,18,0,29,121,18,103,6509,141,0.4674,32661,33882,34236,9155,7189,18002,,-666666666,9538,12377,38,009
"Bowman County, North Dakota",3238,1571,1667,3090,4,41,0,0,76,27,0,27,3084,154,0.4401,34388,35307,35794,20334,,5312,-666666666,-666666666,24288,,38,011
"Burke County, North Dakota",2239,1208,1031,2166,10,34,1,0,7,21,0,21,2160,79,0.4509,35857,36517,37557,6148,,8206,,-666666666,,,38,013
"Burleigh County, North Dakota",90560,45126,45434,83296,1142,3404,689,51,270,1708,91,1617,88769,1791,0.4339,36093,37563,37886,17370,19794,12659,60979,23931,20803,14756,38,015
"Cass County, North Dakota",166852,84300,82552,148944,6371,1813,4640,8,840,4236,358,3878,162834,4018,0.4595,32485,34074,34376,13897,11176,18536,33123,,17751,16922,38,017
"Cavalier County, North Dakota",3867,1957,1910,3710,5,38,10,0,50,54,3,51,3817,50,0.4505,39779,40861,40861,17482,,16966,,-666666666,17482,12157,38,019
"Dickey County, North Dakota",5160,2590,2570,4990,76,44,21,0,2,27,0,27,4988,172,0.4042,28843,29296,29600,17906,17941,22075,12219,-666666666,,,38,021
"Divide County, North Dakota",2369,1190,1179,2239,16,21,35,0,0,58,3,55,2361,8,0.5157,41063,42496,42648,,,37190,,-666666666,-666666666,10053,38,023
"Dunn County, North Dakota",4284,2266,2018,3626,40,423,19,13,42,121,4,117,4162,122,0.5215,40102,43911,44254,8498,15938,20113,45242,,15157,14907,38,025
"Eddy County, North Dakota",2370,1144,1226,2173,0,121,0,7,7,62,0,62,2327,43,0.5176,33785,34994,35496,9195,-666666666,13359,-666666666,38186,,31229,38,027
"Emmons County, North Dakota",3426,1713,1713,3309,0,3,45,0,0,69,0,69,3426,0,0.5168,29467,30277,30277,-666666666,-666666666,,9013,-666666666,-666666666,,38,029
"Foster County, North Dakota",3345,1663,1682,3256,2,36,12,0,2,37,0,37,3306,39,0.3924,30310,30610,30870,7369,,24383,,-666666666,,11319,38,031
"Golden Valley County, North Dakota",1895,931,964,1819,0,9,0,0,1,66,0,66,1861,34,0.4360,26536,26995,26922,,-666666666,,-666666666,-666666666,,16920,38,033
"Grand Forks County, North Dakota",69793,36093,33700,61670,1999,1721,1683,48,590,2082,155,1927,67137,2656,0.4835,29376,31217,31244,25601,13553,11912,26797,19852,16939,10320,38,035
"Grant County, North Dakota",2369,1176,1193,2294,7,37,4,0,10,17,0,17,2354,15,0.5006,32200,32419,32421,15173,,35170,,-666666666,,14618,38,037
"Griggs County, North Dakota",2311,1165,1146,2230,28,24,0,0,4,25,0,25,2301,10,0.4380,31866,31989,32076,,,67079,-666666666,-666666666,,,38,039
"Hettinger County, North Dakota",2639,1252,1387,2504,8,44,0,11,0,72,10,62,2566,73,0.4568,31074,32477,32300,33937,,4100,-666666666,,-666666666,5982,38,041
"Kidder County, North Dakota",2419,1284,1135,2362,0,3,5,0,45,4,0,4,2296,123,0.4741,36779,34185,34738,76043,-666666666,,,-666666666,176667,,38,043
"LaMoure County, North Dakota",4111,2112,1999,4037,6,13,0,0,6,49,0,49,4075,36,0.5020,36493,36903,37108,10422,,,-666666666,-666666666,,11931,38,045
"Logan County, North Dakota",1939,986,953,1905,1,7,5,0,1,20,0,20,1910,29,0.4737,33272,33449,33473,31859,,,,-666666666,,27465,38,047
"McHenry County, North Dakota",5912,3079,2833,5739,9,40,7,0,10,107,10,97,5770,142,0.4787,36072,36847,37295,15415,9100,13695,10414,-666666666,25940,7784,38,049
"McIntosh County, North Dakota",2737,1367,1370,2645,4,3,30,0,0,55,0,55,2695,42,0.4802,30620,30700,30787,,,,38463,-666666666,-666666666,9409,38,051
"McKenzie County, North Dakota",10718,5610,5108,8729,105,1532,30,0,85,237,10,227,10055,663,0.4738,37938,42936,44033,20002,25581,14375,,-666666666,42266,13770,38,053
"McLean County, North Dakota",9576,4917,4659,8677,12,677,11,0,58,141,44,97,9361,215,0.4409,34218,35671,35556,25561,,21895,,-666666666,15952,15338,38,055
"Mercer County, North Dakota",8671,4477,4194,8254,81,212,35,0,52,37,5,32,8461,210,0.3931,34194,34729,34862,22590,,18463,42829,-666666666,,39789,38,057
"Morton County, North Dakota",29633,15295,14338,27565,200,1020,37,0,141,670,3,667,28923,710,0.4416,34715,35468,35875,15987,11091,20807,35589,-666666666,22246,34510,38,059
"Mountrail County, North Dakota",9675,5241,4434,6359,19,2784,68,0,123,322,15,307,9055,620,0.5139,39285,50270,51314,13825,55700,18098,21478,-666666666,18531,16260,38,061
"Nelson County, North Dakota",3032,1525,1507,2978,25,17,0,0,0,12,4,8,2959,73,0.4579,33895,34185,34195,34895,,17106,-666666666,-666666666,-666666666,38500,38,063
"Oliver County, North Dakota",1768,931,837,1640,9,86,2,0,3,28,0,28,1740,28,0.4240,35524,36629,36419,40429,,18764,,-666666666,,,38,065
"Pembina County, North Dakota",7136,3689,3447,6752,18,175,15,0,65,111,3,108,6902,234,0.4427,32779,33562,33751,26313,15450,12857,89740,-666666666,28608,14071,38,067
"Pierce County, North Dakota",4373,2216,2157,4251,52,38,0,0,4,28,0,28,4338,35,0.4708,27926,28302,28163,39486,21763,6234,-666666666,-666666666,,14718,38,069
"Ramsey County, North Dakota",11578,5891,5687,9978,4,1217,53,0,33,293,44,249,11309,269,0.4693,30372,33020,33205,13820,31825,14794,29443,-666666666,,5738,38,071
"Ransom County, North Dakota",5457,2780,2677,5293,25,20,21,0,0,98,0,98,5364,93,0.4205,30822,30875,31167,12977,,15515,26752,-666666666,-666666666,21248,38,073
"Carter County, Montana",1295,625,670,1269,0,5,0,0,0,21,0,21,1277,18,0.4863,30728,31088,31256,19422,-666666666,36740,-666666666,-666666666,-666666666,7505,30,011
"Cascade County, Montana",82049,41248,40801,72844,999,3672,726,93,551,3164,90,3074,78696,3353,0.4587,26578,28008,28373,17187,20978,10879,29250,17053,30325,12643,30,013
"Chouteau County, Montana",5837,2898,2939,4461,3,1194,10,0,54,115,0,115,5713,124,0.4530,22247,26112,26127,5218,,9720,,-666666666,,11734,30,015
"Custer County, Montana",11980,5999,5981,11326,43,307,45,0,57,202,12,190,11627,353,0.4349,26742,27249,27330,28343,,8425,10980,-666666666,77304,20959,30,017
"Daniels County, Montana",1787,878,909,1761,0,18,0,0,8,0,0,0,1749,38,0.4478,33909,34035,33932,33755,-666666666,32006,-666666666,-666666666,,-666666666,30,019
"Dawson County, Montana",9431,4975,4456,8945,62,238,18,0,63,105,1,104,9168,263,0.4149,28438,29461,28882,40881,3679,12965,,-666666666,694,12007,30,021
"Deer Lodge County, Montana",9176,4883,4293,8515,32,128,34,187,71,209,13,196,8894,282,0.4595,23192,23891,24095,11919,20169,18623,,11075,,12354,30,023
"Fallon County, Montana",2913,1525,1388,2786,38,35,25,0,0,29,1,28,2863,50,0.4685,31902,31807,31995,11272,,,52328,-666666666,-666666666,56403,30,025
"Fergus County, Montana",11429,5750,5679,10882,18,179,104,122,5,119,2,117,11335,94,0.4392,25788,26242,26274,21931,,11969,9597,,,35363,30,027
"Flathead County, Montana",94696,47281,47415,89762,248,1524,492,44,546,2080,132,1948,92279,2417,0.4579,27083,27638,27851,15393,34960,18985,18497,5373,14521,13916,30,029
"Gallatin County, Montana",97958,50509,47449,92876,354,912,1261,21,560,1974,60,1914,94883,3075,0.4698,31909,32786,33136,17206,16358,10600,24470,28748,18637,11802,30,031
"Garfield County, Montana",1061,510,551,1060,0,0,0,0,0,1,0,1,1053,8,0.4877,28159,28185,28283,11863,-666666666,-666666666,-666666666,-666666666,-666666666,,30,033
"Glacier County, Montana",13695,6722,6973,4543,36,8818,68,0,20,210,0,210,13309,386,0.5211,16284,25646,26743,8315,13072,11536,20038,-666666666,,14028,30,035
"Golden Valley County, Montana",730,344,386,683,25,0,0,0,0,22,0,22,681,49,0.3972,25714,27516,28169,,,-666666666,-666666666,-666666666,-666666666,-1014,30,037
"Granite County, Montana",3212,1648,1564,3101,2,19,2,0,0,88,4,84,3148,64,0.4409,26720,27032,27422,7930,,37632,,-666666666,-666666666,14303,30,039
"Hill County, Montana",16529,8355,8174,11828,3,4019,84,0,66,529,5,524,15988,541,0.4372,21070,24820,25003,7948,,11299,16525,-666666666,15976,12731,30,041
"Jefferson County, Montana",11601,5958,5643,11011,8,190,31,0,37,324,15,309,11347,254,0.4123,31801,32376,32106,37952,,29295,18635,-666666666,7127,18428,30,043
"Judith Basin County, Montana",1981,1034,947,1948,0,22,0,0,6,5,0,5,1951,30,0.4471,28741,28874,29061,12073,-666666666,28014,-666666666,-666666666,,,30,045
"Lake County, Montana",29311,14418,14893,19966,72,7414,120,21,134,1584,85,1499,28114,1197,0.4805,23191,26955,27374,14079,18261,15459,17855,,10665,13843,30,047
"Lewis and Clark County, Montana",65989,32839,33150,61913,290,1656,443,50,197,1440,156,1284,64035,1954,0.4072,29892,30764,31126,12751,22366,14507,21527,12724,16810,16580,30,049
"Liberty County, Montana",2292,1137,1155,2221,0,29,0,0,24,18,11,7,2275,17,0.5717,32427,32893,32915,,-666666666,,-666666666,-666666666,,29178,30,051
"Lincoln County, Montana",19268,9639,9629,18453,11,197,109,5,29,464,14,450,18752,516,0.4590,22404,22638,22914,14351,5009,21802,11782,,,17693,30,053
"McCone County, Montana",1678,914,764,1547,0,96,9,0,0,26,26,0,1663,15,0.4572,28736,30031,30031,,-666666666,,,-666666666,-666666666,,30,055
"Madison County, Montana",7810,4046,3764,7471,28,39,14,0,104,154,3,151,7575,235,0.4431,30030,30789,30973,17896,,13185,,-666666666,18481,12873,30,057
"Meagher County, Montana",1960,937,1023,1907,0,23,0,0,10,20,0,20,1922,38,0.3784,19989,20103,20319,6008,-666666666,21396,-666666666,-666666666,,,30,059
"Mineral County, Montana",4223,2155,2068,4154,2,14,32,0,4,17,0,17,4167,56,0.4586,21447,21663,21723,15339,,1971,,-666666666,,11547,30,061
"Missoula County, Montana",113101,56928,56173,104191,483,2781,1421,188,183,3854,394,3460,109688,3413,0.4737,27956,28947,29264,14910,18453,17086,25371,17085,32366,11483,30,063
"Musselshell County, Montana",4778,2374,2404,4565,11,42,67,0,0,93,0,93,4651,127,0.4333,23167,23708,23928,16023,,21100,,-666666666,-666666666,,30,065
"Park County, Montana",15843,7917,7926,15231,50,135,11,0,20,396,2,394,15431,412,0.4499,27597,28167,28484,13747,7230,17786,16145,-666666666,33730,11588,30,067
"Petroleum County, Montana",445,239,206,445,0,0,0,0,0,0,0,0,445,0,0.4230,26822,26822,26822,-666666666,-666666666,-666666666,-666666666,-666666666,-666666666,-666666666,30,069
"Phillips County, Montana",4150,2086,2064,3612,0,408,0,0,32,98,5,93,4060,90,0.4522,22772,23914,24213,9380,-666666666,16675,-666666666,-666666666,,12767,30,071
"Pondera County, Montana",6166,3100,3066,5025,24,941,25,0,62,89,0,89,6050,116,0.4325,21995,24428,24463,10875,,11340,14212,-666666666,6540,13152,30,073
"Powder River County, Montana",1648,811,837,1581,0,21,0,0,0,46,0,46,1623,25,0.3906,29393,29710,29899,17916,-666666666,24700,-666666666,-666666666,-666666666,20650,30,075
"Powell County, Montana",6928,4314,2614,6365,29,291,68,8,10,157,9,148,6758,170,0.4274,23620,25006,24892,23964,10024,5188,9324,,,9615,30,077
"Prairie County, Montana",1414,747,667,1361,0,17,0,0,0,36,0,36,1393,21,0.4244,24431,25253,24871,,-666666666,,-666666666,-666666666,-666666666,,30,079
"Ravalli County, Montana",41130,20385,20745,39389,32,228,231,0,122,1128,68,1060,39808,1322,0.4316,23042,23543,23819,13354,,15871,24182,-666666666,16502,7901,30,081
"Richland County, Montana",11392,5864,5528,10713,0,379,46,0,122,132,0,132,10826,566,0.4587,33949,34631,35378,18639,-666666666,21834,11650,-666666666,21593,32544,30,083
"Roosevelt County, Montana",11230,5525,5705,4119,6,6133,23,0,115,834,5,829,10899,331,0.5010,16885,28030,28284,8430,,10099,33117,-666666666,8763,12544,30,085
"Rosebud County, Montana",9348,4629,4719,5605,18,3377,45,0,91,212,0,212,8924,424,0.4180,23387,30694,31702,13142,27894,10998,5027,-666666666,29279,28556,30,087
"Sanders County, Montana",11375,5837,5538,10456,18,433,55,0,21,392,76,316,11076,299,0.4303,20810,21305,21197,21851,,16258,8005,-666666666,14024,15263,30,089
"Sheridan County, Montana",3645,1866,1779,3391,3,54,9,0,25,163,0,163,3561,84,0.4700,31997,33469,33665,21954,,17320,,-666666666,19980,10131,30,091
"Silver Bow County, Montana",34560,17188,17372,32727,202,780,305,0,123,423,2,421,33149,1411,0.4853,25583,26056,26531,14877,6763,16911,23144,-666666666,22177,16657,30,093
"Stillwater County, Montana",9342,4748,4594,8930,33,35,42,0,98,204,0,204,9031,311,0.4071,30958,31282,31563,20174,,36066,32243,-666666666,24816,13767,30,095
"Sweet Grass County, Montana",3634,1770,1864,3464,7,0,30,0,0,133,3,130,3568,66,0.4470,26935,27601,27986,6980,,-666666666,39203,-666666666,-666666666,7874,30,097
"Teton County, Montana",6067,2979,3088,5759,5,127,22,0,51,103,5,98,5981,86,0.4070,25740,26078,26264,10951,14060,22214,38559,-666666666,,20428,30,099
"Toole County, Montana",5114,2919,2195,4648,3,276,96,0,23,68,4,64,4943,171,0.4394,23705,24077,24461,12616,,17597,23156,-666666666,,29532,30,101
"Treasure County, Montana",846,433,413,779,0,11,12,0,26,18,0,18,804,42,0.3703,21255,22067,22176,10217,-666666666,9509,28325,-666666666,11458,,30,103
"Valley County, Montana",7576,3805,3771,6560,6,735,16,29,11,219,0,219,7410,166,0.4197,27820,30262,30450,11149,,9687,,,5464,15663,30,105
"Wheatland County, Montana",2109,1094,1015,2035,0,33,0,0,5,36,0,36,2059,50,0.4049,19407,19614,19815,15726,-666666666,21145,-666666666,-666666666,,,30,107
"Wibaux County, Montana",1143,552,591,1143,0,0,0,0,0,0,0,0,1126,17,0.4006,23985,23985,23829,,-666666666,-666666666,-666666666,-666666666,-666666666,-666666666,30,109
"Yellowstone County, Montana",155344,76301,79043,140985,1009,6946,1060,61,1386,3897,180,3717,147173,8171,0.4523,30519,31985,32485,17638,13703,14895,23671,24656,14608,17296,30,111
"Adams County, Nebraska",31536,16007,15529,29440,305,85,421,13,748,524,103,421,28727,2809,0.4571,27609,28370,29258,16790,4485,18461,31628,9315,12915,17990,31,001
"Antelope County, Nebraska",6421,3217,3204,6278,17,22,18,0,51,35,0,35,6219,202,0.4661,27048,27375,27596,15230,12059,,,-666666666,5722,7260,31,003
"Arthur County, Nebraska",437,210,227,426,0,0,0,0,1,10,0,10,437,0,0.4429,21174,21427,21427,-666666666,-666666666,-666666666,-666666666,-666666666,,9270,31,005
"Banner County, Nebraska",793,368,425,765,10,0,2,0,1,15,0,15,716,77,0.4971,30095,31019,33781,6296,,-666666666,,-666666666,,,31,007
"Blaine County, Nebraska",580,308,272,572,0,0,3,5,0,0,0,0,580,0,0.3729,23001,23051,23051,-666666666,-666666666,-666666666,,,-666666666,-666666666,31,009
"Boone County, Nebraska",5353,2693,2660,5269,29,3,1,7,5,39,4,35,5259,94,0.4226,28288,28590,28831,13383,19483,,,,15040,,31,011
"Box Butte County, Nebraska",11279,5741,5538,10472,30,362,37,8,40,330,110,220,9946,1333,0.3927,27751,28953,30308,20079,16120,4652,,,34093,17747,31,013
"Boyd County, Nebraska",2006,1024,982,1935,16,14,5,0,5,31,0,31,1991,15,0.4582,25507,26147,26283,,,9057,,-666666666,,7790,31,015
"Brown County, Nebraska",3022,1439,1583,2951,1,5,14,0,0,51,6,45,2991,31,0.5124,30135,30476,30471,30703,,,,-666666666,-666666666,13133,31,017
"Buffalo County, Nebraska",48402,24188,24214,45169,458,137,627,6,1064,941,78,863,44317,4085,0.4340,27218,28077,29023,13658,13717,18165,19271,,18026,9704,31,019
"Burt County, Nebraska",6594,3241,3353,6304,48,101,32,0,49,60,2,58,6422,172,0.4042,24613,25239,25496,11346,11750,8104,11700,-666666666,12433,13763,31,021
"Butler County, Nebraska",8205,4126,4079,7945,53,30,42,0,81,54,2,52,7966,239,0.4149,28045,28496,28755,10996,,22487,36671,-666666666,11022,8131,31,023
"Cass County, Nebraska",25463,12760,12703,24604,202,44,153,7,116,337,33,304,24717,746,0.4044,30637,31172,31335,22542,6370,14759,24927,,20689,14582,31,025
"Cedar County, Nebraska",8657,4396,4261,8534,5,64,7,2,7,38,7,31,8511,146,0.4346,28663,28903,29152,15138,,7223,,,,11568,31,027
"Chase County, Nebraska",4061,1983,2078,3988,1,0,0,0,7,65,0,65,3510,551,0.4578,29239,29657,32529,11615,,-666666666,-666666666,-666666666,,4617,31,029
"Cherry County, Nebraska",5781,2844,2937,5286,1,218,25,8,0,243,1,242,5623,158,0.3971,27891,29111,29624,9678,,12627,,,-666666666,16847,31,031
"Cheyenne County, Nebraska",10090,4956,5134,9653,7,40,124,0,28,238,9,229,9427,663,0.4138,30929,31700,32716,14893,13129,17605,28475,-666666666,17175,5297,31,033
"Clay County, Nebraska",6313,3224,3089,6115,25,13,19,0,58,83,6,77,5759,554,0.3924,25472,25835,27194,9835,12824,,28358,-666666666,14819,10722,31,035
"Colfax County, Nebraska",10499,5449,5050,9407,281,98,9,18,424,262,117,145,5896,4603,0.4164,23619,24739,33414,12446,13333,928,,21439,14489,16478,31,037
"Cuming County, Nebraska",9055,4578,4477,8672,7,40,14,0,207,115,29,86,8185,870,0.4091,26061,26614,28019,10183,,11708,15057,-666666666,15843,7893,31,039
"Custer County, Nebraska",10784,5331,5453,10479,66,13,91,0,57,78,29,49,10499,285,0.4845,29986,30293,30589,12922,,15815,15978,-666666666,12368,45319,31,041
"Dakota County, Nebraska",20697,10072,10625,14611,862,485,659,25,3638,417,22,395,12873,7824,0.4099,21710,24752,29117,12898,10291,15385,16897,,12578,33005,31,043
"Dawes County, Nebraska",9082,4476,4606,8105,91,258,94,199,54,281,25,256,8666,416,0.4379,23307,24957,23988,37297,3248,11272,10477,,2069,10379,31,045
"Dawson County, Nebraska",23924,12122,11802,21305,1298,195,6,7,717,396,207,189,16102,7822,0.4283,24042,25172,30234,14244,14407,21150,,,16043,10968,31,047
"Deuel County, Nebraska",1932,944,988,1852,0,14,3,0,31,32,0,32,1812,120,0.4039,28640,29035,29903,9040,-666666666,23250,,-666666666,,34303,31,049
"Dixon County, Nebraska",5809,2921,2888,5531,20,4,2,7,156,89,0,89,5107,702,0.4063,24983,25445,26972,13083,20155,,,,21030,6434,31,051
"Dodge County, Nebraska",36679,17969,18710,35027,261,242,227,82,233,607,31,576,32498,4181,0.4268,26141,26910,28773,10286,5359,11168,13956,14867,10688,8696,31,053
"Douglas County, Nebraska",543253,267547,275706,431358,60705,2834,17723,239,14965,15429,1349,14080,478050,65203,0.4659,30548,33965,36517,13498,17110,14697,25727,25171,13914,12529,31,055
"Dundy County, Nebraska",1823,912,911,1792,3,1,0,0,7,20,0,20,1718,105,0.4514,28161,27176,28106,13835,25800,,-666666666,-666666666,,108230,31,057
"Fillmore County, Nebraska",5676,2834,2842,5488,49,28,11,0,43,57,5,52,5465,211,0.4420,29361,30007,30590,7899,,,,-666666666,6377,,31,059
"Franklin County, Nebraska",3076,1541,1535,3025,7,4,4,0,0,36,1,35,3019,57,0.4401,28373,28622,28817,18160,8771,,8900,-666666666,-666666666,13889,31,061
"Frontier County, Nebraska",2599,1303,1296,2545,1,12,2,0,0,39,0,39,2571,28,0.4220,26798,27030,27217,10204,,,,-666666666,-666666666,19931,31,063
"Furnas County, Nebraska",4850,2363,2487,4701,9,27,7,0,43,63,0,63,4682,168,0.4156,23307,23743,24123,8289,,,,-666666666,7067,11798,31,065
"Gage County, Nebraska",21778,10807,10971,21033,118,77,119,20,136,275,18,257,21314,464,0.4163,26347,26737,26824,18420,24016,9212,9514,,13478,15580,31,067
"Garden County, Nebraska",1930,927,1003,1876,3,5,25,0,1,20,0,20,1846,84,0.4816,30900,31652,32256,,,,,-666666666,,5115,31,069
"Garfield County, Nebraska",1968,982,986,1939,3,0,0,0,4,22,0,22,1927,41,0.3791,24379,24570,24687,18163,,-666666666,-666666666,-666666666,,12441,31,071
"Gosper County, Nebraska",1977,944,1033,1948,0,10,8,0,4,7,0,7,1966,11,0.3710,29393,29607,29714,,-666666666,,,-666666666,,,31,073
"Grant County, Nebraska",647,341,306,647,0,0,0,0,0,0,0,0,627,20,0.4037,21925,21925,22323,9450,-666666666,-666666666,-666666666,-666666666,-666666666,-666666666,31,075
"Greeley County, Nebraska",2447,1220,1227,2393,13,0,9,0,13,19,0,19,2399,48,0.4003,25054,25243,25489,12525,,-666666666,,-666666666,31100,19037,31,077
"Hall County, Nebraska",61105,30720,30385,55532,1327,252,702,99,2375,818,86,732,45139,15966,0.4273,24617,25192,29011,13410,28762,20323,24160,11299,15293,9206,31,079
"Hamilton County, Nebraska",9118,4560,4558,8756,76,71,36,0,141,38,21,17,8848,270,0.4137,31565,32093,32230,11424,40653,10593,,-666666666,14306,4676,31,081
"Harlan County, Nebraska",3465,1824,1641,3324,19,13,6,1,32,70,20,50,3315,150,0.4366,25997,26015,25075,41473,90853,,,,11863,12156,31,083
"Hayes County, Nebraska",1013,558,455,1003,0,0,0,0,6,4,0,4,955,58,0.4542,27080,27150,27837,14271,-666666666,-666666666,-666666666,-666666666,20750,,31,085
"Hitchcock County, Nebraska",2866,1434,1432,2854,4,5,0,0,0,3,0,3,2842,24,0.4168,23967,24015,24180,4671,6550,,-666666666,-666666666,-666666666,,31,087
"Holt County, Nebraska",10360,5145,5215,10079,5,90,46,1,57,82,50,32,9935,425,0.4113,26267,26462,26952,13226,,10790,43600,,34277,3823,31,089
"Hooker County, Nebraska",669,316,353,653,6,3,0,0,7,0,0,0,640,29,0.3599,22094,22457,21926,30000,,,-666666666,-666666666,,-666666666,31,091
"Howard County, Nebraska",6365,3232,3133,6171,7,2,14,17,78,76,0,76,6212,153,0.4320,28301,28542,28686,15520,,,,35888,14626,22299,31,093
"Jefferson County, Nebraska",7354,3580,3774,7110,0,70,0,0,9,165,0,165,7105,249,0.4370,26305,26772,26764,20277,-666666666,10717,-666666666,-666666666,,12676,31,095
"Johnson County, Nebraska",5167,3085,2082,4503,318,70,62,0,153,61,6,55,4657,510,0.4281,21890,23988,25391,6088,6947,1723,18037,-666666666,8925,4475,31,097
"Kearney County, Nebraska",6548,3228,3320,6432,10,7,23,0,27,49,0,49,6199,349,0.4410,31563,31851,32661,17152,4980,,23213,-666666666,24948,9596,31,099
"Keith County, Nebraska",8103,4090,4013,7803,42,49,51,39,27,92,22,70,7587,516,0.4312,26699,27304,28042,14344,9486,11733,9096,16951,20537,6966,31,101
"Keya Paha County, Nebraska",736,387,349,719,1,0,3,0,6,7,2,5,728,8,0.4026,28086,28425,28425,,,-666666666,,-666666666,,,31,103
"Kimball County, Nebraska",3713,1869,1844,3554,1,13,23,0,41,81,6,75,3418,295,0.4200,23727,23953,24385,17376,,30877,26835,-666666666,13637,17142,31,105
"Knox County, Nebraska",8551,4175,4376,7448,16,817,46,14,83,127,15,112,8329,222,0.4419,26675,28987,29052,11773,8088,10758,7676,,17958,11113,31,107
"Lancaster County, Nebraska",301707,151180,150527,262334,11888,1899,12290,228,4252,8816,1090,7726,282000,19707,0.4476,28600,30553,31311,15134,14627,15420,20033,22640,16289,10188,31,109
"Lincoln County, Nebraska",35777,17588,18189,34157,363,106,226,7,270,648,27,621,32889,2888,0.4263,27474,27900,28933,15755,10237,56086,22885,,31230,10021,31,111
"Logan County, Nebraska",830,417,413,806,2,2,0,0,12,8,0,8,814,16,0.3835,24693,24494,24494,,,,-666666666,-666666666,,39675,31,113
"Loup County, Nebraska",542,258,284,531,0,3,0,0,0,8,0,8,542,0,0.3767,28063,28255,28255,-666666666,-666666666,,-666666666,-666666666,-666666666,,31,115
"McPherson County, Nebraska",425,219,206,417,0,0,0,0,0,8,0,8,421,4,0.4150,25352,25820,25898,,-666666666,-666666666,-666666666,-666666666,-666666666,,31,117
"Madison County, Nebraska",35125,17405,17720,32300,461,540,311,0,946,567,120,447,30131,4994,0.4189,24458,25656,27385,12088,13571,9324,12595,-666666666,11224,8084,31,119
"Merrick County, Nebraska",7793,3854,3939,7487,70,8,3,0,49,176,11,165,7482,311,0.4115,26102,26163,26755,9428,7371,,,-666666666,14151,32476,31,121
"Morrill County, Nebraska",4843,2428,2415,4638,36,23,10,0,52,84,14,70,4110,733,0.4133,24216,24206,26338,13268,4725,30130,66050,-666666666,29027,23530,31,123
"Nance County, Nebraska",3607,1781,1826,3593,3,8,1,2,0,0,0,0,3519,88,0.4602,26179,26265,26141,28806,,,,,-666666666,-666666666,31,125
"Nemaha County, Nebraska",7101,3491,3610,6846,112,44,6,2,23,68,10,58,6923,178,0.4330,28690,29450,29916,7096,10329,3668,,,10930,6540,31,127
"Nuckolls County, Nebraska",4352,2150,2202,4254,4,8,27,0,12,47,0,47,4235,117,0.4104,24096,24495,24790,10519,,,,-666666666,,9536,31,129
"Otoe County, Nebraska",15890,7809,8081,15262,21,83,52,0,112,360,51,309,14753,1137,0.4048,27251,27885,28932,13049,33857,10942,19698,-666666666,18152,7673,31,131
"Pawnee County, Nebraska",2695,1339,1356,2625,0,6,0,0,0,64,0,64,2645,50,0.4953,27039,27350,27548,17150,-666666666,,-666666666,-666666666,-666666666,15186,31,133
"Perkins County, Nebraska",2911,1468,1443,2884,5,2,0,0,8,12,0,12,2802,109,0.4199,30429,30529,31022,16439,,,-666666666,-666666666,19175,8683,31,135
"Phelps County, Nebraska",9236,4632,4604,8941,12,11,18,0,52,202,0,202,8751,485,0.4305,27882,28390,29049,12711,11017,,12661,-666666666,17358,8842,31,137
"Pierce County, Nebraska",7179,3614,3565,7030,16,23,12,4,13,81,13,68,7065,114,0.4035,27386,27336,27543,16922,,11309,,,43646,17114,31,139
"Platte County, Nebraska",32703,16488,16215,31340,93,37,202,0,558,473,27,446,27176,5527,0.4037,27052,27561,30040,14342,12069,53603,19540,-666666666,15241,11281,31,141
"Polk County, Nebraska",5242,2584,2658,5094,12,47,15,0,32,42,0,42,5015,227,0.4122,30947,31418,32237,10969,,23779,,-666666666,,15748,31,143
"Red Willow County, Nebraska",10884,5533,5351,10570,175,35,36,0,9,59,0,59,10362,522,0.4380,24529,25084,25736,12119,766,17034,,-666666666,,,31,145
"Richardson County, Nebraska",8149,4026,4123,7634,25,201,24,0,8,257,0,257,8002,147,0.4341,26638,27379,27500,12735,48964,8397,,-666666666,12400,19100,31,147
"Rock County, Nebraska",1407,688,719,1351,4,0,3,0,14,35,0,35,1397,10,0.4252,30247,30762,30853,,,-666666666,,-666666666,21257,17143,31,149
"Saline County, Nebraska",14356,7231,7125,12972,114,9,429,14,608,210,57,153,11008,3348,0.3926,21880,22948,26162,10141,5824,,16534,,9892,12096,31,151
"Sarpy County, Nebraska",172460,86211,86249,152881,7018,638,3927,208,2159,5629,360,5269,157953,14507,0.3813,31906,33021,34097,19677,28436,17280,25438,16291,28289,14073,31,153
"Saunders County, Nebraska",20946,10530,10416,20404,40,49,50,0,58,345,25,320,20526,420,0.4006,30348,30849,31105,14353,8845,12633,28326,-666666666,12190,9036,31,155
"Scotts Bluff County, Nebraska",36599,17667,18932,34154,311,400,242,13,798,681,89,592,28250,8349,0.4531,25863,26689,30238,13852,5248,16489,15577,,18753,11853,31,157
"Seward County, Nebraska",17113,8696,8417,16459,80,17,103,0,225,229,16,213,16723,390,0.4123,28491,29167,29304,12717,25721,12647,13601,-666666666,12791,4152,31,159
"Sheridan County, Nebraska",5259,2586,2673,4402,26,452,36,3,23,317,7,310,5031,228,0.4458,25077,27861,28120,8723,37577,6517,9447,,,12322,31,161
"Sherman County, Nebraska",3090,1522,1568,3040,23,2,9,0,14,2,0,2,3031,59,0.4288,26348,26592,26831,14478,,,11889,-666666666,26743,,31,163
"Sioux County, Nebraska",1274,636,638,1203,4,0,3,0,0,64,5,59,1243,31,0.4308,27279,28443,28793,16981,,-666666666,,-666666666,-666666666,,31,165
"Stanton County, Nebraska",6022,3022,3000,5858,44,0,15,0,16,89,0,89,5704,318,0.4321,29282,29762,30505,16809,15770,-666666666,24213,-666666666,,,31,167
"Thayer County, Nebraska",5163,2558,2605,5040,7,13,0,0,16,87,0,87,5049,114,0.4755,30057,30279,30431,21997,,,-666666666,-666666666,,25574,31,169
"Thomas County, Nebraska",675,357,318,650,0,1,14,0,2,8,0,8,671,4,0.4341,30746,28330,28417,,-666666666,,,-666666666,,146350,31,171
"Thurston County, Nebraska",6989,3457,3532,2807,10,3981,36,0,35,120,14,106,6662,327,0.4937,19100,33618,35601,6624,,9407,4053,-666666666,6246,10181,31,173
"Valley County, Nebraska",4240,2128,2112,4183,12,8,0,0,1,36,0,36,4128,112,0.4412,26384,26565,26926,13343,,,-666666666,-666666666,,13361,31,175
"Washington County, Nebraska",20338,10064,10274,19692,135,33,34,0,91,353,79,274,19788,550,0.4075,31776,32303,32604,17267,20532,36324,16850,-666666666,17760,11350,31,177
"Wayne County, Nebraska",9414,4813,4601,8969,309,29,36,0,54,17,0,17,8902,512,0.4330,26732,27448,28207,13995,8657,17103,10461,-666666666,34563,,31,179
"Webster County, Nebraska",3665,1784,1881,3522,4,0,43,0,13,83,11,72,3506,159,0.4511,24534,25010,25444,14936,,-666666666,19037,-666666666,,8999,31,181
"Wheeler County, Nebraska",805,411,394,802,0,0,1,0,0,2,0,2,805,0,0.4338,30800,30847,30847,-666666666,-666666666,-666666666,,-666666666,-666666666,,31,183
"York County, Nebraska",13842,6799,7043,13195,112,74,25,0,101,335,23,312,13194,648,0.4208,27962,28909,29534,12897,3348,7700,,-666666666,12217,10226,31,185
"Churchill County, Nevada",24148,12285,11863,19706,570,1179,594,58,951,1090,314,776,21022,3126,0.4209,23951,25895,27032,12532,21018,18647,15005,10783,9802,13996,32,001
"Clark County, Nevada",2070153,1035722,1034431,1297573,228502,13297,193617,14869,220266,102029,17121,84908,1441697,628456,0.4522,26661,30446,35697,16066,20676,19149,28039,19250,14960,16630,32,003
"Douglas County, Nevada",47426,23909,23517,42448,321,980,561,140,1495,1481,47,1434,41716,5710,0.4594,35243,37166,38739,19334,13093,19220,29503,19457,15265,19368,32,005
"Elko County, Nevada",52029,27082,24947,45797,624,2870,564,122,1308,744,66,678,39507,12522,0.3774,31378,32987,36476,21297,14431,20437,20504,10294,21587,17688,32,007
"Esmeralda County, Nevada",1069,500,569,993,0,16,0,0,54,6,0,6,933,136,0.3744,22415,22080,22663,18701,-666666666,16538,-666666666,-666666666,22500,,32,009
"Eureka County, Nevada",1730,845,885,1707,2,21,0,0,0,0,0,0,1722,8,0.4081,34031,33894,33368,,,,-666666666,-666666666,-666666666,-666666666,32,011
"Humboldt County, Nevada",17091,8899,8192,14822,82,813,79,5,859,431,74,357,12672,4419,0.3738,27580,28716,31565,20494,18898,12492,34842,,25674,21367,32,013
"Lander County, Nevada",5907,3255,2652,5169,6,352,43,8,194,135,32,103,4374,1533,0.3507,30044,31214,32608,28137,,29377,,,17672,13869,32,015
"Lincoln County, Nevada",5155,2821,2334,4522,147,181,48,0,203,54,4,50,4713,442,0.4865,25505,27596,28980,5322,3603,7672,,-666666666,10757,,32,017
"Lyon County, Nevada",51897,26220,25677,44516,519,1250,695,56,2768,2093,189,1904,43700,8197,0.3936,23519,24598,25789,15226,23502,16058,25860,9971,17039,13178,32,019
"Mineral County, Nevada",4519,2276,2243,2834,54,1061,150,0,227,193,26,167,3933,586,0.4465,24146,28926,29044,16854,15089,13175,27096,-666666666,20561,18717,32,021
"Nye County, Nevada",43198,21547,21651,36636,1266,706,650,184,2621,1135,198,937,37088,6110,0.4184,23075,24642,25399,15625,14214,16566,15698,12926,14009,13219,32,023
"Pershing County, Nevada",6690,4364,2326,5685,322,182,79,46,252,124,11,113,5110,1580,0.4213,17631,19573,22699,8703,3636,8127,11009,,8664,3668,32,027
"Storey County, Nevada",3941,1887,2054,3631,16,75,81,8,23,107,2,105,3697,244,0.3630,34967,35962,36734,22844,2663,49907,16006,,10565,17793,32,029
"Washoe County, Nevada",439914,221166,218748,354121,10117,6906,23733,2676,24642,17719,2510,15209,336446,103468,0.4676,29942,32440,36795,15288,21829,22346,25663,15944,15883,15013,32,031
"White Pine County, Nevada",9893,5759,4134,8481,419,625,63,23,162,120,18,102,8407,1486,0.4201,24186,26120,28760,11131,6732,12847,43989,5787,12212,16788,32,033
"Carson City, Nevada",54412,27785,26627,44416,585,1413,1655,139,4629,1575,277,1298,41938,12474,0.4484,26553,28204,30364,16426,16853,13944,36371,16141,13778,23059,32,510
"Belknap County, New Hampshire",60392,29571,30821,58320,322,149,643,0,97,861,77,784,59439,953,0.4388,32501,32821,33022,17448,26780,29860,36116,-666666666,,14353,33,001
"Carroll County, New Hampshire",47416,23653,23763,46134,170,61,319,9,23,700,33,667,46771,645,0.4549,33481,33713,33687,32696,14021,25451,34734,,25061,23758,33,003
"Cheshire County, New Hampshire",76320,37271,39049,72930,530,137,978,26,343,1376,238,1138,75031,1289,0.4490,30935,31531,31594,18354,15825,16645,32899,,15118,8913,33,005
"Coos County, New Hampshire",32219,17090,15129,31047,637,100,25,0,128,282,76,206,31682,537,0.4296,25467,26139,26304,9769,4811,10231,17032,-666666666,9193,11637,33,007
"Grafton County, New Hampshire",89164,43911,45253,82896,868,460,2896,75,170,1799,108,1691,87228,1936,0.4711,33964,34752,35009,17898,24404,17991,27311,45323,13808,18463,33,009
"Hillsborough County, New Hampshire",404948,200979,203969,367298,9519,460,14945,73,3600,9053,1016,8037,380458,24490,0.4262,36012,36926,37878,18601,21289,55418,36003,19718,23331,18623,33,011
"Merrimack County, New Hampshire",147715,72732,74983,140060,1734,139,2463,13,640,2666,113,2553,144905,2810,0.4197,32848,33563,33754,20609,15602,14134,28877,,19287,14353,33,013
"Rockingham County, New Hampshire",300365,148646,151719,285903,2228,299,5652,0,1534,4749,415,4334,292819,7546,0.4173,41449,42066,42343,26762,32981,25068,33388,-666666666,28352,23128,33,015
"Strafford County, New Hampshire",125913,61524,64389,117495,1216,90,3833,0,442,2837,285,2552,123222,2691,0.4243,30598,31150,31337,19375,22000,24838,27467,-666666666,16560,18040,33,017
"Sullivan County, New Hampshire",43051,21130,21921,41511,259,190,340,33,135,583,14,569,42448,603,0.4159,30552,30894,30941,20941,24370,24183,29894,,14361,14498,33,019
"Atlantic County, New Jersey",274026,132741,141285,184371,42711,563,22658,66,14225,9432,3391,6041,223856,50170,0.4556,28575,33403,36450,15948,19716,19687,21508,16200,15407,11761,34,001
"Bergen County, New Jersey",930310,450329,479981,658572,54765,1777,147370,303,45625,21898,5027,16871,759109,171201,0.4793,44978,48384,52243,28098,34615,27618,43458,50446,25107,21458,34,003
"Burlington County, New Jersey",450236,221808,228428,326657,72668,495,21503,157,11390,17366,1946,15420,416661,33575,0.4281,38137,41338,42055,24593,28843,27951,46076,49968,22135,17674,34,005
"Camden County, New Jersey",511145,247229,263916,321999,100150,1159,28892,86,43722,15137,3676,11461,431018,80127,0.4660,31736,37389,38605,17205,23168,13121,32526,17415,15690,14539,34,007
"Cape May County, New Jersey",95404,46594,48810,86962,4384,58,1013,98,1286,1603,208,1395,88568,6836,0.4646,34550,35791,37099,14976,22007,22595,39736,25656,15503,14515,34,009
"Cumberland County, New Jersey",155744,79905,75839,99295,30904,1163,2077,0,15346,6959,1785,5174,110368,45376,0.4491,22303,25997,29535,14392,16328,18912,23254,-666666666,13570,15671,34,011
"Essex County, New Jersey",792586,380718,411868,330789,318221,2104,39694,214,80468,21096,5806,15290,618172,174414,0.5478,33482,48722,57049,19504,21312,17166,45552,19045,16806,20761,34,013
"Gloucester County, New Jersey",291286,141585,149701,238509,30050,184,8737,74,6324,7408,1782,5626,275048,16238,0.4124,34886,36708,37034,22338,28896,23948,31693,29780,18014,19010,34,015
"Hudson County, New Jersey",668526,332210,336316,370874,85172,2125,99280,513,89152,21410,7557,13853,380709,287817,0.5002,34468,38105,53370,20223,24597,18796,46685,21076,18221,23611,34,017
"Hunterdon County, New Jersey",125708,62725,62983,114597,3291,66,4532,196,1231,1795,364,1431,118178,7530,0.4446,53222,55226,56295,32238,19478,,52306,13670,15187,21132,34,019
"Mercer County, New Jersey",371101,181642,189459,235205,75905,451,38667,118,13588,7167,1329,5838,310119,60982,0.4948,38652,44199,50113,17697,21501,23799,49832,4823,18107,18412,34,021
"Middlesex County, New Jersey",831852,409221,422631,502779,82640,1557,196289,228,30038,18321,6180,12141,665737,166115,0.4308,35209,35946,41060,20707,29409,33046,39212,13278,21423,21335,34,023
"Monmouth County, New Jersey",627532,305359,322173,516179,45729,952,33380,228,18638,12426,1607,10819,562289,65243,0.4692,44504,47474,49390,22817,26065,22730,49130,27523,18678,17284,34,025
"Morris County, New Jersey",498215,244099,254116,406016,15730,534,49582,21,16240,10092,1597,8495,434964,63251,0.4561,51182,53699,56733,26955,37818,40146,50101,,20693,25779,34,027
"Ocean County, New Jersey",586166,282068,304098,537404,18082,600,11113,210,10089,8668,1117,7551,534152,52014,0.4409,31903,32357,33272,19664,25553,11498,47163,967,17561,16339,34,029
"Passaic County, New Jersey",507204,246848,260356,321733,62932,2242,26552,139,74690,18916,3838,15078,304970,202234,0.4766,28661,33909,40836,17554,19296,19780,33938,13467,15486,16336,34,031
"Salem County, New Jersey",64504,31407,33097,51899,8716,93,594,0,1499,1703,151,1552,59412,5092,0.4381,30295,33369,34470,15330,18699,16970,30208,-666666666,15752,9537,34,033
"Somerset County, New Jersey",331686,161900,169786,225368,30707,663,54935,17,13421,6575,1148,5427,284780,46906,0.4577,50034,53654,57823,26418,32098,15132,55613,,23014,21757,34,035
"Sussex County, New Jersey",144694,71759,72935,134806,3056,73,2748,24,1759,2228,279,1949,134214,10480,0.4076,39667,40373,41137,27481,28661,51790,45797,,21184,18687,34,037
"Union County, New Jersey",550436,268169,282267,315833,116934,1435,26599,105,75580,13950,4127,9823,384955,165481,0.4951,36374,44477,53186,20431,25903,17480,48648,42163,17809,19779,34,039
"Warren County, New Jersey",107095,52215,54880,95863,4474,176,2993,14,2012,1563,96,1467,98346,8749,0.4150,35386,36612,37591,20699,29294,19039,28479,20564,15931,17895,34,041
"Bernalillo County, New Mexico",674777,330751,344026,487865,19647,31231,16206,630,91066,28132,11254,16878,343210,331567,0.4721,27402,30384,38287,19452,23460,17800,32034,19442,17612,18297,35,001
"Catron County, New Mexico",3547,1860,1687,3444,30,10,12,0,1,50,27,23,2863,684,0.4089,20762,21087,21872,17028,,,,-666666666,,2082,35,003
"Chaves County, New Mexico",65610,32534,33076,52656,1152,929,523,40,8600,1710,810,900,29563,36047,0.4676,21015,22568,29952,14571,17120,14556,24552,530,13873,14641,35,005
"Cibola County, New Mexico",27373,13884,13489,12008,263,10987,154,25,3020,916,188,728,17009,10364,0.4311,16885,22104,27214,16662,10317,11954,22217,,16551,9967,35,006
"Colfax County, New Mexico",12716,6431,6285,10840,60,275,67,0,1048,426,190,236,6490,6226,0.4721,20911,22367,25519,17297,3493,7677,24585,-666666666,14022,11229,35,007
"Curry County, New Mexico",50544,26213,24331,35557,3110,573,815,123,8717,1649,799,850,30139,20405,0.4536,21502,24731,27685,14474,14460,28786,24692,11985,11670,13741,35,009
"De Baca County, New Mexico",1977,915,1062,1415,0,0,4,0,358,200,95,105,1035,942,0.4399,28232,34991,44669,15054,-666666666,-666666666,,-666666666,14657,4986,35,011
"Do?a Ana County, New Mexico",213825,105129,108696,190289,3614,2433,2242,23,11176,4048,1305,2743,70118,143707,0.4801,20143,20271,32858,14210,34877,21052,23991,,14116,14976,35,013
"Eddy County, New Mexico",56369,28463,27906,51182,786,704,258,54,2595,790,167,623,30051,26318,0.4245,27974,28371,35272,20384,23693,27034,27590,,23031,23566,35,015
"Grant County, New Mexico",28879,14257,14622,26286,173,497,62,5,1087,769,210,559,14568,14311,0.4959,24882,25926,34046,17175,2392,7980,,,18769,13694,35,017
"Guadalupe County, New Mexico",4469,2602,1867,3759,67,75,0,0,450,118,86,32,1007,3462,0.4498,16034,17174,17937,15844,6397,19781,-666666666,-666666666,10200,5047,35,019
"Harding County, New Mexico",565,290,275,520,0,1,0,0,11,33,26,7,328,237,0.5407,23339,24325,28472,16052,-666666666,,-666666666,-666666666,19564,8867,35,021
"Hidalgo County, New Mexico",4531,2227,2304,4253,15,5,0,0,119,139,66,73,1939,2592,0.4196,18077,18497,21898,15263,,,-666666666,-666666666,14871,7037,35,023
"Lea County, New Mexico",68930,35420,33510,60375,2354,537,110,31,3770,1753,405,1348,30437,38493,0.4395,24126,24779,34119,17655,17567,28194,38714,,20832,15699,35,025
"Lincoln County, New Mexico",19726,9736,9990,17540,127,331,71,0,1102,555,0,555,13509,6217,0.4839,25230,26745,31753,13771,8445,14543,21538,-666666666,14302,9714,35,027
"Los Alamos County, New Mexico",17895,9187,8708,15471,95,224,1047,10,622,426,83,343,14893,3002,0.3723,51066,52342,56460,31293,57858,22519,45774,,43633,42568,35,028
"Luna County, New Mexico",24627,12225,12402,22387,297,275,100,7,1132,429,253,176,8616,16011,0.4798,15650,15753,22700,12297,17045,4475,13339,,16514,14812,35,029
"McKinley County, New Mexico",74346,35924,38422,11912,382,56222,734,32,2814,2250,347,1903,64132,10214,0.5121,12882,24302,30167,15117,19394,10254,14183,11978,19169,8699,35,031
"Mora County, New Mexico",4598,2374,2224,2461,5,5,0,0,2093,34,34,0,924,3674,0.4621,13826,13986,16347,13569,,,-666666666,-666666666,13551,,35,033
"Otero County, New Mexico",65333,33491,31842,50277,2347,4591,851,45,4688,2534,802,1732,41296,24037,0.4531,20652,23174,27388,13649,15543,10394,21854,,11379,10960,35,035
"Quay County, New Mexico",8555,4260,4295,7651,168,47,66,16,416,191,99,92,4763,3792,0.4402,18285,19002,22446,14029,10039,29883,8836,,10678,15298,35,037
"Rio Arriba County, New Mexico",39924,19608,20316,23288,221,6231,147,3,8922,1112,582,530,11415,28509,0.5088,19600,20909,26412,19234,28034,13976,54380,,20617,9305,35,039
"Roosevelt County, New Mexico",19618,9843,9775,14543,516,193,75,6,3507,778,277,501,11661,7957,0.4759,18447,20252,23993,11763,22654,18264,4211,,11999,12538,35,041
"Sandoval County, New Mexico",138117,67822,70295,96687,2870,17189,1943,81,13566,5781,1919,3862,86665,51452,0.4231,27060,31070,35917,20915,29889,13596,27850,24515,19728,15597,35,043
"San Juan County, New Mexico",122537,60845,61692,65541,544,46340,677,66,5684,3685,787,2898,98303,24234,0.4621,22927,29680,33238,17886,31219,14298,27514,38748,21018,11917,35,045
"San Miguel County, New Mexico",28350,14268,14082,14188,549,380,293,55,12015,870,437,433,6351,21999,0.5082,16990,20335,22927,16057,4080,10726,9802,,14417,10238,35,047
"Santa Fe County, New Mexico",147320,71604,75716,122883,1150,4936,1797,88,12611,3855,1538,2317,72055,75265,0.4833,34176,36081,49007,22026,34024,17515,46148,45902,22224,28057,35,049
"Sierra County, New Mexico",11442,5663,5779,10489,73,88,27,0,440,325,20,305,8055,3387,0.4514,20495,20771,22877,15091,46959,28356,14252,-666666666,14067,12724,35,051
"Socorro County, New Mexico",17324,8856,8468,13553,31,2134,191,0,841,574,147,427,8762,8562,0.4705,17277,19756,26917,13796,,6902,10337,-666666666,16298,1745,35,053
"Taos County, New Mexico",32961,16084,16877,24936,105,2225,278,0,4715,702,224,478,14314,18647,0.4801,22302,24123,31921,17148,68286,16487,19915,-666666666,16267,10648,35,055
"Torrance County, New Mexico",15599,8098,7501,14291,287,214,32,0,212,563,101,462,9169,6430,0.4952,18967,19226,23162,13596,13084,8359,,-666666666,17987,19306,35,057
"Union County, New Mexico",4292,2398,1894,3348,76,141,5,0,579,143,82,61,2539,1753,0.4699,21091,23759,29938,11528,2782,13450,,-666666666,12157,11126,35,059
"Valencia County, New Mexico",75993,38178,37815,58741,843,3272,381,0,10499,2257,983,1274,30659,45334,0.4402,19842,21019,27299,15516,32992,15957,22383,-666666666,14626,13770,35,061
"Albany County, New York",307891,148964,158927,235711,38530,470,18629,139,4091,10321,1258,9063,290793,17098,0.4610,33888,37655,38097,20085,20347,20606,29534,12783,16117,14216,36,001
"Allegany County, New York",47700,24124,23576,45587,712,131,567,0,210,493,34,459,46960,740,0.4114,21478,21957,22084,8804,6401,24827,17149,-666666666,7383,9085,36,003
"Bronx County, New York",1436785,676440,760345,295351,476525,8375,52462,706,551787,51579,23593,27986,640592,796193,0.5010,18896,26945,35709,15423,19389,17912,20651,25512,14144,17366,36,005
"Broome County, New York",197381,96991,100390,170517,11029,406,8064,79,2067,5219,433,4786,189767,7614,0.4558,25880,27638,27908,12879,13054,15802,21278,18137,11856,9112,36,007
"Cattaraugus County, New York",78506,38795,39711,72288,1273,2249,643,0,380,1673,197,1476,76976,1530,0.4154,22832,23473,23593,10501,18196,16173,26514,-666666666,8647,9446,36,009
"Cayuga County, New York",78783,40388,38395,72587,3405,302,387,0,518,1584,205,1379,76663,2120,0.4157,26596,28006,28255,11348,8600,13005,27838,-666666666,12193,7680,36,011
"Chautauqua County, New York",131748,65093,66655,122325,3465,511,812,109,2165,2361,282,2079,122460,9288,0.4396,23249,24244,24968,10514,10021,19045,13430,15471,10931,7003,36,013
"Chemung County, New York",87742,43482,44260,77481,5143,392,1369,10,381,2966,366,2600,85163,2579,0.4519,26196,27684,27876,14781,10262,9612,46152,,18732,8984,36,015
"Chenango County, New York",49286,24601,24685,47440,442,136,223,29,240,776,75,701,48262,1024,0.4193,23805,24082,24117,19655,18562,18677,24000,,17365,11317,36,017
"Clinton County, New York",81505,41893,39612,74418,3482,163,1098,6,1134,1204,126,1078,79272,2233,0.4358,25024,26452,26602,9349,6241,14033,20087,,7808,13257,36,019
"Columbia County, New York",61860,31058,30802,55383,2693,15,1177,21,673,1898,127,1771,59181,2679,0.4662,33864,35381,35647,18881,20729,32933,41020,,15464,10322,36,021
"Cortland County, New York",48713,23778,24935,45887,799,69,451,21,498,988,50,938,47463,1250,0.4219,24665,25162,25251,17772,19220,69441,20548,,15473,9733,36,023
"Delaware County, New York",46480,23356,23124,44161,896,55,338,0,346,684,106,578,44817,1663,0.4392,24753,25400,25570,15150,9719,24911,18114,-666666666,6703,15077,36,025
"Dutchess County, New York",295905,147197,148708,233311,30648,1244,11120,135,10184,9263,1602,7661,261960,33945,0.4419,35101,38018,39180,21133,23430,23060,39029,40145,19370,14369,36,027
"Erie County, New York",922129,446259,475870,722667,123382,4353,30607,292,20270,20558,3771,16787,875377,46752,0.4635,29940,33262,33626,15386,17824,14727,25434,19316,12462,13216,36,029
"Essex County, New York",38598,20158,18440,35933,1193,108,184,6,482,692,224,468,37411,1187,0.4277,28155,29227,29409,11418,8050,9930,12962,20633,30986,12154,36,031
"Franklin County, New York",51007,27788,23219,42319,2869,3543,232,88,1031,925,100,825,49326,1681,0.4458,23660,25755,25936,14031,2703,18279,48927,35623,16047,14435,36,033
"Fulton County, New York",54297,27062,27235,51509,878,155,379,12,494,870,20,850,52812,1485,0.4287,25092,25765,25857,15594,12113,11362,17007,,13266,11075,36,035
"Genesee County, New York",59053,29325,29728,54536,1470,632,388,0,763,1264,48,1216,57281,1772,0.4052,26381,27355,27559,13061,10981,20668,33131,-666666666,14801,10008,36,037
"Greene County, New York",48069,24956,23113,43053,3238,167,486,3,379,743,245,498,45461,2608,0.4488,26307,28042,28667,11400,8421,6615,36512,,14115,7840,36,039
"Hamilton County, New York",4697,2382,2315,4533,28,5,3,1,12,115,3,112,4631,66,0.4186,27371,27798,28077,3789,9521,,,,,18397,36,041
"Herkimer County, New York",63558,31375,32183,61095,699,124,319,136,225,960,79,881,62312,1246,0.4185,24678,25105,25257,11012,13818,21491,26421,6695,16063,9827,36,043
"Jefferson County, New York",117966,61754,56212,101957,6869,627,1695,306,1768,4744,639,4105,109607,8359,0.4189,24172,25261,25654,15653,19063,20183,24915,16110,16343,11876,36,045
"Kings County, New York",2606852,1234959,1371893,1128927,871223,8730,304037,1001,225869,67065,16020,51045,2100750,506102,0.5201,28134,36370,39474,18496,22504,17533,23733,41009,16264,23761,36,047
"Lewis County, New York",27107,13671,13436,26250,228,50,123,15,166,275,43,232,26662,445,0.4196,25230,25573,25646,17584,17808,10964,17909,,20925,8350,36,049
"Livingston County, New York",64622,32439,32183,60301,1640,122,884,17,498,1160,88,1072,62464,2158,0.4053,24596,25689,26121,8260,5175,21461,16018,,13976,6319,36,051
"Madison County, New York",72089,35429,36660,68421,1481,419,617,32,127,992,85,907,70621,1468,0.4289,26824,27503,27693,12505,10013,20115,27872,,19049,9086,36,053
"Monroe County, New York",749236,361925,387311,569464,114834,3012,26808,189,14606,20323,3054,17269,688396,60840,0.4634,30194,34075,35217,15327,16337,15594,29393,27749,16507,12824,36,055
"Montgomery County, New York",49667,24468,25199,43826,1038,53,370,7,3061,1312,302,1010,43428,6239,0.4502,23885,25344,25972,12548,17586,17347,11931,,12319,10893,36,057
"Nassau County, New York",1356801,658161,698640,945893,155583,3070,118271,241,88759,44984,16061,28923,1138623,218178,0.4544,44548,50609,53119,24243,30378,27740,43028,35584,19627,20463,36,059
"New York County, New York",1634989,773232,861757,928883,244787,6173,192573,946,192292,69335,15444,53891,1211463,423526,0.5967,66522,91540,103508,23323,24457,21275,61895,39821,17723,32444,36,061
"Niagara County, New York",213374,103798,109576,187520,15251,2145,2299,94,1238,4827,643,4184,207819,5555,0.4374,27487,29226,29438,15180,15105,17136,20115,19299,14681,10627,36,063
"Oneida County, New York",232858,116027,116831,200237,14208,412,8826,64,3378,5733,665,5068,220718,12140,0.4577,26577,28485,29066,10453,14284,18901,20834,10448,9680,9934,36,065
"Onondaga County, New York",468050,226022,242028,375133,52001,2673,17120,139,5175,15809,1743,14066,446699,21351,0.4610,30225,33473,33922,17118,16734,27288,22062,12410,14073,12308,36,067
"Ontario County, New York",109450,53705,55745,102012,2720,416,1308,119,1121,1754,155,1599,104807,4643,0.4398,31524,32517,33074,13916,15076,17645,30796,14944,15815,14309,36,069
"Orange County, New York",376242,188285,187957,281602,38663,1320,10058,71,31541,12987,3736,9251,303365,72877,0.4387,31272,33832,34972,21867,25950,25685,35943,35494,19656,16750,36,071
"Orleans County, New York",41938,20887,21051,37652,2627,147,277,28,474,733,46,687,39992,1946,0.4175,23332,24482,25010,8798,12614,26805,28361,,8769,10130,36,073
"Oswego County, New York",120513,60384,60129,115260,1154,187,808,10,958,2136,124,2012,117644,2869,0.4213,24284,24688,24817,13131,19383,34445,24178,,8545,11317,36,075
"Otsego County, New York",60979,29517,31462,57344,1103,167,743,1,475,1146,147,999,58868,2111,0.4349,24989,25443,25684,14635,15454,23229,26099,,12286,16261,36,077
"Putnam County, New York",99408,49388,50020,89000,2354,747,2235,15,3011,2046,310,1736,86342,13066,0.4121,41993,43512,45260,26254,32406,21114,39673,,24992,22412,36,079
"Queens County, New York",2310011,1120010,1190001,936414,423451,8976,572759,1091,288733,78587,29005,49582,1663006,647005,0.4510,27631,33324,39880,20762,26046,20950,24753,28402,19092,21428,36,081
"Rensselaer County, New York",159959,78890,81069,139014,9937,212,3940,0,1287,5569,370,5199,152777,7182,0.4286,31529,33716,34257,14727,18051,17459,21288,-666666666,17854,11943,36,083
"Richmond County, New York",473324,229095,244229,355407,48941,1134,38052,251,18584,10955,2571,8384,388205,85119,0.4538,32678,35192,37603,21443,22829,23639,32856,11935,17748,21215,36,085
"Rockland County, New York",322642,158136,164506,228430,40574,597,19589,26,25602,7824,2423,5401,267942,54700,0.4594,35557,38215,39705,21736,29053,36350,44639,43981,19705,20725,36,087
"St. Lawrence County, New York",111529,56822,54707,103863,2668,864,1252,42,795,2045,376,1669,109034,2495,0.4585,23313,24261,24434,7096,6841,15091,20586,27936,7695,7772,36,089
"Saratoga County, New York",224929,111025,113904,210462,3582,392,5991,57,1012,3433,358,3075,218498,6431,0.4150,37583,37914,38274,23755,27314,18735,44198,,31357,20799,36,091
"Schenectady County, New York",154845,75383,79462,120729,15486,355,6900,51,5454,5870,1487,4383,144680,10165,0.4359,29212,32512,33194,16297,16026,17982,25710,,15293,14001,36,093
"Schoharie County, New York",31667,15789,15878,30322,488,32,258,11,115,441,63,378,30724,943,0.4168,25638,26166,26380,16523,7555,12725,21870,,20173,14008,36,095
"Schuyler County, New York",18336,9183,9153,17726,193,47,95,0,20,255,4,251,18020,316,0.4228,25004,25212,25373,12002,12148,23243,6891,-666666666,,27153,36,097
"Seneca County, New York",35036,18470,16566,32104,1681,124,260,8,154,705,8,697,33912,1124,0.4332,25680,27100,27561,11078,6762,14890,17795,,38881,8324,36,099
"Steuben County, New York",98151,48750,49401,93231,1501,124,1456,13,292,1534,105,1429,96617,1534,0.4510,26830,26876,26741,30540,20935,10580,48366,18331,17457,12536,36,101
"Suffolk County, New York",1498130,737351,760779,1212079,114292,3499,56762,507,74145,36846,10504,26342,1225824,272306,0.4385,38779,42135,45233,21707,25326,21061,36363,36696,18104,17163,36,103
"Sullivan County, New York",75818,38803,37015,61984,6498,179,1201,0,2851,3105,223,2882,64460,11358,0.4660,27068,29563,31142,15127,15623,20258,28004,-666666666,12312,14792,36,105
"Tioga County, New York",49649,24549,25100,48088,365,16,334,10,115,721,47,674,48807,842,0.4339,29654,29917,29943,25897,17998,26300,32073,,32479,16467,36,107
"Tompkins County, New York",104268,51285,52983,84196,4211,302,10638,1,1125,3795,256,3539,99342,4926,0.4980,28888,31436,32004,15223,13910,27218,21994,,17739,11746,36,109
"Ulster County, New York",180505,89631,90874,155745,10674,274,3504,46,3423,6839,773,6066,163123,17382,0.4595,31760,34067,35085,17337,17471,17941,26868,9767,15268,12985,36,111
"Warren County, New York",64911,31835,33076,62408,749,171,595,57,184,747,79,668,63472,1439,0.4416,31652,32131,32477,12573,18050,8052,21417,,11898,22963,36,113
"Washington County, New York",62465,32308,30157,58702,2038,165,292,0,385,883,104,779,60884,1581,0.4127,25200,26138,26348,9421,5273,29596,30932,-666666666,13062,11388,36,115
"Wayne County, New York",91874,45514,46360,85661,2883,164,625,61,825,1655,205,1450,88102,3772,0.4060,26209,27021,27396,15407,16273,17499,17017,10685,19050,9976,36,117
"Westchester County, New York",969229,468336,500893,641027,140015,3863,55359,207,99420,29338,8887,20451,740386,228843,0.5382,49938,60123,66898,22747,29506,23594,55920,32442,18645,23257,36,119
"Wyoming County, New York",41239,22339,18900,37778,2281,150,139,0,351,540,64,476,39917,1322,0.3996,24610,26258,26534,11468,3541,19868,14497,-666666666,13789,9301,36,121
"Yates County, New York",25106,12110,12996,24269,207,36,225,1,112,256,37,219,24588,518,0.4499,26001,26633,26730,18215,6657,4011,3473,,21311,6754,36,123
"Alamance County, North Carolina",156372,74352,82020,110548,29039,621,2214,282,9386,4282,768,3514,137493,18879,0.4565,23989,27139,28294,11330,18844,21568,21942,7397,10679,9233,37,001
"Alexander County, North Carolina",37211,18974,18237,33005,2142,114,430,35,1024,461,23,438,35549,1662,0.4330,20567,21982,22141,9121,11577,33042,8200,,6289,2759,37,003
"Alleghany County, North Carolina",10868,5391,5477,9936,262,170,17,0,403,80,17,63,9854,1014,0.4230,21059,22071,22514,10486,13156,11669,,-666666666,5882,17813,37,005
"Anson County, North Carolina",25883,13575,12308,12423,12612,86,301,0,168,293,8,285,24943,940,0.4330,17548,21843,22782,7108,13897,1955,10873,-666666666,7151,10044,37,007
"Ashe County, North Carolina",26992,13302,13690,25354,193,92,85,15,831,422,153,269,25610,1382,0.4592,22343,22980,23109,13235,13096,10925,29216,,14296,5983,37,009
"Avery County, North Carolina",17633,9639,7994,16209,655,86,85,0,345,253,11,242,16749,884,0.5079,21548,22827,23203,12097,3376,5014,6713,-666666666,14496,6892,37,011
"Beaufort County, North Carolina",47513,22714,24799,33458,12331,54,59,48,640,923,160,763,43960,3553,0.4618,23716,27386,28342,10655,15882,33452,,,10440,5820,37,013
"Bertie County, North Carolina",20324,10389,9935,7313,12608,127,113,2,27,134,30,104,19930,394,0.4518,17244,25027,25417,13896,13018,7437,7112,,8270,8104,37,015
"Bladen County, North Carolina",34454,16361,18093,19831,12086,817,20,0,1277,423,148,275,31874,2580,0.5030,19510,23774,24779,9423,13583,20199,22920,-666666666,12068,9906,37,017
"Brunswick County, North Carolina",119167,57790,61377,99521,12589,506,800,559,2877,2315,125,2190,113527,5640,0.4503,28694,31215,31621,13586,16175,19975,31855,7175,12797,14154,37,019
"Buncombe County, North Carolina",250112,120043,130069,222134,15713,886,2986,227,1981,6185,753,5432,234374,15738,0.4655,28087,29498,30445,13194,16742,25427,25079,20744,12906,13174,37,021
"Burke County, North Carolina",89082,44089,44993,75155,5483,459,3242,23,3360,1360,92,1268,83912,5170,0.4444,20775,22369,22589,8722,16310,12661,13576,,6340,6394,37,023
"Cabarrus County, North Carolina",192296,93508,98788,142064,32188,568,5258,52,8107,4059,664,3395,173419,18877,0.4236,27728,29859,31020,12792,21806,16402,40023,,13951,13297,37,025
"Caldwell County, North Carolina",81623,40166,41457,73059,3998,442,466,25,2667,966,183,783,77625,3998,0.4512,20587,21681,21837,10300,10963,14933,13760,,10773,11078,37,027
"Camden County, North Carolina",10228,5133,5095,8452,1450,23,206,0,5,92,0,92,9957,271,0.4034,26420,27952,28034,20802,20679,,13338,-666666666,,12879,37,029
"Carteret County, North Carolina",68537,33660,34877,60921,4157,258,817,19,778,1587,69,1518,65687,2850,0.4471,29349,30876,31312,14764,17930,17552,26805,,14143,11481,37,031
"Caswell County, North Carolina",23094,11640,11454,14408,7518,41,133,31,513,450,4,446,22271,823,0.4383,20235,22025,22268,7603,18572,,16038,,7275,7931,37,033
"Catawba County, North Carolina",155461,76086,79375,123873,13304,443,6121,0,8778,2942,159,2783,141505,13956,0.4526,24220,27045,27630,10409,15485,16486,15646,-666666666,9646,7266,37,035
"Chatham County, North Carolina",68778,33303,35475,55295,8218,185,975,43,2317,1745,225,1520,60278,8500,0.4900,35109,38690,41432,14148,19318,17819,66942,,10365,13480,37,037
"Cherokee County, North Carolina",27226,13308,13918,25518,375,398,166,0,205,564,7,557,26446,780,0.4220,19285,19685,19833,12418,7037,13370,23017,-666666666,12840,14786,37,039
"Chowan County, North Carolina",14556,6925,7631,9163,4889,178,36,2,130,158,0,158,14060,496,0.4541,22173,26822,27747,8490,14041,36931,,,5849,,37,041
"Clay County, North Carolina",10730,5059,5671,10646,45,0,12,0,9,18,14,4,10392,338,0.4554,23076,23138,23519,11020,6511,-666666666,,-666666666,,,37,043
"Cleveland County, North Carolina",97113,46731,50382,73303,20151,221,975,0,1034,1429,38,1391,94000,3113,0.4628,20677,22648,22897,11699,14743,19205,24023,-666666666,12529,7112,37,045
"Columbus County, North Carolina",57015,28027,28988,35133,17625,2111,180,17,1366,583,31,552,54190,2825,0.5009,21133,25353,25162,19548,14305,15992,10941,29535,15820,7161,37,047
"Craven County, North Carolina",104190,52791,51399,73456,22365,699,2802,84,2009,2775,109,2666,96897,7293,0.4344,25230,29149,29909,15927,17077,13031,13558,10058,14990,9939,37,049
"Cumberland County, North Carolina",325841,159259,166582,166292,120092,4738,7841,759,7368,18751,1348,17403,290321,35520,0.4377,23148,26784,27791,17270,20359,16357,26166,25487,17207,11453,37,051
"Currituck County, North Carolina",24864,12299,12565,22490,1550,140,120,0,111,453,28,425,23973,891,0.3833,28202,28064,28262,23828,34423,18620,24803,-666666666,25940,18195,37,053
"Dare County, North Carolina",35187,17290,17897,32040,707,94,178,0,1277,891,68,823,32750,2437,0.4073,29746,30917,31570,11325,16193,18638,61026,-666666666,10548,20814,37,055
"Davidson County, North Carolina",164058,80049,84009,141859,14750,669,2191,37,1973,2579,153,2426,153069,10989,0.4320,23146,24326,25142,11656,16328,16021,18458,39041,12563,10945,37,057
"Davie County, North Carolina",41568,20263,21305,36842,2635,21,318,0,1124,628,23,605,38901,2667,0.4669,28178,29171,29891,16237,22202,3352,24136,-666666666,18108,15911,37,059
"Duplin County, North Carolina",59121,28969,30152,38153,14724,114,181,25,5008,916,83,833,46518,12603,0.4482,17960,21006,23922,8971,13853,,10604,,9104,7013,37,061
"Durham County, North Carolina",294618,140813,153805,150067,110777,1091,13849,125,10377,8332,1473,6859,255361,39257,0.4790,31473,39675,44931,14537,23038,20222,33665,28022,13078,16680,37,063
"Edgecombe County, North Carolina",54669,25396,29273,21006,30998,216,58,67,1209,1115,106,1009,52417,2252,0.4600,18009,23643,24119,10365,15043,11192,53455,,9491,3681,37,065
"Forsyth County, North Carolina",364691,173059,191632,242803,95187,780,7434,333,10773,7381,1016,6365,319546,45145,0.4960,27593,32255,35544,10707,18313,21430,30563,18545,10204,17362,37,067
"Franklin County, North Carolina",62989,31235,31754,42412,16230,808,260,1,1634,1644,212,1432,58020,4969,0.4292,22394,25792,26663,10591,15708,16172,47132,,12064,10148,37,069
"Gaston County, North Carolina",211753,102235,109518,162526,32627,824,3081,115,7823,4757,568,4189,198226,13527,0.4616,23710,25557,25835,14252,18907,19783,32545,15654,11098,9465,37,071
"Gates County, North Carolina",11615,5762,5853,7363,3837,96,66,0,57,196,0,196,11476,139,0.4006,23602,27269,27436,17531,17676,29485,,-666666666,,6617,37,073
"Graham County, North Carolina",8651,4326,4325,7681,34,704,0,1,163,68,10,58,8392,259,0.4437,18783,19754,19907,7747,21688,11228,-666666666,,9037,9344,37,075
"Granville County, North Carolina",58341,29722,28619,35739,17960,356,248,23,1885,2130,452,1678,53976,4365,0.4266,23563,28328,29152,12910,16843,15226,20141,,11728,12665,37,077
"Greene County, North Carolina",21241,11452,9789,11960,7554,102,41,0,956,628,181,447,18117,3124,0.4384,18682,21096,23877,6869,17639,1451,13615,-666666666,6496,6923,37,079
"Guilford County, North Carolina",511815,242827,268988,288612,171837,2297,23395,336,13961,11377,1364,10013,473048,38767,0.4859,27531,35032,36810,12881,18108,16335,21617,19235,12986,12080,37,081
"Halifax County, North Carolina",52849,25436,27413,21187,27527,1901,443,24,307,1460,203,1257,51479,1370,0.4971,20134,25297,25372,21618,16261,16863,55449,,40561,7620,37,083
"Harnett County, North Carolina",126620,62640,63980,85578,26921,1137,1418,77,6817,4672,713,3959,111585,15035,0.4258,21214,24175,24782,13707,16230,19193,26389,23503,12300,7567,37,085
"Haywood County, North Carolina",59577,28798,30779,57137,637,167,320,20,402,894,152,742,57424,2153,0.4590,26483,26657,26977,15391,22018,21322,36832,,17226,19510,37,087
"Henderson County, North Carolina",110905,53523,57382,101051,3488,219,1257,113,2738,2039,69,1970,100099,10806,0.4299,26534,27582,28896,12270,16912,41227,22432,8835,12036,12446,37,089
"Hertford County, North Carolina",24285,11991,12294,8572,14144,260,195,41,297,776,24,752,23478,807,0.4697,17650,24431,25068,8245,13926,16530,18086,,10623,14242,37,091
"Hoke County, North Carolina",51853,25654,26199,23751,17275,4281,699,56,3036,2755,176,2579,45312,6541,0.4265,18715,22785,23658,14523,17076,11698,19494,28675,12590,11166,37,093
"Hyde County, North Carolina",5629,2977,2652,3743,1855,10,4,0,16,1,0,1,5303,326,0.4122,18770,22702,24008,8520,10978,,,-666666666,14150,,37,095
"Iredell County, North Carolina",167493,82362,85131,136625,20622,749,4020,38,3190,2249,302,1947,155363,12130,0.4675,28268,30689,31733,13713,16506,17181,28445,29013,13404,13488,37,097
"Jackson County, North Carolina",41227,20392,20835,34411,1274,3504,420,9,618,991,68,923,39007,2220,0.4626,21903,23442,23953,8764,7448,17181,19948,,14227,9048,37,099
"Johnston County, North Carolina",182155,89432,92723,142427,27836,962,1179,26,5126,4599,994,3605,158331,23824,0.4034,23171,24966,26716,11152,19026,22973,15792,,8620,10886,37,101
"Jones County, North Carolina",10074,4878,5196,6634,3080,35,21,0,62,242,0,242,9652,422,0.4448,20348,23638,24529,8413,14153,20431,,-666666666,13200,12394,37,103
"Lee County, North Carolina",59540,29003,30537,41679,11332,405,626,52,3997,1449,240,1209,48122,11418,0.4383,22389,25396,28243,11348,16865,15235,22635,,11618,11275,37,105
"Lenoir County, North Carolina",58343,27863,30480,32054,22838,209,333,50,825,2034,10,2024,54116,4227,0.4605,20773,25224,26924,8477,15687,26268,22821,,12576,10389,37,107
"Lincoln County, North Carolina",79783,39547,40236,70542,4271,188,433,13,2613,1723,254,1469,74155,5628,0.4499,26352,27966,28418,13311,13459,21844,29027,,12686,12997,37,109
"McDowell County, North Carolina",45013,22731,22282,40968,1804,238,319,13,1287,384,44,340,42394,2619,0.4254,19233,20147,20365,10691,10966,4924,24165,,8251,2812,37,111
"Macon County, North Carolina",33991,16429,17562,31469,391,161,250,0,1294,426,24,402,31745,2246,0.4748,25195,25842,26333,14726,10925,17958,21378,-666666666,17766,18004,37,113
"Madison County, North Carolina",21130,10447,10683,20310,407,36,105,0,57,215,3,212,20621,509,0.4531,22278,22563,22833,9773,7832,18567,11218,-666666666,2981,33823,37,115
"Martin County, North Carolina",23510,10951,12559,12711,10162,81,38,95,169,254,88,166,22686,824,0.4661,21149,23236,23681,12218,18929,12757,65437,,11318,6837,37,117
"Mecklenburg County, North Carolina",1011774,486037,525737,565183,315272,3181,53861,719,45532,28026,2700,25326,884160,127614,0.4899,34091,43673,47727,15528,21872,23171,31740,8956,13285,18519,37,119
"Mitchell County, North Carolina",15263,7465,7798,14797,62,92,37,20,130,125,0,125,14544,719,0.4540,22130,22595,23177,7687,2889,12076,11941,,4064,7426,37,121
"Montgomery County, North Carolina",27475,13437,14038,21057,5166,75,424,4,433,316,51,265,23331,4144,0.4723,20007,22639,25261,10027,11622,4113,16700,,7806,6908,37,123
"Moore County, North Carolina",93070,44833,48237,77031,11654,652,1203,12,642,1876,63,1813,87284,5786,0.4579,29679,32605,33956,12825,15029,16976,27132,,10333,13390,37,125
"Nash County, North Carolina",94385,45309,49076,50234,36659,624,919,16,3722,2211,491,1720,88222,6163,0.4733,24106,30900,31430,11741,17135,18601,29553,,9693,8928,37,127
"New Hanover County, North Carolina",216430,104029,112401,175310,30589,636,2902,109,2301,4583,217,4366,204856,11574,0.4831,30375,33207,34220,14738,16471,30691,33328,18138,19729,18586,37,129
"Northampton County, North Carolina",20628,10017,10611,8133,11843,104,44,13,129,362,0,362,20215,413,0.4656,18836,24950,25579,4846,15152,6299,28423,,6161,9264,37,131
"Onslow County, North Carolina",185755,100854,84901,138029,27888,937,3531,423,4817,10130,1290,8840,163847,21908,0.4089,22590,23521,24116,18466,22252,25629,20482,33986,17335,13311,37,133
"Orange County, North Carolina",139807,66666,73141,105093,16010,709,10261,30,3067,4637,665,3972,128262,11545,0.5183,37103,41421,43356,16125,21444,14753,36470,38207,13769,13550,37,135
"Pamlico County, North Carolina",12892,6599,6293,9722,2374,148,25,102,232,289,1,288,12439,453,0.4298,24332,28022,28212,10718,14621,12176,21776,1960,7800,7550,37,137
"Pasquotank County, North Carolina",39909,19548,20361,23440,14580,77,637,115,188,872,15,857,38045,1864,0.4496,22549,26944,26076,36547,16043,36447,24094,27443,19178,10942,37,139
"Pender County, North Carolina",56358,28042,28316,43164,9219,243,199,42,2188,1303,280,1023,52733,3625,0.4635,24031,27414,27856,12384,13582,19337,17181,,12969,6693,37,141
"Perquimans County, North Carolina",13470,6439,7031,9880,3296,20,0,9,23,242,27,215,13141,329,0.4515,25407,28296,28627,21599,16748,,-666666666,,23722,22530,37,143
"Person County, North Carolina",39196,19019,20177,26918,10551,361,119,24,504,719,120,599,37591,1605,0.4365,22049,25115,25357,13605,15762,14669,32834,,5953,13438,37,145
"Pitt County, North Carolina",175150,82515,92635,102061,60578,515,3012,36,5048,3900,357,3543,164775,10375,0.4926,24066,29787,30424,12817,16271,14845,31015,,8783,11297,37,147
"Polk County, North Carolina",20324,9732,10592,18530,1084,45,30,8,413,214,0,214,19175,1149,0.4598,28175,29878,30366,10920,12025,,31270,,5781,11664,37,149
"Randolph County, North Carolina",142588,70281,72307,123509,8752,637,1541,13,5761,2375,277,2098,127120,15468,0.4180,21731,22751,23682,12819,16861,11436,14385,,15742,8772,37,151
"Richmond County, North Carolina",45710,22113,23597,28756,14473,933,157,0,360,1031,33,998,42914,2796,0.4733,19411,22703,23924,9132,14053,17248,25147,-666666666,12691,6237,37,153
"Robeson County, North Carolina",134576,64911,69665,39500,32599,52120,948,114,6261,3034,307,2727,123363,11213,0.4889,16221,21251,22842,8731,13592,15316,21415,9278,8886,8317,37,155
"Renville County, North Dakota",2573,1282,1291,2471,17,13,24,0,12,36,18,18,2476,97,0.4038,31646,32559,33397,,,15408,10783,-666666666,,9842,38,075
"Richland County, North Dakota",16329,8454,7875,15305,83,437,34,6,115,349,26,323,15918,411,0.3978,28534,29041,29402,7955,19108,16832,99500,,12608,22010,38,077
"Rolette County, North Dakota",14607,7215,7392,2812,81,11365,39,0,13,297,16,281,14554,53,0.4945,17744,32556,32759,14032,7493,14175,,-666666666,,17970,38,079
"Sargent County, North Dakota",3889,2053,1836,3715,65,27,9,0,38,35,4,31,3774,115,0.4070,33072,33752,33934,18083,27569,21626,,-666666666,,14677,38,081
"Sheridan County, North Dakota",1395,707,688,1362,0,3,0,0,11,19,0,19,1380,15,0.4761,31244,31993,32087,,-666666666,,-666666666,-666666666,,,38,083
"Sioux County, North Dakota",4431,2223,2208,567,2,3717,4,2,20,119,25,94,4268,163,0.5118,15338,30924,30966,12002,,12974,,,32715,11292,38,085
"Slope County, North Dakota",665,361,304,622,32,0,0,0,0,11,0,11,663,2,0.4706,36168,36878,36982,,,-666666666,-666666666,-666666666,-666666666,,38,087
"Stark County, North Dakota",29837,15538,14299,27560,487,257,413,28,432,660,52,608,28339,1498,0.4352,37681,39116,39676,19834,25990,10653,21117,,14852,20737,38,089
"Steele County, North Dakota",1969,1028,941,1958,0,0,0,0,11,0,0,0,1927,42,0.4343,36802,36658,37121,22145,-666666666,-666666666,-666666666,-666666666,,-666666666,38,091
"Stutsman County, North Dakota",21108,10801,10307,19822,205,287,104,18,171,501,130,371,20658,450,0.4399,30623,31326,31490,16936,9728,15680,25662,,37311,19764,38,093
"Towner County, North Dakota",2292,1142,1150,2020,0,81,7,0,5,179,3,176,2239,53,0.4946,33785,37041,37698,8030,-666666666,18928,,-666666666,,5709,38,095
"Traill County, North Dakota",8075,4071,4004,7683,75,76,20,9,83,129,10,119,7820,255,0.4565,31188,32264,32697,11722,12363,11662,,,11495,9005,38,097
"Walsh County, North Dakota",10995,5638,5357,10019,34,231,73,0,506,132,7,125,9812,1183,0.4522,30266,31915,33079,14537,3806,6311,17015,-666666666,17266,10986,38,099
"Ward County, North Dakota",68954,36151,32803,60884,2335,1125,882,90,1034,2604,91,2513,65357,3597,0.4179,32395,33658,34249,17046,28509,24996,34326,12844,12445,17485,38,101
"Wells County, North Dakota",4179,2083,2096,4095,0,15,0,0,8,61,17,44,4142,37,0.4367,30260,30741,30775,14127,-666666666,,-666666666,-666666666,,1928,38,103
"Williams County, North Dakota",31643,17360,14283,27732,891,854,106,27,567,1466,258,1208,29962,1681,0.4621,45442,47339,48099,23962,28221,29599,94416,24852,36978,29367,38,105
"Adams County, Ohio",28111,13972,14139,27298,100,122,49,0,17,525,8,517,27964,147,0.4580,18901,19120,19150,10639,24756,18430,,-666666666,,7142,39,001
"Allen County, Ohio",104664,52851,51813,87249,12448,239,759,0,703,3266,297,2969,101790,2874,0.4517,23600,25199,25441,14036,14664,21595,48300,-666666666,15533,11087,39,003
"Ashland County, Ohio",53343,26055,27288,51722,358,24,317,0,186,736,10,726,52713,630,0.3966,22604,22737,22788,29237,11361,11638,20099,-666666666,58715,11070,39,005
"Ashtabula County, Ohio",99175,49847,49328,92247,3426,183,446,36,479,2358,95,2263,95332,3843,0.4272,20978,21551,21945,10781,13823,20404,31478,,12765,8927,39,007
"Athens County, Ohio",65103,32492,32611,59238,1609,178,2039,22,321,1696,81,1615,63912,1191,0.5101,18602,19053,19153,11374,15459,11963,17682,,18554,7622,39,009
"Auglaize County, Ohio",45871,22865,23006,44499,172,96,276,21,280,527,51,476,45215,656,0.3975,26690,26960,27071,16620,23095,,27433,49052,14130,11603,39,011
"Belmont County, Ohio",69228,35300,33928,64723,2836,204,263,0,273,929,45,884,68655,573,0.4493,24533,24958,24973,12714,17871,9335,76442,-666666666,16875,6104,39,013
"Brown County, Ohio",44059,21855,22204,42800,424,62,92,2,130,549,37,512,43699,360,0.4303,23776,23989,24035,12347,14738,19279,8135,,8491,20956,39,015
"Butler County, Ohio",373638,183146,190492,320711,29293,758,9934,223,3611,9108,526,8582,357300,16338,0.4408,28556,29716,30171,16042,22641,22445,30605,11806,10595,12511,39,017
"Carroll County, Ohio",28108,14029,14079,27311,214,30,92,9,84,368,72,296,27779,329,0.4255,25093,25423,25475,13956,6484,,15710,,,16793,39,019
"Champaign County, Ohio",39175,19599,19576,36965,666,38,194,36,178,1098,68,1030,38592,583,0.3847,24715,25074,25218,15207,18744,24624,45018,,28325,10983,39,021
"Clark County, Ohio",136175,65897,70278,117716,11204,288,933,96,1284,4654,85,4569,131953,4222,0.4423,23992,25038,25292,12183,18486,18668,47372,18576,11746,9925,39,023
"Clermont County, Ohio",201092,99198,101894,191898,2682,391,2190,77,712,3142,112,3030,197632,3460,0.4360,30060,30378,30542,17982,28812,43600,28629,12662,19547,13831,39,025
"Clinton County, Ohio",41854,20761,21093,39547,994,56,130,11,135,981,100,881,41193,661,0.4287,23612,23923,24028,13209,25028,,20381,,14796,10864,39,027
"Columbiana County, Ohio",105230,52906,52324,100017,2386,156,292,0,706,1673,86,1587,103670,1560,0.4375,23785,24295,24309,16330,12325,18350,30981,-666666666,12811,13497,39,029
"Coshocton County, Ohio",36665,18231,18434,35539,378,64,127,0,15,542,56,486,36323,342,0.4035,21521,21810,21801,24168,17959,,16877,-666666666,,8075,39,031
"Crawford County, Ohio",42485,20785,21700,41167,269,14,176,7,145,707,14,693,41882,603,0.4395,22631,22481,22549,36138,22991,31979,32068,,106656,11645,39,033
"Cuyahoga County, Ohio",1258710,599319,659391,795889,374396,3273,35166,279,16432,33275,3898,29377,1190593,68117,0.5077,29143,35317,36233,16917,17099,20455,38935,21051,17161,13471,39,035
"Darke County, Ohio",52185,25632,26553,50964,389,132,174,0,90,436,7,429,51442,743,0.4075,23589,23795,23968,13124,12756,31572,11268,-666666666,16429,13163,39,037
"Defiance County, Ohio",38488,19165,19323,35301,734,139,162,9,1336,807,297,510,34827,3661,0.4018,24703,25369,25887,15856,20357,20645,35856,,18338,8408,39,039
"Delaware County, Ohio",188996,93421,95575,167734,6625,115,9679,60,989,3794,196,3598,184450,4546,0.4325,42985,43692,44011,32239,36039,35096,46804,48963,39740,15108,39,041
"Erie County, Ohio",75808,37092,38716,65526,6066,363,437,86,687,2643,91,2552,72758,3050,0.4515,28684,30408,30828,14441,16909,18636,36000,36217,14486,16583,39,043
"Fairfield County, Ohio",150163,74713,75450,133694,10133,199,1994,31,641,3471,195,3276,147176,2987,0.4216,28746,29508,29626,21249,26417,21369,26050,,22315,9507,39,045
"Fayette County, Ohio",28719,14101,14618,27064,565,19,216,0,181,674,94,580,28180,539,0.4401,22728,23237,23324,13932,20902,,17489,-666666666,9960,9004,39,047
"Franklin County, Ohio",1232118,600802,631316,841819,267515,2047,56170,522,18065,45980,2913,43067,1169360,62758,0.4689,30098,34908,35780,16356,18473,19558,30773,23276,16412,14786,39,049
"Fulton County, Ohio",42466,21055,21411,40024,218,56,173,16,1407,572,96,476,38964,3502,0.4168,27010,27852,28455,15623,12008,20857,15364,,15453,6838,39,051
"Gallia County, Ohio",30376,14839,15537,28790,824,104,199,29,41,389,13,376,30008,368,0.4456,20914,21416,21572,7814,13076,7286,17330,,6215,8990,39,053
"Geauga County, Ohio",94020,46372,47648,90951,1197,71,613,0,105,1083,197,886,92803,1217,0.4520,37537,37994,38040,26074,23719,7977,36114,-666666666,21910,18692,39,055
"Greene County, Ohio",164325,80712,83613,141803,11689,238,4720,37,764,5074,307,4767,160017,4308,0.4472,31877,32926,33004,27113,23013,45714,37745,,25510,18039,39,057
"Guernsey County, Ohio",39478,19497,19981,37839,506,83,123,0,85,842,4,838,39051,427,0.4424,22280,22699,22731,17203,9144,18584,60703,-666666666,,7355,39,059
"Hamilton County, Ohio",805965,387906,418059,549898,207896,1131,19031,312,7381,20316,1266,19050,782665,23300,0.5082,31303,37065,37416,22235,17937,21298,34601,75240,16983,14124,39,061
"Hancock County, Ohio",75672,37160,38512,70392,1029,49,1286,0,1003,1913,379,1534,71837,3835,0.4284,28244,28923,29129,21266,26913,,21011,-666666666,27595,9385,39,063
"Hardin County, Ohio",31652,15787,15865,30512,196,22,265,4,102,551,55,496,31180,472,0.3984,20994,21328,21426,10376,8357,31427,20857,,10498,8616,39,065
"Harrison County, Ohio",15521,7678,7843,14882,315,33,47,0,30,214,0,214,15390,131,0.4171,22639,22787,22788,22992,20017,46588,20051,-666666666,25167,12695,39,067
"Henry County, Ohio",27890,13745,14145,26390,141,28,115,10,655,551,156,395,25853,2037,0.3865,26288,27067,27643,13030,10766,32421,15011,,13539,10515,39,069
"Highland County, Ohio",43109,21245,21864,41440,513,39,190,0,30,897,63,834,42725,384,0.4452,21134,21415,21478,12520,11181,9631,31595,-666666666,,12532,39,071
"Hocking County, Ohio",28690,14246,14444,27943,259,7,74,0,29,378,19,359,28445,245,0.4272,22091,22258,22273,19418,14803,,7243,-666666666,,18425,39,073
"Holmes County, Ohio",43702,21854,21848,43096,80,78,32,0,33,383,38,345,43310,392,0.4125,19517,19580,19614,16719,15295,,17294,-666666666,15297,16532,39,075
"Huron County, Ohio",58704,29041,29663,55623,884,31,165,3,934,1064,72,992,55176,3528,0.4103,23698,24238,24714,13207,12444,30074,21029,,15193,12488,39,077
"Jackson County, Ohio",32717,15979,16738,31754,244,14,50,24,49,582,13,569,32401,316,0.4429,20583,20616,20714,13349,9850,,143758,,,9446,39,079
"Jefferson County, Ohio",67607,32771,34836,61774,3758,166,271,5,33,1600,187,1413,66707,900,0.4480,23356,24081,24217,6709,17002,27054,21600,,8321,10596,39,081
"Knox County, Ohio",60878,29853,31025,58773,626,74,222,0,82,1101,34,1067,60023,855,0.4176,23426,23777,23883,12502,21579,10238,13237,-666666666,13940,9420,39,083
"Lake County, Ohio",229266,111975,117291,211270,8781,286,2885,14,1408,4622,414,4208,220248,9018,0.4191,31053,31907,32357,15947,19043,27897,40083,,23680,11635,39,085
"Lawrence County, Ohio",61503,30191,31312,58678,1385,55,334,0,53,998,54,944,60962,541,0.4521,22567,22891,22919,17194,18713,,32322,-666666666,21615,6841,39,087
"Licking County, Ohio",169762,83232,86530,157242,5775,233,1878,32,570,4032,167,3865,166942,2820,0.4275,27934,28465,28593,17349,29456,16748,22524,,21151,9207,39,089
"Logan County, Ohio",45388,22470,22918,43113,756,24,334,2,127,1032,25,1007,44751,637,0.4215,25877,26095,26157,19113,30973,25542,39213,,13074,10126,39,091
"Lorain County, Ohio",304091,149762,154329,259775,25839,803,2951,134,3915,10674,1527,9147,275803,28288,0.4408,27537,29595,30608,16455,15045,18944,24742,9948,24653,10383,39,093
"Gibson County, Tennessee",49511,23596,25915,38877,9062,177,151,43,309,892,257,635,48292,1219,0.4330,20948,22902,23016,16349,14107,15780,13828,,27179,6132,47,053
"Giles County, Tennessee",29034,14140,14894,25022,2751,16,200,29,299,717,5,712,28428,606,0.4402,21487,22817,23018,9321,15170,,12183,,6571,8982,47,055
"Grainger County, Tennessee",22813,11306,11507,22338,117,48,97,0,1,212,20,192,22159,654,0.4295,19850,20026,19999,20787,8847,14329,23566,-666666666,,6999,47,057
"Greene County, Tennessee",68502,33474,35028,65100,1569,182,223,0,415,1013,115,898,66677,1825,0.4638,21525,22103,22275,10394,10757,11277,29899,-666666666,6423,7183,47,059
"Grundy County, Tennessee",13494,6686,6808,10858,72,30,59,12,14,2449,0,2449,13468,26,0.4808,16132,17241,17262,,7888,18327,30961,,,11088,47,061
"Hamblen County, Tennessee",63203,30662,32541,55598,2606,109,534,15,2565,1776,411,1365,56140,7063,0.4596,20642,21730,22344,9188,16568,19798,37321,,5218,9394,47,063
"Hamilton County, Tennessee",351305,169346,181959,264700,69518,451,6925,134,2872,6705,570,6135,333492,17813,0.4787,28456,31761,32661,14647,17419,23229,31703,35052,16594,14372,47,065
"Hancock County, Tennessee",6609,3288,3321,6474,26,44,6,0,4,55,4,51,6561,48,0.4565,16351,16479,16465,,,19039,,-666666666,,,47,067
"Hardeman County, Tennessee",25975,14094,11881,14574,10805,74,184,0,61,277,26,251,25547,428,0.4445,16178,19205,19284,15610,11594,,65958,-666666666,17267,6167,47,069
"Hardin County, Tennessee",25839,12638,13201,24331,960,84,33,13,36,382,11,371,25308,531,0.5212,22928,23637,23971,9039,11269,19427,25970,,,8379,47,071
"Hawkins County, Tennessee",56567,27698,28869,54433,709,137,233,14,224,817,52,765,55808,759,0.4569,21394,21286,21300,16343,45194,20955,11538,,15522,12770,47,073
"Haywood County, Tennessee",18129,8472,9657,8343,9080,21,13,21,454,197,0,197,17363,766,0.4855,19956,24886,25385,28117,14799,,,,42426,2139,47,075
"Henderson County, Tennessee",27952,13455,14497,24895,2200,10,20,0,253,574,0,574,27349,603,0.4318,20479,21313,21514,8048,16284,,,-666666666,9109,2967,47,077
"Henry County, Tennessee",32291,15680,16611,28946,2777,71,97,0,22,378,43,335,31580,711,0.4827,23090,24227,24371,17258,12818,40158,30236,-666666666,,6725,47,079
"Hickman County, Tennessee",24251,12719,11532,22271,1150,86,44,0,231,469,47,422,23717,534,0.4365,18410,19229,19314,12729,6509,,11127,-666666666,13091,10214,47,081
"Houston County, Tennessee",8234,4120,4114,7776,239,40,22,0,0,157,0,157,8062,172,0.4000,18256,18704,18715,18226,14110,14163,,-666666666,-666666666,3814,47,083
"Humphreys County, Tennessee",18216,8971,9245,17228,671,87,39,9,11,171,74,97,17829,387,0.4583,23221,22658,22894,5961,39015,17011,25923,,22391,20260,47,085
"Jackson County, Tennessee",11526,5795,5731,11191,53,0,7,0,20,255,66,189,11313,213,0.4519,17675,17872,18011,4233,24860,-666666666,,-666666666,,8430,47,087
"Jefferson County, Tennessee",52851,26034,26817,50259,1169,115,180,11,293,824,149,675,51074,1777,0.4470,22674,23157,23490,10466,15469,4301,16434,,14121,10725,47,089
"Johnson County, Tennessee",17923,9618,8305,16701,689,89,29,0,156,259,6,253,17600,323,0.4857,17834,18569,18630,9245,8177,8027,15490,-666666666,5716,7064,47,091
"Knox County, Tennessee",448164,217833,230331,383763,40132,1372,9048,236,4167,9446,762,8684,430963,17201,0.4823,28980,30667,31171,14638,17544,32725,30611,15955,15582,13183,47,093
"Lake County, Tennessee",7643,4823,2820,5228,2193,30,29,4,53,106,22,84,7481,162,0.5033,13330,17174,17334,5452,5047,6667,8593,,,1772,47,095
"Lauderdale County, Tennessee",27261,14248,13013,16836,9502,151,64,0,266,442,63,379,26612,649,0.4582,16217,19026,19303,10468,11423,15363,10255,-666666666,15800,13690,47,097
"Lawrence County, Tennessee",42406,20841,21565,40354,782,129,205,6,397,533,30,503,41599,807,0.4341,19802,19771,19852,11186,13468,13747,81139,,7511,18434,47,099
"Lewis County, Tennessee",11907,5904,6003,11300,193,0,233,0,66,115,34,81,11644,263,0.4226,19877,20557,20693,11122,9082,-666666666,5240,-666666666,,6695,47,101
"Lincoln County, Tennessee",33582,16438,17144,29995,1733,117,69,0,268,1400,151,1249,32534,1048,0.4436,22541,23432,23612,13364,16971,26393,15097,-666666666,16068,11633,47,103
"Loudon County, Tennessee",50637,24646,25991,48125,584,79,369,24,754,702,0,702,46627,4010,0.4601,28660,28936,30256,11206,14002,34843,67531,,14496,16334,47,105
"McMinn County, Tennessee",52606,25618,26988,48845,1978,108,284,29,272,1090,52,1038,50734,1872,0.4571,20472,20593,20820,15051,16005,23497,22797,23090,21942,21818,47,107
"McNairy County, Tennessee",26057,12734,13323,23943,1572,42,16,0,78,406,7,399,25567,490,0.4706,18285,18918,19195,4917,12913,18248,,-666666666,3074,5214,47,109
"Macon County, Tennessee",22924,11376,11548,22459,49,24,18,9,157,208,0,208,21819,1105,0.4529,19437,19686,19895,12328,6763,17888,,,10276,4554,47,111
"Madison County, Tennessee",98128,46518,51610,58487,36718,81,1032,0,427,1383,41,1342,94603,3525,0.4698,23724,28593,29525,10486,16379,33184,30619,-666666666,11111,11000,47,113
"Marion County, Tennessee",28363,13843,14520,26533,502,78,128,0,47,1075,42,1033,27892,471,0.4472,22056,22442,22624,9667,20634,6324,37849,-666666666,14243,12787,47,115
"Marshall County, Tennessee",31335,15380,15955,28207,2296,47,143,0,182,460,44,416,29822,1513,0.4449,23407,24149,24788,11403,17115,17004,40314,-666666666,7362,11062,47,117
"Maury County, Tennessee",85767,41287,44480,72150,9958,347,681,0,862,1769,128,1641,81211,4556,0.4386,24986,26531,27283,12456,18084,17575,18347,-666666666,14757,9829,47,119
"Meigs County, Tennessee",11804,5828,5976,11353,157,6,22,0,0,266,5,261,11631,173,0.4428,19976,20160,20148,20924,10843,,,-666666666,-666666666,14032,47,121
"Monroe County, Tennessee",45482,22698,22784,43243,903,379,190,42,61,664,27,637,43707,1775,0.4386,19840,20007,20419,10944,15879,21715,12267,,31334,12911,47,123
"Montgomery County, Tennessee",189709,94948,94761,135815,36664,1122,4240,806,3027,8035,768,7267,171708,18001,0.4098,23384,25315,25951,18285,18793,31452,20215,23821,19840,13533,47,125
"Moore County, Tennessee",6314,3093,3221,5932,222,97,0,0,0,63,8,55,6294,20,0.5034,30126,30841,30861,,16668,16103,-666666666,-666666666,-666666666,31863,47,127
"Morgan County, Tennessee",21688,12087,9601,20442,1006,43,7,3,66,121,1,120,21440,248,0.4491,18281,19279,19384,4877,1596,784,,,1797,5031,47,129
"Obion County, Tennessee",30900,14833,16067,26467,3154,97,85,10,490,597,80,517,29729,1171,0.4607,21650,23437,23748,10533,11962,10276,14124,,12849,4098,47,131
"Overton County, Tennessee",22090,10963,11127,21575,150,54,53,0,0,258,16,242,21809,281,0.4570,19827,20088,20185,11610,7057,,25517,-666666666,-666666666,6984,47,133
"Perry County, Tennessee",7891,3988,3903,7480,233,29,12,0,0,137,16,121,7721,170,0.4878,18611,19168,19277,11476,11089,,,-666666666,-666666666,5738,47,135
"Pickett County, Tennessee",5096,2531,2565,4962,37,0,0,0,0,97,0,97,5064,32,0.4024,20664,20859,20901,18603,27300,-666666666,-666666666,-666666666,-666666666,8143,47,137
"Polk County, Tennessee",16697,8330,8367,16176,31,56,20,0,93,321,23,298,16397,300,0.4534,22768,23009,22886,27806,13471,11004,,-666666666,24123,13889,47,139
"Putnam County, Tennessee",74652,36847,37805,70453,1762,97,869,38,168,1265,215,1050,70324,4328,0.5212,22555,22845,22678,28209,8852,20892,20239,10913,108614,16125,47,141
"Rhea County, Tennessee",32461,15970,16491,30807,773,85,57,0,152,587,45,542,31024,1437,0.4559,20888,21199,21742,7707,15346,15804,23316,-666666666,9580,15320,47,143
"Roane County, Tennessee",52983,26121,26862,50061,1252,159,355,0,119,1037,85,952,52120,863,0.4560,23942,24237,24116,28281,24110,21565,16777,-666666666,,14707,47,145
"Robertson County, Tennessee",67905,33429,34476,60079,5023,265,347,13,1088,1090,250,840,63740,4165,0.4004,25534,26658,27215,14417,18626,8014,14765,,14690,14141,47,147
"Rutherford County, Tennessee",290289,143078,147211,229831,39633,1039,8674,100,2548,8464,518,7946,269514,20775,0.4094,26373,28125,28989,16152,20798,16736,24615,19777,14486,11540,47,149
"Scott County, Tennessee",22029,10865,11164,21639,69,104,0,0,17,200,0,200,21868,161,0.5599,21011,21187,21273,7843,11278,16680,-666666666,-666666666,,9228,47,151
"Sequatchie County, Tennessee",14710,7292,7418,13064,35,82,0,0,47,1482,0,1482,14211,499,0.4249,21605,22294,22765,11897,20074,13924,-666666666,-666666666,31653,15678,47,153
"Sevier County, Tennessee",94537,46406,48131,89385,621,286,1005,12,1714,1514,42,1472,89407,5130,0.4318,22773,23130,23607,11480,17079,14758,26809,,13369,13329,47,155
"Shelby County, Tennessee",936990,446704,490286,370954,498376,2211,23208,301,25729,16211,1927,14284,881227,55763,0.5078,26963,40464,42190,13788,17903,17757,33354,13692,10277,15350,47,157
"Smith County, Tennessee",19176,9524,9652,18223,480,113,5,0,134,221,30,191,18703,473,0.4590,23108,23728,24020,8700,12245,4628,,-666666666,9854,13526,47,159
"Stewart County, Tennessee",13257,6479,6778,12390,168,50,152,0,62,435,122,313,12930,327,0.4245,21652,22381,22663,3837,20667,19548,15006,-666666666,,6266,47,161
"Sullivan County, Tennessee",156644,75878,80766,148364,2977,249,853,66,1134,3001,70,2931,153975,2669,0.4635,24680,25192,25330,10236,18753,20658,29980,31520,8403,10081,47,163
"Sumner County, Tennessee",172786,84479,88307,153340,11747,538,2077,127,1893,3064,191,2873,165286,7500,0.4356,29313,30305,30848,15043,22616,28097,30364,5623,19194,12049,47,165
"Tipton County, Tennessee",61558,30403,31155,48107,11321,412,345,123,208,1042,44,998,59984,1574,0.4330,24969,26903,26821,29299,17274,38260,26439,,27967,15529,47,167
"Trousdale County, Tennessee",7970,4001,3969,6859,937,0,125,0,0,49,0,49,7937,33,0.4422,23319,24069,24169,,20302,-666666666,,-666666666,-666666666,,47,169
"Unicoi County, Tennessee",17945,8919,9026,17494,140,11,78,0,107,115,25,90,17178,767,0.4548,20958,21089,21478,11233,16315,,23829,-666666666,13278,11605,47,171
"Union County, Tennessee",19081,9506,9575,18694,89,6,50,0,16,226,0,226,18797,284,0.4286,19030,19187,19353,8682,4390,,17150,-666666666,,13370,47,173
"Lucas County, Ohio",434800,211033,223767,316376,83111,1217,7577,89,9058,17372,3850,13522,405788,29012,0.4881,25977,29711,30265,14799,16017,16284,28553,25585,16981,9873,39,095
"Madison County, Ohio",43537,23807,19730,39364,2498,142,419,8,125,981,25,956,42796,741,0.4214,25687,27221,27361,13286,4915,5840,45274,,1802,14773,39,097
"Mahoning County, Ohio",233015,113472,119543,186987,36102,661,1867,46,1530,5822,501,5321,220573,12442,0.4649,24651,27232,27810,13934,13788,13428,28122,59080,17789,10823,39,099
"Marion County, Ohio",65620,35004,30616,59031,3766,115,321,4,581,1802,133,1669,64015,1605,0.4252,21177,22501,22631,6794,6006,11312,53001,,3827,10085,39,101
"Medina County, Ohio",175543,86786,88757,167895,2624,324,2033,9,600,2058,162,1896,172255,3288,0.4084,32911,33301,33434,21723,22074,28272,34398,,11032,20450,39,103
"Meigs County, Ohio",23345,11465,11880,22751,288,18,51,0,12,225,0,225,23215,130,0.4457,21317,21488,21586,4203,20439,,19031,-666666666,,7711,39,105
"Mercer County, Ohio",40886,20558,20328,39808,200,3,182,138,190,365,0,365,40168,718,0.4036,26236,26488,26671,15842,21183,,30049,8091,15987,11908,39,107
"Miami County, Ohio",103864,51232,52632,97723,2058,117,1303,21,322,2320,57,2263,102290,1574,0.4128,27247,27690,27879,15730,19404,23252,34115,,31312,11578,39,109
"Monroe County, Ohio",14442,7220,7222,14146,44,24,45,0,0,183,0,183,14370,72,0.4267,22100,22135,22226,1571,30270,,20796,-666666666,-666666666,15564,39,111
"Montgomery County, Ohio",532761,256454,276307,391493,110098,1149,10427,208,3458,15928,727,15201,518801,13960,0.4659,26392,29253,29550,17644,18141,12256,32476,9457,13639,13152,39,113
"Morgan County, Ohio",14857,7392,7465,13849,471,40,19,0,29,449,0,449,14739,118,0.4420,20301,20793,20796,19336,13498,,28737,-666666666,8986,14233,39,115
"Morrow County, Ohio",35032,17580,17452,34143,196,44,21,0,43,585,15,570,34541,491,0.3867,23630,23990,24092,16019,3328,,,-666666666,21823,10414,39,117
"Muskingum County, Ohio",85991,41858,44133,79381,2832,170,346,14,242,3006,328,2678,85147,844,0.4318,21945,22478,22489,26691,20572,9958,9730,,26557,10831,39,119
"Noble County, Ohio",14429,8821,5608,13237,795,17,15,0,70,295,0,295,14315,114,0.4143,21188,22314,22369,3146,10626,13400,,-666666666,2221,5094,39,121
"Ottawa County, Ohio",40981,20201,20780,39281,472,38,104,7,504,575,140,435,39010,1971,0.4266,30403,30899,31255,21612,14916,19984,26199,,17399,22173,39,123
"Paulding County, Ohio",19057,9493,9564,18125,202,41,77,8,315,289,51,238,18190,867,0.4118,24174,24652,24907,15049,20418,26210,24638,,10109,12290,39,125
"Perry County, Ohio",35947,17953,17994,34999,106,56,100,0,56,630,84,546,35679,268,0.4272,20852,21111,21113,14436,10733,21170,,-666666666,,10769,39,127
"Pickaway County, Ohio",56804,30071,26733,53232,1822,127,183,1,138,1301,143,1158,56049,755,0.4043,24779,25727,25797,15252,6816,59406,3632,,26164,10615,39,129
"Pike County, Ohio",28298,14069,14229,27158,199,63,77,74,94,633,30,603,28032,266,0.4538,21375,21584,21482,26031,28673,24857,14209,,,13257,39,131
"Portage County, Ohio",161796,79194,82602,147808,6539,175,2879,0,731,3664,97,3567,159201,2595,0.4411,26769,27724,27877,15808,19908,23016,16554,-666666666,16738,10693,39,133
"Preble County, Ohio",41561,20594,20967,40424,205,106,186,0,5,635,33,602,41259,302,0.4009,24605,24855,24867,18418,11581,20309,25241,-666666666,,13338,39,135
"Putnam County, Ohio",34116,17025,17091,32370,101,11,88,9,1104,433,151,282,32103,2013,0.3861,27367,28007,28350,13899,15984,12736,24765,,15307,14352,39,137
"Richland County, Ohio",121888,61816,60072,105925,9194,182,929,35,615,5008,320,4688,119810,2078,0.4298,22520,23951,24090,9834,12320,18376,40805,,6608,9741,39,139
"Ross County, Ohio",77193,40501,36692,69703,3388,66,422,27,322,3265,173,3092,76303,890,0.4469,22158,23091,23108,11247,12585,6173,30396,16052,20294,11663,39,141
"Sandusky County, Ohio",59870,29557,30313,54182,1905,124,227,0,2116,1316,195,1121,54159,5711,0.4095,24467,25698,26203,15857,15140,16665,9095,-666666666,14782,6250,39,143
"Scioto County, Ohio",77366,38260,39106,73052,2159,335,325,0,227,1268,76,1192,76402,964,0.4711,20728,21148,21237,10119,10865,18704,41014,-666666666,3100,11777,39,145
"Seneca County, Ohio",55711,27858,27853,52412,1352,73,298,0,404,1172,148,1024,53027,2684,0.4198,23900,24612,24635,21517,10792,23163,13441,-666666666,20126,11190,39,147
"Shelby County, Ohio",48949,24679,24270,46226,1450,179,405,0,151,538,81,457,48227,722,0.4170,27330,27703,27891,12121,14026,31851,34961,-666666666,9734,28834,39,149
"Stark County, Ohio",374762,181928,192834,331467,27197,390,2896,82,1196,11534,446,11088,367823,6939,0.4435,26442,27714,27851,17589,16408,25034,49392,36423,15907,8850,39,151
"Summit County, Ohio",541372,262454,278918,430787,77746,911,14835,175,2036,14882,711,14171,531202,10170,0.4703,29643,32464,32601,21212,18431,36525,26217,11947,12644,12099,39,153
"Trumbull County, Ohio",204908,99872,105036,181833,17085,297,982,19,381,4311,356,3955,201597,3311,0.4420,24445,25488,25614,15947,16029,23424,33974,31016,18956,12161,39,155
"Tuscarawas County, Ohio",92579,45527,47052,89816,745,233,362,0,256,1167,117,1050,90404,2175,0.4232,24173,24334,24529,14449,21209,21850,31882,-666666666,20449,12555,39,157
"Union County, Ohio",53955,25813,28142,49639,1283,158,1574,0,217,1084,137,947,53137,818,0.4075,30431,30694,30754,22354,18726,43365,45736,-666666666,6173,12992,39,159
"Van Wert County, Ohio",28501,13966,14535,27515,333,20,102,0,175,356,84,272,27678,823,0.4158,25316,25780,26085,12635,14400,,14531,-666666666,23344,4249,39,161
"Vinton County, Ohio",13128,6617,6511,12746,29,6,1,0,0,346,0,346,13100,28,0.4032,19431,19769,19786,12107,4207,10333,,-666666666,-666666666,8448,39,163
"Warren County, Ohio",222184,111615,110569,198434,7922,151,10607,43,1584,3443,84,3359,216554,5630,0.4281,36057,36640,36946,21942,23778,19258,40919,193081,20447,21678,39,165
"Washington County, Ohio",61154,30212,30942,58825,682,240,427,31,133,816,47,769,60534,620,0.4528,25462,25744,25869,12455,18292,18537,34260,,9176,12176,39,167
"Wayne County, Ohio",115747,57359,58388,109989,1806,239,1069,0,787,1857,116,1741,113666,2081,0.4131,24311,24610,24700,16016,18139,20489,26720,-666666666,20846,13151,39,169
"Williams County, Ohio",37270,18437,18833,35640,414,108,221,10,473,404,69,335,35763,1507,0.4054,22757,23186,23504,12530,7457,12169,22502,,18731,7940,39,171
"Wood County, Ohio",129418,63646,65772,119403,3638,274,2079,37,1111,2876,636,2240,122657,6761,0.4520,28843,29455,29774,18954,16771,13136,48515,9270,18024,10412,39,173
"Wyandot County, Ohio",22359,11090,11269,21731,93,0,174,4,181,176,7,169,21779,580,0.4032,25064,25262,25551,14392,29149,-666666666,17802,,26034,4635,39,175
"Adair County, Oklahoma",22161,10997,11164,9618,79,9652,136,22,276,2378,48,2330,20799,1362,0.4557,16018,18719,19030,8905,34025,14354,15390,19350,12300,11681,40,001
"Alfalfa County, Oklahoma",5784,3473,2311,4400,125,85,0,0,110,1064,54,1010,5495,289,0.5042,27807,31841,32267,16400,6225,7332,-666666666,-666666666,33993,14658,40,003
"Atoka County, Oklahoma",13847,7266,6581,10174,537,1891,84,12,147,1002,24,978,13376,471,0.4796,19159,21506,21736,8406,5839,14747,11101,,7524,13011,40,005
"Beaver County, Oklahoma",5479,2707,2772,4504,9,27,0,0,902,37,0,37,4288,1191,0.4341,26738,29199,30504,14088,9500,28511,-666666666,-666666666,14975,16849,40,007
"Beckham County, Oklahoma",23290,12339,10951,19523,810,262,198,19,736,1742,105,1637,20075,3215,0.4904,25269,27426,27817,17262,9348,47411,13893,,15793,10736,40,009
"Blaine County, Oklahoma",9777,5358,4419,7618,510,530,29,0,494,596,65,531,8839,938,0.4320,20848,23132,23941,8307,8642,21886,11917,-666666666,10919,9833,40,011
"Bryan County, Oklahoma",44529,21641,22888,33247,841,7023,235,11,1085,2087,26,2061,42067,2462,0.4514,21273,23009,23360,12015,14633,16703,28647,,14912,13826,40,013
"Caddo County, Oklahoma",29510,15389,14121,18543,750,7102,113,23,1032,1947,146,1801,26059,3451,0.4572,20499,24144,24898,12079,16128,15366,,,11609,11815,40,015
"Canadian County, Oklahoma",129571,64268,65303,105804,3005,5139,4096,12,4496,7019,693,6326,119321,10250,0.3926,28724,30956,31499,17177,21341,21256,22558,,15025,16101,40,017
"Carter County, Oklahoma",48530,23448,25082,36143,3257,3782,547,8,1029,3764,197,3567,45349,3181,0.4641,24272,27166,27766,12441,16694,17252,26871,,13351,12727,40,019
"Cherokee County, Oklahoma",48267,23872,24395,25154,645,16468,311,131,749,4809,270,4539,45029,3238,0.4551,19627,23386,24393,9660,9694,15452,33517,22551,11490,15883,40,021
"Choctaw County, Oklahoma",15051,7277,7774,9478,1698,2015,24,26,288,1522,69,1453,14479,572,0.4982,19085,20376,20365,15613,17861,16845,,,19097,15283,40,023
"Cimarron County, Oklahoma",2269,1128,1141,2004,6,19,6,0,176,58,6,52,1793,476,0.4313,26309,25657,28428,18397,,47284,,-666666666,33823,20452,40,025
"Cleveland County, Oklahoma",271818,135801,136017,214323,12299,10342,12026,194,3503,19131,1268,17863,250160,21658,0.4298,28378,30572,31295,18781,21787,22150,22433,21273,17318,17239,40,027
"Coal County, Oklahoma",5755,2816,2939,4078,24,781,27,0,145,700,52,648,5527,228,0.5067,23716,26932,27018,10189,32592,16485,17493,-666666666,12103,15391,40,029
"Comanche County, Oklahoma",124583,64689,59894,79469,21505,6892,2644,630,2594,10849,1036,9813,109097,15486,0.4431,23925,26499,27288,17540,20782,16910,22872,22533,21951,16566,40,031
"Cotton County, Oklahoma",6062,2988,3074,4841,123,590,9,0,27,472,4,468,5633,429,0.4146,22411,24762,24899,15645,11251,17392,,-666666666,5581,8350,40,033
"Craig County, Oklahoma",14683,7494,7189,9694,458,2891,101,29,136,1374,38,1336,14203,480,0.4241,20130,21920,22259,11047,9809,16141,27249,36107,23286,18164,40,035
"Creek County, Oklahoma",70931,35091,35840,56645,1530,8146,364,23,494,3729,114,3615,68300,2631,0.4422,23336,25023,25281,18019,14136,15782,24311,,11565,19417,40,037
"Custer County, Oklahoma",29248,14597,14651,23856,905,716,355,24,809,2583,201,2382,24361,4887,0.4429,23540,25602,28320,11187,13161,15698,13412,10992,23069,11958,40,039
"Delaware County, Oklahoma",41433,20505,20928,27112,132,9011,494,43,590,4051,152,3899,39975,1458,0.4587,22267,26492,26653,11498,14089,14545,19413,37272,12456,13048,40,041
"Dewey County, Oklahoma",4862,2461,2401,4351,8,38,20,0,5,440,17,423,4553,309,0.4450,25708,26953,27720,15364,,20345,13555,-666666666,,15075,40,043
"Ellis County, Oklahoma",4123,2002,2121,3835,0,41,22,0,20,205,33,172,3820,303,0.4844,28610,28794,29859,13331,-666666666,95015,7282,-666666666,33960,13660,40,045
"Garfield County, Oklahoma",62481,30941,31540,51463,1922,1163,490,1596,2826,3021,187,2834,55426,7055,0.4227,24968,27239,28375,12913,16537,19457,22933,8250,14746,12489,40,047
"Garvin County, Oklahoma",27570,13672,13898,22744,703,1598,103,1,309,2112,116,1996,25453,2117,0.4717,22208,23183,24036,12137,17426,17553,31862,,16883,17124,40,049
"Grady County, Oklahoma",53955,26854,27101,46279,1169,2685,142,6,413,3261,191,3070,51058,2897,0.4373,26250,27995,28652,13743,16134,18262,19205,,16255,13318,40,051
"Grant County, Oklahoma",4497,2276,2221,4029,61,22,5,0,131,249,0,249,4295,202,0.4008,29559,30554,30586,14006,20198,20991,10140,-666666666,16739,23655,40,053
"Greer County, Oklahoma",6081,3546,2535,4750,470,268,0,0,368,225,87,138,5427,654,0.4724,20147,21237,21402,20917,5131,21272,-666666666,-666666666,29951,11124,40,055
"Harmon County, Oklahoma",2813,1395,1418,1888,207,20,51,0,410,237,123,114,2045,768,0.4619,21227,26937,28953,10016,9918,17945,8414,-666666666,11960,4679,40,057
"Harper County, Oklahoma",3785,1869,1916,3589,4,6,4,0,100,82,2,80,2986,799,0.4308,24948,25007,28737,12154,,,,-666666666,30561,17662,40,059
"Haskell County, Oklahoma",12835,6388,6447,9554,103,2141,72,2,52,911,10,901,12335,500,0.4248,18981,20489,20883,8533,14128,13450,45094,,10313,15188,40,061
"Hughes County, Oklahoma",13727,7368,6359,9336,799,2713,6,6,56,811,9,802,13075,652,0.4496,16672,19983,20550,9450,5247,10669,,,5270,10847,40,063
"Jackson County, Oklahoma",25864,12867,12997,18159,1948,464,367,37,3266,1623,411,1212,19946,5918,0.4494,23616,25734,26651,13629,19627,25414,28438,,13472,9627,40,065
"Jefferson County, Oklahoma",6280,3166,3114,5220,79,439,8,0,266,268,40,228,5682,598,0.4532,19651,21191,21797,10419,12663,10323,,-666666666,11408,15757,40,067
"Johnston County, Oklahoma",11027,5422,5605,7916,212,685,12,19,123,2060,163,1897,10508,519,0.4458,19602,21042,21281,11007,11004,24657,8442,,11507,13852,40,069
"Kay County, Oklahoma",45398,22517,22881,36077,868,3560,282,0,1048,3563,200,3363,42093,3305,0.4419,23514,25910,26415,14866,14042,14099,13899,-666666666,18055,13338,40,071
"Kingfisher County, Oklahoma",15392,7692,7700,12760,136,604,0,4,1407,481,37,444,13102,2290,0.4293,30011,32473,33481,14685,24413,28938,-666666666,,13394,16160,40,073
"Kiowa County, Oklahoma",9239,4611,4628,7300,351,505,42,6,514,521,80,441,8239,1000,0.4774,22857,25687,26403,11363,15606,13739,,,12508,8486,40,075
"Latimer County, Oklahoma",10643,5393,5250,7235,128,2012,42,0,63,1163,31,1132,10294,349,0.4778,22560,25998,26318,7944,6823,16192,22319,-666666666,2127,15038,40,077
"Le Flore County, Oklahoma",49885,25002,24883,37781,1190,5171,240,57,1164,4282,134,4148,46505,3380,0.4571,19138,20606,21198,8327,10097,15537,22480,8775,9430,15642,40,079
"Lincoln County, Oklahoma",34640,17194,17446,29696,619,2649,53,18,129,1476,65,1411,33579,1061,0.4476,23878,24811,25046,17287,18133,20039,19209,,23299,14784,40,081
"Logan County, Oklahoma",45171,22366,22805,37114,4030,1582,260,29,311,1845,165,1680,42659,2512,0.4652,27483,29153,29862,15916,14525,20949,145194,,16761,13432,40,083
"Love County, Oklahoma",9768,4830,4938,8149,168,672,26,0,289,464,16,448,8366,1402,0.3776,20440,20869,22483,11377,11126,19697,89546,-666666666,17969,15017,40,085
"McClain County, Oklahoma",37222,18563,18659,31289,357,2222,227,0,959,2168,50,2118,34380,2842,0.4104,27217,28476,28879,16726,15563,23539,10475,-666666666,15911,21479,40,087
"McCurtain County, Oklahoma",33071,16264,16807,21541,2709,4514,171,267,616,3253,232,3021,31238,1833,0.4598,18507,20788,20945,10668,15666,14338,20871,7731,12056,13537,40,089
"McIntosh County, Oklahoma",20161,9950,10211,14200,676,3165,106,0,18,1996,10,1986,19652,509,0.4457,21456,23235,23501,11870,18341,17507,14598,-666666666,,16579,40,091
"Major County, Oklahoma",7721,3861,3860,6926,38,147,45,0,323,242,12,230,7019,702,0.4545,27797,29650,30486,11653,17368,17001,,-666666666,13689,6841,40,093
"Marshall County, Oklahoma",16079,8021,8058,11468,232,1265,28,0,1544,1542,268,1274,13432,2647,0.4325,21394,24281,24714,13650,7569,16559,7029,-666666666,12549,15092,40,095
"Mayes County, Oklahoma",40923,20382,20541,27614,187,5103,182,92,81,7664,142,7522,39623,1300,0.4295,21756,24411,24673,14254,16722,17357,19168,41246,13660,15157,40,097
"Murray County, Oklahoma",13792,6801,6991,10438,240,943,66,0,380,1725,110,1615,12997,795,0.4115,24454,26982,27445,11287,10642,17183,23152,-666666666,15934,16982,40,099
"Muskogee County, Oklahoma",69939,34194,35745,41979,7745,12246,488,27,1334,6120,145,5975,65933,4006,0.4625,21109,24377,24936,11829,14995,17976,26561,23607,12749,14077,40,101
"Noble County, Oklahoma",11470,5662,5808,9652,135,934,0,0,28,721,2,719,11092,378,0.4558,26701,29304,29576,14441,7539,14263,-666666666,-666666666,17243,11921,40,103
"Nowata County, Oklahoma",10510,5179,5331,7220,231,1921,27,51,71,989,14,975,10210,300,0.4356,21085,23529,23771,10430,13506,17529,23078,12098,,13691,40,105
"Okfuskee County, Oklahoma",12212,6542,5670,7853,977,1678,22,0,62,1620,66,1554,11744,468,0.4581,17381,20017,20293,11866,10495,13606,,-666666666,12508,12753,40,107
"Oklahoma County, Oklahoma",764698,374134,390564,526547,114349,22351,24944,576,24744,51187,2729,48458,639548,125150,0.4862,28059,32234,36130,12582,18923,22225,26710,19020,14078,15590,40,109
"Okmulgee County, Oklahoma",39322,19447,19875,25836,3324,4948,102,12,139,4961,42,4919,37879,1443,0.4449,20721,23270,23480,15398,17971,15277,10176,,27341,14603,40,111
"Osage County, Oklahoma",47923,24031,23892,31467,5424,6702,160,37,379,3754,46,3708,46353,1570,0.4394,23416,26005,26334,12350,17953,19687,24694,29205,14394,17063,40,113
"Ottawa County, Oklahoma",32022,15720,16302,22037,287,4319,228,210,528,4413,102,4311,30345,1677,0.4370,18616,20421,20889,8905,7200,16086,22475,14926,9629,13868,40,115
"Pawnee County, Oklahoma",16444,8212,8232,13122,181,1866,56,16,26,1177,2,1175,15997,447,0.4275,22750,23507,23680,16489,11063,22425,15036,,,16989,40,117
"Payne County, Oklahoma",79953,40872,39081,64597,2952,4028,3447,61,317,4551,123,4428,76382,3571,0.5315,22409,24398,24858,13803,16932,12229,16051,,13330,12369,40,119
"Pittsburg County, Oklahoma",44643,22693,21950,32241,1508,3781,224,20,611,6258,132,6126,42584,2059,0.4454,23339,26122,26422,13209,20030,16337,12955,,15628,15196,40,121
"Pontotoc County, Oklahoma",38213,18664,19549,26997,806,2928,354,6,201,6921,48,6873,36347,1866,0.4392,22710,25016,25708,11224,18278,21067,14074,,19047,15492,40,123
"Pottawatomie County, Oklahoma",71551,34082,37469,54456,2194,9898,458,16,696,3833,94,3739,68149,3402,0.4371,21422,23605,23966,12566,11175,14927,29451,20650,14173,13407,40,125
"Pushmataha County, Oklahoma",11149,5462,5687,8369,110,1368,44,4,75,1179,0,1179,10792,357,0.5091,22207,23362,23550,15554,12502,22483,9093,,13339,15720,40,127
"Roger Mills County, Oklahoma",3732,1823,1909,3399,4,58,1,0,0,270,0,270,3490,242,0.4839,27869,28832,30245,8953,,16298,,-666666666,-666666666,18460,40,129
"Rogers County, Oklahoma",89970,44799,45171,67539,904,10623,855,10,1475,8564,133,8431,86191,3779,0.4283,28938,31387,31702,20466,25164,22587,23099,,22298,19659,40,131
"Seminole County, Oklahoma",25403,12396,13007,17363,1232,5138,54,9,192,1415,128,1287,24249,1154,0.4639,19374,22171,22420,12848,15171,13227,9161,,17363,11762,40,133
"Sequoyah County, Oklahoma",41344,20456,20888,26875,826,7731,274,30,550,5058,118,4940,39795,1549,0.4431,18698,19731,19842,11947,16457,17563,9185,,11856,16608,40,135
"Stephens County, Oklahoma",44631,21698,22933,37500,937,2364,269,13,1439,2109,185,1924,41506,3125,0.4682,24555,26263,26593,13574,14711,17940,9608,,11770,16706,40,137
"Texas County, Oklahoma",21499,11359,10140,13430,679,145,578,0,5805,862,169,693,11816,9683,0.4089,22923,26064,29589,16242,18060,25122,30813,-666666666,16473,15606,40,139
"Tillman County, Oklahoma",7611,3902,3709,5354,652,173,20,4,883,525,209,316,5682,1929,0.4497,20549,24270,25751,11710,14227,13023,,,11406,8458,40,141
"Tulsa County, Oklahoma",629823,307129,322694,444511,62574,29328,17950,475,23745,51240,2318,48922,555372,74451,0.4828,28970,33245,35255,13784,17421,23061,26282,15551,13452,17622,40,143
"Wagoner County, Oklahoma",76190,37685,38505,57782,2708,6292,1001,36,893,7478,264,7214,72020,4170,0.4024,26159,28440,28961,15982,20250,20514,21802,49353,15349,17188,40,145
"Washington County, Oklahoma",51892,25164,26728,40589,1287,5192,992,3,469,3360,131,3229,48960,2932,0.4661,28528,30874,31710,15912,16277,18954,37768,,17355,18493,40,147
"Washita County, Oklahoma",11626,5797,5829,10638,9,105,17,0,134,723,3,720,10525,1101,0.4412,25032,25713,26829,11133,,19466,,-666666666,5696,16950,40,149
"Woods County, Oklahoma",9125,4922,4203,8152,247,81,78,0,73,494,49,445,8547,578,0.4497,27464,29641,30123,18876,7210,8764,7851,-666666666,12004,10122,40,151
"Woodward County, Oklahoma",21111,11153,9958,19063,151,272,27,6,414,1178,58,1120,18602,2509,0.4485,27308,28739,30892,12083,11849,9494,12074,,25194,11236,40,153
"Baker County, Oregon",16030,8127,7903,15148,65,240,124,43,83,327,11,316,15415,615,0.4462,24776,25277,25668,17752,30503,18073,10496,14747,18384,13694,41,001
"Benton County, Oregon",87455,44079,43376,76207,860,572,5585,274,1066,2891,148,2743,81355,6100,0.4818,28986,30313,31386,14340,14462,40129,23519,6858,16013,13544,41,003
"Clackamas County, Oregon",394967,194409,200558,351391,3604,2895,16002,1066,6738,13271,919,12352,362464,32503,0.4443,35506,36674,37725,20162,27741,20676,34355,24066,18788,20720,41,005
"Clatsop County, Oregon",37660,18744,18916,34102,290,265,422,75,783,1723,190,1533,34586,3074,0.4284,27071,27895,28625,12420,17801,11750,67097,25140,13040,11327,41,007
"Columbia County, Oregon",49645,24908,24737,46036,303,575,558,124,549,1500,78,1422,47344,2301,0.4377,27449,27866,28405,17971,19842,20429,27043,15556,32804,18038,41,009
"Coos County, Oregon",62944,30893,32051,55775,824,1447,758,93,1159,2888,41,2847,59034,3910,0.4798,24261,25466,25769,13091,4308,14935,24462,6744,14177,15920,41,011
"Crook County, Oregon",21334,10471,10863,19606,98,238,34,14,662,682,142,540,19746,1588,0.4146,22346,23159,23314,14327,6578,28676,,,10691,10905,41,013
"Curry County, Oregon",22364,10915,11449,20484,87,442,128,5,224,994,27,967,20907,1457,0.4314,24908,25730,25990,17078,26353,24321,18175,,15595,11190,41,015
"Deschutes County, Oregon",170813,84267,86546,159574,824,854,1742,177,2618,5024,622,4402,157784,13029,0.4616,30177,30676,31693,15781,23985,25056,33421,27388,18974,21031,41,017
"Douglas County, Oregon",107375,53026,54349,99671,380,1309,1012,95,625,4283,164,4119,101726,5649,0.4417,23608,23937,24340,16804,18034,29059,30235,21145,14383,14623,41,019
"Gilliam County, Oregon",1913,969,944,1818,6,54,0,10,25,0,0,0,1727,186,0.4412,23360,23811,25064,9899,,17996,-666666666,,,-666666666,41,021
"Grant County, Oregon",7227,3608,3619,6893,30,48,17,0,9,230,0,230,6974,253,0.4363,23960,24387,24736,15119,,31108,31776,-666666666,28467,10723,41,023
"Harney County, Oregon",7214,3645,3569,6601,46,251,32,10,73,201,1,200,6858,356,0.4371,22795,23756,24490,9897,8030,11081,5847,,19660,13910,41,025
"Hood River County, Oregon",22842,11495,11347,20383,130,252,391,7,1163,516,123,393,15796,7046,0.4369,28347,27859,33676,17126,,37350,35510,,36859,22137,41,027
"Jackson County, Oregon",210916,102814,108102,192714,1439,1573,2319,636,3806,8429,485,7944,185858,25058,0.4587,25612,26319,27843,12595,14628,19051,42248,20496,13523,13806,41,029
"Jefferson County, Oregon",22305,11467,10838,15500,246,3908,155,87,1847,562,94,468,17884,4421,0.4159,21630,25620,27519,11914,9455,11858,19467,14700,11383,20192,41,031
"Josephine County, Oregon",84063,41141,42922,77710,307,1200,680,5,1363,2798,254,2544,78213,5850,0.4789,23004,23651,24131,13301,21150,16726,31109,32060,10750,11906,41,033
"Klamath County, Oregon",65946,33005,32941,58193,407,2222,681,88,1398,2957,151,2806,58123,7823,0.4415,23071,24179,25382,12990,16248,16157,24986,20249,13661,11495,41,035
"Lake County, Oregon",7799,4196,3603,7027,44,106,95,0,202,325,26,299,7207,592,0.4263,20327,21516,22031,10257,,14626,10160,-666666666,9242,8611,41,037
"Lane County, Oregon",360273,177392,182881,317641,3904,4064,9191,886,7855,16732,1086,15646,330870,29403,0.4659,25612,26719,27453,14418,16067,18404,24227,12720,15124,14934,41,039
"Lincoln County, Oregon",46685,22631,24054,41174,212,1401,590,91,1111,2106,321,1785,42657,4028,0.4392,24593,25632,26431,12718,17313,18864,18838,9785,14751,16261,41,041
"Linn County, Oregon",119862,59243,60619,110179,591,1719,1373,116,2357,3527,521,3006,109808,10054,0.4281,22934,23582,24256,13322,15137,17929,19918,14068,14881,13272,41,043
"Malheur County, Oregon",30474,16638,13836,26603,348,257,479,21,1761,1005,185,820,20459,10015,0.4598,17150,18083,20905,10787,12086,7328,21288,7719,10024,7438,41,045
"Marion County, Oregon",326527,162353,164174,267594,3769,3416,6285,2559,22965,19939,3019,16920,242868,83659,0.4236,23348,25257,28218,12277,16014,17589,23244,18706,13653,11896,41,047
"Morrow County, Oregon",11207,5711,5496,9767,15,78,40,14,814,479,51,428,7321,3886,0.3657,21279,22345,25960,14159,,22659,17840,,15902,9915,41,049
"Multnomah County, Oregon",778193,385176,393017,608567,42317,6142,53626,4883,22041,40617,3763,36854,691614,86579,0.4824,33255,36751,38627,17335,17807,16534,27896,15905,17266,17335,41,051
"Polk County, Oregon",78470,38065,40405,68820,621,1102,1527,248,2182,3970,442,3528,68238,10232,0.4153,24827,26269,27424,14342,23968,16010,18030,22600,14640,10762,41,053
"Sherman County, Oregon",1705,856,849,1593,8,42,2,0,0,60,4,56,1618,87,0.5300,32223,33659,35042,9724,9025,11350,,-666666666,-666666666,12413,41,055
"Tillamook County, Oregon",25552,12929,12623,23352,87,207,190,105,855,756,48,708,22979,2573,0.4372,23688,24732,25896,9339,30077,14300,19293,9454,10564,11199,41,057
"Umatilla County, Oregon",76582,39827,36755,65277,527,2291,517,125,4083,3762,417,3345,56986,19596,0.4252,21528,22756,24828,14348,13417,13314,43366,13106,13404,12447,41,059
"Union County, Oregon",25758,12706,13052,23792,193,257,284,296,248,688,44,644,24627,1131,0.4684,25458,25909,26161,15307,10970,24018,45522,15639,10347,15853,41,061
"Wallowa County, Oregon",6836,3337,3499,6564,27,29,15,1,9,191,9,182,6662,174,0.4279,24956,25377,25526,17601,,42190,12193,,,10280,41,063
"Wasco County, Oregon",25657,12789,12868,22593,166,1018,206,183,890,601,110,491,21368,4289,0.4083,22931,24207,25482,15375,6434,15866,19553,7181,15826,7963,41,065
"Washington County, Oregon",564088,278000,286088,437467,10288,3550,53569,2329,29333,27552,3384,24168,472593,91495,0.4270,33433,35540,38323,15255,26730,24245,37972,21765,13507,17030,41,067
"Wheeler County, Oregon",1369,657,712,1309,0,15,9,0,8,28,0,28,1343,26,0.4374,22723,22943,22858,26535,-666666666,21667,,-666666666,,13993,41,069
"Yamhill County, Oregon",102217,51023,51194,90700,949,1194,1517,270,3660,3927,310,3617,86449,15768,0.4457,26523,27439,29102,16493,6637,17257,27925,11791,15293,23920,41,071
"Adams County, Pennsylvania",101759,50232,51527,93855,1465,71,669,0,3561,2138,525,1613,95038,6721,0.3980,28515,29607,29898,13702,29278,69320,21754,-666666666,10648,10578,42,001
"Allegheny County, Pennsylvania",1230360,593029,637331,992002,159592,1435,41764,299,5083,30185,1616,28569,1207105,23255,0.4856,33830,36700,36848,24359,19141,19056,38316,33001,20582,13884,42,003
"Armstrong County, Pennsylvania",67512,33505,34007,66101,634,14,182,0,40,541,30,511,67056,456,0.4174,24634,24848,24880,18546,16822,55614,14948,-666666666,14960,10897,42,005
"Beaver County, Pennsylvania",169205,82025,87180,153775,10273,78,804,33,532,3710,86,3624,166796,2409,0.4277,28018,29236,29327,22045,17386,22803,23930,,23726,8590,42,007
"Bedford County, Pennsylvania",48852,24409,24443,47729,263,97,111,0,134,518,71,447,48307,545,0.4157,23632,23872,23920,15535,16328,21803,21606,-666666666,8007,10063,42,009
"Berks County, Pennsylvania",414097,203542,210555,346269,20009,3550,5733,160,17449,20927,2779,18148,336151,77946,0.4375,27844,30289,32498,12338,17773,12559,31282,14083,14217,10144,42,011
"Blair County, Pennsylvania",125917,61654,64263,120688,2018,27,933,48,338,1865,44,1821,124487,1430,0.4418,24466,24842,24774,27013,12008,29548,29207,45940,15207,12269,42,013
"Bradford County, Pennsylvania",61808,30540,31268,60019,351,64,403,9,232,730,61,669,60922,886,0.4291,26255,26452,26514,25041,7150,15177,24873,,42249,15569,42,015
"Bucks County, Pennsylvania",626220,307068,319152,556082,24226,909,27680,25,6069,11229,1613,9616,595821,30399,0.4437,39958,41153,41877,22258,26024,23420,41991,,19901,18056,42,017
"Butler County, Pennsylvania",185974,91929,94045,178887,2038,144,1919,55,421,2510,132,2378,183534,2440,0.4382,33406,33491,33586,24782,32423,23458,49232,72451,17419,18423,42,019
"Cambria County, Pennsylvania",137762,67867,69895,129288,4592,71,659,58,395,2699,327,2372,135660,2102,0.4446,23993,24805,24881,12153,9481,23758,49909,12190,13457,5247,42,021
"Cameron County, Pennsylvania",4807,2432,2375,4702,29,7,11,0,5,53,0,53,4768,39,0.4468,25716,25995,26163,5844,,,,-666666666,,12436,42,023
"Carbon County, Pennsylvania",64330,31944,32386,61831,1161,102,301,0,207,728,18,710,61714,2616,0.4099,25743,26237,26467,17813,12551,20225,29482,-666666666,5573,9803,42,025
"Centre County, Pennsylvania",159178,83558,75620,140074,6043,249,9234,70,837,2671,366,2305,154788,4390,0.4710,27584,28820,29028,17698,19849,18476,20137,20577,17611,10141,42,027
"Chester County, Pennsylvania",512028,252007,260021,441027,29907,624,23718,123,5827,10802,1498,9304,475867,36161,0.4574,44299,46297,48143,19689,24999,17441,48602,31448,18470,22318,42,029
"Clarion County, Pennsylvania",38939,18983,19956,37669,462,52,239,13,124,380,28,352,38638,301,0.4326,22451,22698,22752,11344,9367,20769,34694,,7913,11256,42,031
"Clearfield County, Pennsylvania",81170,42256,38914,77296,2026,138,429,0,282,999,261,738,78861,2309,0.4187,21650,22275,22468,10237,5860,10728,33424,-666666666,2221,7264,42,033
"Clinton County, Pennsylvania",39536,19383,20153,38030,645,54,241,15,105,446,30,416,38999,537,0.4117,22084,22484,22570,13174,4231,15822,32424,,23565,8935,42,035
"Columbia County, Pennsylvania",66772,32139,34633,63555,1231,107,773,22,444,640,123,517,65087,1685,0.4554,24155,24605,24764,17130,11733,16583,21316,7950,20693,11022,42,037
"Crawford County, Pennsylvania",87027,42542,44485,83395,1646,39,414,17,174,1342,187,1155,86010,1017,0.4281,23578,24122,24226,9012,12244,15710,15138,,7889,8771,42,039
"Cumberland County, Pennsylvania",243838,120485,123353,217203,8668,183,9019,13,2990,5762,872,4890,235556,8282,0.4256,33079,34374,34695,15065,18786,25261,35697,,14631,11490,42,041
"Dauphin County, Pennsylvania",271962,131707,140255,195198,49840,634,10281,63,7263,8683,1121,7562,249547,22415,0.4448,30068,34307,35277,15079,19285,18081,25544,14571,14775,15806,42,043
"Delaware County, Pennsylvania",562316,270171,292145,395791,118089,832,29581,104,5839,12080,1320,10760,542788,19528,0.4778,34857,40423,40888,18198,20251,14337,31376,4708,14036,15566,42,045
"Elk County, Pennsylvania",31111,15541,15570,30499,155,69,141,0,83,164,0,164,30888,223,0.3999,25753,25944,25999,16335,16828,26710,18826,-666666666,16547,8818,42,047
"Erie County, Pennsylvania",279133,137741,141392,243823,19863,772,4307,102,2421,7845,846,6999,268289,10844,0.4573,25555,27440,27876,10694,13613,15384,15305,24725,13946,7414,42,049
"Fayette County, Pennsylvania",134229,66241,67988,124542,5450,80,230,322,371,3234,117,3117,132844,1385,0.4575,22863,23673,23714,11918,13077,34360,17366,10365,9640,11023,42,051
"Forest County, Pennsylvania",7493,5881,1612,4653,2371,34,43,0,235,157,43,114,6928,565,0.3857,13283,18041,18722,3157,5557,2541,14842,-666666666,4514,3968,42,053
"Franklin County, Pennsylvania",152707,75038,77669,142099,5867,307,1581,47,876,1930,319,1611,144983,7724,0.4095,27706,28362,28891,15877,19010,9970,32537,,16640,9955,42,055
"Fulton County, Pennsylvania",14653,7386,7267,14233,226,33,32,14,1,114,11,103,14495,158,0.3950,24327,24715,24848,5716,9008,21685,25528,,,8709,42,057
"Greene County, Pennsylvania",37669,19556,18113,35066,1650,21,108,3,134,687,154,533,37133,536,0.4348,24389,25557,25598,8852,5560,2962,24193,,15035,12593,42,059
"Huntingdon County, Pennsylvania",45844,24289,21555,42153,2501,22,226,8,191,743,142,601,44991,853,0.4051,22217,22793,22956,30971,12885,23541,10431,,5976,28887,42,061
"Indiana County, Pennsylvania",87491,43929,43562,82716,2136,182,999,35,279,1144,104,1040,86385,1106,0.4574,23886,24163,24208,12530,7695,26498,55776,1123,13128,9157,42,063
"Jefferson County, Pennsylvania",44575,22136,22439,43697,284,104,109,23,48,310,33,277,44212,363,0.4153,22841,23043,23097,14820,7212,13297,28555,,13910,12696,42,065
"Juniata County, Pennsylvania",24811,12361,12450,23993,234,9,117,0,295,163,29,134,24045,766,0.4050,23461,23797,24069,11285,12797,,18885,-666666666,15063,8981,42,067
"Lackawanna County, Pennsylvania",213006,102979,110027,197017,6337,215,4889,22,1173,3353,246,3107,199544,13462,0.4585,26179,27112,28035,11736,13343,21069,16324,19200,20732,12307,42,069
"Lancaster County, Pennsylvania",533110,260976,272134,472127,22015,918,10986,24,15877,11163,2036,9127,481027,52083,0.4233,28152,29700,30577,14129,16938,26274,24350,,11881,11777,42,071
"Lawrence County, Pennsylvania",88528,42843,45685,82545,3366,47,407,0,454,1709,51,1658,87425,1103,0.4589,25614,26530,26679,14135,15250,12087,20316,-666666666,6413,8536,42,073
"Lebanon County, Pennsylvania",136950,66914,70036,120440,2828,118,1658,42,8908,2956,1011,1945,120943,16007,0.4030,27051,28628,29171,14261,19666,22814,24151,,13356,13282,42,075
"Lehigh County, Pennsylvania",358792,174829,183963,282360,24174,701,11680,134,29356,10387,2237,8150,280474,78318,0.4495,29587,32566,35567,13955,17009,22677,37957,,14216,12706,42,077
"Luzerne County, Pennsylvania",318917,157130,161787,285749,12798,882,3480,77,10254,5677,1209,4468,289120,29797,0.4543,25899,27385,28229,11730,9769,10822,34934,,12557,8651,42,079
"Lycoming County, Pennsylvania",116313,57104,59209,106874,5645,185,782,9,686,2132,138,1994,114238,2075,0.4243,24855,25915,26016,13368,12937,12604,28336,,7854,8558,42,081
"McKean County, Pennsylvania",42609,22024,20585,40254,1102,90,210,19,249,685,120,565,41722,887,0.4493,24303,24984,24610,38353,7180,8376,21960,,23938,14946,42,083
"Mercer County, Pennsylvania",114598,56473,58125,104771,6558,80,766,3,368,2052,87,1965,113084,1514,0.4348,24399,25382,25450,16739,14093,32068,21633,,22243,8282,42,085
"Mifflin County, Pennsylvania",46585,22871,23714,45239,301,25,235,34,181,570,52,518,45952,633,0.4074,21665,21977,22028,10919,14277,10720,20949,33809,4821,6172,42,087
"Monroe County, Pennsylvania",167126,82532,84594,129349,23320,539,3563,84,5077,5194,1047,4147,142652,24474,0.4076,26128,27218,27955,20003,24834,27477,24881,,16367,15367,42,089
"Montgomery County, Pennsylvania",815876,396386,419490,655493,72312,895,58140,213,9691,19132,1816,17316,777276,38600,0.4655,42995,45981,46854,23488,28877,24925,39322,28260,18254,18752,42,091
"Montour County, Pennsylvania",18404,8836,9568,17358,334,6,573,0,9,124,9,115,17963,441,0.4666,31293,30912,31320,10101,8201,,57235,-666666666,,26674,42,093
"Northampton County, Pennsylvania",300520,147510,153010,259549,15282,1132,8132,53,6790,9582,1668,7914,264226,36294,0.4307,31086,32394,33700,18243,24784,18867,33169,48313,17966,14573,42,095
"Northumberland County, Pennsylvania",93590,47287,46303,89072,2668,257,332,73,331,857,133,724,90738,2852,0.4286,23512,24133,24419,9909,6661,19540,48557,,11247,9528,42,097
"Perry County, Pennsylvania",45647,22995,22652,44455,408,66,153,0,74,491,15,476,44878,769,0.3811,27648,27926,28130,15561,12771,23221,30663,-666666666,24774,14938,42,099
"Philadelphia County, Pennsylvania",1559938,737899,822039,643570,668573,5734,107669,1663,89089,43640,7372,36268,1345168,214770,0.5116,23696,32867,35752,13632,17594,13528,20519,12810,12199,14970,42,101
"Pike County, Pennsylvania",56210,28092,28118,50416,3259,102,793,35,484,1121,349,772,50553,5657,0.4115,29695,30295,30606,26677,23527,25189,32994,27874,30557,18367,42,103
"Potter County, Pennsylvania",17239,8694,8545,16807,93,28,62,0,65,184,7,177,17032,207,0.4350,22929,23046,23080,20365,15182,25700,17453,-666666666,42783,10625,42,105
"Schuylkill County, Pennsylvania",145503,74295,71208,136781,4038,226,752,38,1662,2006,219,1787,140284,5219,0.4194,24275,25061,25289,13335,8443,6701,26471,,10372,15400,42,107
"Snyder County, Pennsylvania",40246,19942,20304,38891,394,36,300,0,234,391,27,364,39382,864,0.4278,24708,24976,25177,9829,14751,,36270,-666666666,7792,7124,42,109
"Somerset County, Pennsylvania",76201,39529,36672,72755,2074,74,245,15,308,730,88,642,75180,1021,0.4252,23402,24000,24107,7273,6144,12719,24593,,3232,21775,42,111
"Sullivan County, Pennsylvania",6302,3303,2999,5951,156,24,21,31,36,83,12,71,6193,109,0.4139,26154,27186,27226,18553,4058,27575,15071,,11881,8982,42,113
"Susquehanna County, Pennsylvania",41832,21060,20772,40887,235,60,150,15,150,335,3,332,41119,713,0.4262,26551,26820,26977,13492,19062,15807,21440,,12349,10714,42,115
"Tioga County, Pennsylvania",42031,20843,21188,40821,222,62,231,16,118,561,49,512,41508,523,0.4248,24626,24882,24978,12897,19217,18310,24942,,8277,12710,42,117
"Union County, Pennsylvania",45178,24910,20268,39673,3132,188,692,14,627,852,166,686,42606,2572,0.4463,23316,25580,26083,10554,6268,255,10570,,7629,7912,42,119
"Venango County, Pennsylvania",53460,26309,27151,51796,445,29,183,0,69,938,40,898,52893,567,0.4303,24257,24525,24637,9156,11445,7072,21785,-666666666,17296,17065,42,121
"Warren County, Pennsylvania",40649,20363,20286,39766,204,34,217,0,31,397,11,386,40243,406,0.4337,25414,25406,25080,56469,12584,25374,62425,-666666666,5242,14140,42,123
"Washington County, Pennsylvania",208269,101979,106290,195449,5987,184,1926,23,557,4143,141,4002,205136,3133,0.4503,31561,32336,32464,20495,18931,15342,33516,,17974,14898,42,125
"Wayne County, Pennsylvania",51307,27266,24041,48155,1823,109,313,8,259,640,137,503,49227,2080,0.4149,24962,25939,26019,19305,8081,5503,27640,,9681,7793,42,127
"Westmoreland County, Pennsylvania",359377,175500,183877,341205,8673,324,3243,40,732,5160,508,4652,355552,3825,0.4421,30153,30652,30720,19245,16759,34051,44013,25198,16195,12765,42,129
"Wyoming County, Pennsylvania",27975,14051,13924,27239,249,17,115,0,67,288,0,288,27477,498,0.4197,26823,27052,27305,15349,8681,24518,41390,-666666666,42721,11534,42,131
"York County, Pennsylvania",440604,217812,222792,391989,25613,446,6090,97,6263,10106,936,9170,411305,29299,0.4138,28975,30275,31082,13233,19538,31602,28809,12077,14996,11274,42,133
"Bristol County, Rhode Island",49228,23746,25482,46778,691,29,915,11,147,657,42,615,47976,1252,0.4841,40998,41765,42177,19539,22636,,41426,12764,6171,15102,44,001
"Kent County, Rhode Island",164886,79561,85325,152635,2354,217,3952,44,2141,3543,268,3275,158144,6742,0.4404,35323,36009,36393,22222,32279,40275,33128,,25760,15620,44,003
"Newport County, Rhode Island",82714,40616,42098,74140,2726,175,1586,52,1278,2757,190,2567,78306,4408,0.4724,42086,44209,44935,21456,25845,7931,35877,,13165,20150,44,005
"Providence County, Rhode Island",631344,306301,325043,462744,61173,3653,25796,370,56495,21113,5769,15344,499023,132321,0.4819,27809,31553,34147,14242,18378,15275,24835,25346,14352,14929,44,007
"Washington County, Rhode Island",126319,61073,65246,117729,1942,1056,2349,98,1157,1988,344,1644,122667,3652,0.4401,37692,38848,39025,24420,21144,21310,31114,27064,21418,11860,44,009
"Abbeville County, South Carolina",24951,12212,12739,17440,6777,38,77,0,74,545,9,536,24625,326,0.4344,18460,20852,20729,23010,13687,,15356,-666666666,3865,4123,45,001
"Aiken County, South Carolina",165146,79827,85319,115969,40545,407,1421,80,2808,3916,357,3559,156221,8925,0.4549,25602,28941,29622,13580,17742,43463,30941,14264,11518,14666,45,003
"Allendale County, South Carolina",9589,5114,4475,2345,7090,23,0,0,100,31,6,25,9300,289,0.4738,12649,18808,19913,8143,10511,,-666666666,-666666666,12221,,45,005
"Anderson County, South Carolina",192709,92748,99961,153978,31418,407,1793,76,1671,3366,253,3113,186159,6550,0.4504,23341,25122,25174,19218,16799,17307,23295,34054,13138,8493,45,007
"Bamberg County, South Carolina",15057,7262,7795,5402,9419,8,55,0,113,60,8,52,14890,167,0.4772,18260,27451,27681,22993,12899,,23638,-666666666,30669,5073,45,009
"Barnwell County, South Carolina",21917,10438,11479,11295,9888,58,61,9,347,259,0,259,21427,490,0.4863,19652,25430,25468,13447,13299,20010,10934,,12020,19816,45,011
"Beaufort County, South Carolina",175316,86370,88946,129693,32247,420,2102,64,6620,4170,610,3560,155541,19775,0.4711,33877,39336,41765,14711,18522,21127,42647,20784,13855,11693,45,013
"Berkeley County, South Carolina",199081,99053,100028,133912,48433,914,4781,211,4972,5858,321,5537,186955,12126,0.4244,25992,29488,29972,17583,19356,18910,23320,23552,14897,13735,45,015
"Calhoun County, South Carolina",14886,7125,7761,8109,6239,61,0,0,360,117,15,102,14365,521,0.4651,22964,27647,27897,12850,17593,29330,-666666666,-666666666,12436,13949,45,017
"Charleston County, South Carolina",380673,184332,196341,256797,107455,610,5103,133,3232,7343,391,6952,361601,19072,0.5030,33700,41390,42757,17956,17047,30196,32179,22793,14300,18571,45,019
"Cherokee County, South Carolina",56274,27395,28879,42546,11265,106,368,24,838,1127,78,1049,54005,2269,0.4969,19940,21919,22380,9484,14927,10641,6869,,12261,6470,45,021
"Chester County, South Carolina",32435,15904,16531,19524,12181,113,39,0,39,539,29,510,31847,588,0.4880,19858,22849,22990,14926,15133,21831,201682,-666666666,,5723,45,023
"Chesterfield County, South Carolina",46083,22552,23531,29214,14868,283,227,33,596,862,51,811,44198,1885,0.4639,19088,21529,22000,11303,15081,21478,17869,,11999,9918,45,025
"Clarendon County, South Carolina",34056,16746,17310,16600,16595,55,56,0,333,417,26,391,33055,1001,0.4802,18765,25189,25796,9225,12700,21631,2604,-666666666,10965,12403,45,027
"Colleton County, South Carolina",37884,18195,19689,21536,14457,296,15,423,746,411,75,336,36761,1123,0.4725,20297,25595,25717,8920,14097,15581,23907,,6276,7569,45,029
"Darlington County, South Carolina",67689,31953,35736,38291,27570,199,370,11,256,992,48,944,66442,1247,0.4786,20144,25150,25432,12136,13561,31034,35376,,8278,5298,45,031
"Dillon County, South Carolina",31273,14592,16681,14845,14622,790,112,6,56,842,0,842,30442,831,0.4720,15729,19781,19661,11436,12288,12053,32218,,4963,5992,45,033
"Dorchester County, South Carolina",148517,72395,76122,101145,37607,780,2808,35,1754,4388,236,4152,141265,7252,0.4263,26288,29547,29996,17293,20411,17651,24448,,12069,9995,45,035
"Edgefield County, South Carolina",26388,14310,12078,15558,9698,112,101,0,565,354,156,198,24890,1498,0.4450,22695,27472,28175,13656,16150,6520,21260,-666666666,13927,11604,45,037
"Fairfield County, South Carolina",23025,11004,12021,8994,13042,30,45,0,90,824,83,741,22578,447,0.5109,20762,27832,28312,14655,16548,,37736,-666666666,23878,9360,45,039
"Florence County, South Carolina",138575,64672,73903,75560,58442,322,1714,46,440,2051,28,2023,135233,3342,0.4762,23420,29009,29412,15773,15968,18548,51670,,13073,9678,45,041
"Georgetown County, South Carolina",60804,28933,31871,38894,19388,86,137,15,1133,1151,275,876,58955,1849,0.4881,26601,33697,33852,14243,14174,15060,19709,,13163,11047,45,043
"Greenville County, South Carolina",482191,234053,248138,366249,88307,1311,10315,286,6830,8893,1123,7770,440281,41910,0.4715,28065,31000,32518,14660,18553,25829,29896,11436,13232,11782,45,045
"Greenwood County, South Carolina",69881,32511,37370,44642,21822,17,607,0,1330,1463,95,1368,65840,4041,0.4828,21887,26292,27335,8960,14418,10900,18561,-666666666,10838,10449,45,047
"Hampton County, South Carolina",20296,10447,9849,8618,11226,51,79,13,147,162,46,116,19857,439,0.4587,20291,29614,26350,82106,13352,29702,17866,,17271,6127,45,049
"Horry County, South Carolina",300418,145624,154794,243113,41298,1393,3442,206,5909,5057,653,4404,282490,17928,0.4446,24986,27276,27887,12720,15154,15701,23667,11239,10896,15664,45,051
"Jasper County, South Carolina",27186,14081,13105,13803,11986,0,198,0,927,272,0,272,23534,3652,0.4266,18921,23416,26404,11017,14481,-666666666,25960,-666666666,11219,7626,45,053
"Kershaw County, South Carolina",63090,30547,32543,45206,15435,142,303,0,534,1470,249,1221,60498,2592,0.4393,23149,26145,26404,17203,16232,15770,7684,-666666666,18166,9357,45,055
"Lancaster County, South Carolina",83704,40886,42818,61365,18755,346,732,54,1302,1150,196,954,79572,4132,0.4562,24528,28160,28569,15704,14745,10087,22597,,10653,5227,45,057
"Laurens County, South Carolina",66442,32155,34287,46727,16610,120,224,45,1249,1467,127,1340,63571,2871,0.4424,20417,22208,22565,9604,17128,11604,10160,9518,10154,11943,45,059
"Lee County, South Carolina",18189,9437,8752,5981,11693,30,8,0,107,370,55,315,17774,415,0.4669,15545,23655,23737,7356,11794,8800,,-666666666,,6404,45,061
"Lexington County, South Carolina",277702,135372,142330,221685,40185,751,4454,173,4103,6351,607,5744,262038,15664,0.4340,28141,30541,31226,16276,19189,26571,25268,15251,12884,13421,45,063
"McCormick County, South Carolina",9806,5450,4356,4907,4697,14,32,0,17,139,5,134,9689,117,0.4560,22454,32717,32576,36789,12390,7050,21175,-666666666,,,45,065
"Marion County, South Carolina",31975,14687,17288,12960,18110,158,222,0,255,270,49,221,31130,845,0.4971,18373,25539,26200,9414,13558,11989,17791,-666666666,13463,6173,45,067
"Marlboro County, South Carolina",27702,14716,12986,11361,14036,1091,85,0,339,790,82,708,26782,920,0.4613,15849,19809,20484,6647,13478,11396,28191,-666666666,9741,8482,45,069
"Newberry County, South Carolina",37750,18336,19414,23609,11579,121,83,12,1645,701,188,513,35010,2740,0.4472,21883,26249,27063,10669,14781,28968,18734,,13599,10288,45,071
"Oconee County, South Carolina",75375,37104,38271,66486,5549,141,501,0,1139,1559,239,1320,71675,3700,0.4875,25944,27361,27862,12047,16629,29294,28113,-666666666,10927,8633,45,073
"Orangeburg County, South Carolina",89731,42228,47503,30746,55545,322,881,14,797,1426,162,1264,87921,1810,0.4790,18490,25498,25918,7352,14908,13226,25770,,12310,7229,45,075
"Pickens County, South Carolina",120722,60065,60657,107077,7866,419,2143,134,1171,1912,304,1608,116598,4124,0.4480,22258,23202,23324,16947,16216,11829,16564,,14339,8912,45,077
"Richland County, South Carolina",401743,194943,206800,186244,186054,504,10570,439,6583,11349,1611,9738,381774,19969,0.4617,26852,35048,35874,18894,20010,23770,22469,7270,18902,14086,45,079
"Saluda County, South Carolina",20113,10112,10001,12779,5158,56,0,0,1814,306,23,283,17119,2994,0.4546,21468,26606,27303,13278,13758,,-666666666,-666666666,10184,6994,45,081
"Spartanburg County, South Carolina",294229,142694,151535,215472,60808,451,6595,116,5444,5343,723,4620,275613,18616,0.4488,23277,25837,26495,14551,16443,20552,20761,23095,14823,9757,45,083
"Sumter County, South Carolina",107682,51876,55806,52297,50317,231,1317,5,723,2792,276,2516,103703,3979,0.4448,20916,26098,26654,16505,16252,18517,17203,,17015,10909,45,085
"Union County, South Carolina",27928,13442,14486,18509,8614,35,0,0,57,713,19,694,27579,349,0.4538,19614,22726,22784,13075,14041,,-666666666,-666666666,,7968,45,087
"Williamsburg County, South Carolina",32816,15946,16870,10549,21490,25,152,0,157,443,117,326,32075,741,0.4960,16650,23621,24176,7504,13425,,13547,-666666666,9346,10095,45,089
"York County, South Carolina",245606,118494,127112,184220,45982,1570,4225,121,3427,6061,466,5595,233366,12240,0.4507,28830,32274,33034,16308,19164,16185,27037,26313,14990,9878,45,091
"Aurora County, South Dakota",2732,1437,1295,2512,41,91,6,0,60,22,0,22,2559,173,0.4092,28385,29360,29868,14989,43163,3384,,-666666666,21645,,46,003
"Beadle County, South Dakota",18155,9113,9042,15780,51,256,1501,5,372,190,64,126,16524,1631,0.4127,24532,26599,28133,10957,38871,5642,8073,,21786,10525,46,005
"Bennett County, South Dakota",3445,1576,1869,1082,34,1731,2,0,0,596,0,596,3238,207,0.3893,15011,29194,29483,6634,13821,8542,,-666666666,-666666666,8123,46,007
"Bon Homme County, South Dakota",7001,4064,2937,6242,95,350,88,0,68,158,0,158,6782,219,0.4366,23359,24314,23392,43003,8446,5287,48803,-666666666,15769,23732,46,009
"Brookings County, South Dakota",33435,17181,16254,31025,492,370,938,10,210,390,7,383,32608,827,0.4436,26589,27527,27854,9935,12008,4935,21885,,9876,11714,46,011
"Brown County, South Dakota",38430,18716,19714,35148,598,1221,875,10,37,541,30,511,37501,929,0.4335,29463,30308,30758,12884,26085,13467,21521,,6927,29066,46,013
"Brule County, South Dakota",5312,2637,2675,4610,0,535,0,0,6,161,0,161,5188,124,0.4385,24496,26475,25741,44594,-666666666,13193,-666666666,-666666666,,5457,46,015
"Buffalo County, South Dakota",2052,986,1066,293,8,1653,0,36,0,62,0,62,2019,33,0.4465,10763,21553,21553,9791,,9276,-666666666,,-666666666,3477,46,017
"Butte County, South Dakota",10268,5076,5192,9712,70,194,0,0,41,251,35,216,9915,353,0.4821,26067,26849,27277,12969,,10832,-666666666,-666666666,14427,15683,46,019
"Campbell County, South Dakota",1553,735,818,1473,0,61,3,0,0,16,0,16,1550,3,0.5405,32814,34311,34296,,-666666666,5105,,-666666666,-666666666,,46,021
"Charles Mix County, South Dakota",9277,4628,4649,5921,5,2972,19,11,44,305,0,305,9011,266,0.4683,21323,28569,28684,10345,19940,8277,19789,,23052,7494,46,023
"Clark County, South Dakota",3639,1866,1773,3454,54,78,20,0,18,15,0,15,3577,62,0.4346,26291,27219,27262,17624,3193,11437,,-666666666,,9460,46,025
"Clay County, South Dakota",14029,7001,7028,12676,214,421,282,0,54,382,19,363,13662,367,0.5220,23046,24201,24008,25517,15534,10575,17406,-666666666,10615,8620,46,027
"Codington County, South Dakota",27886,14048,13838,26378,78,592,193,10,88,547,11,536,27310,576,0.4218,27294,28186,28294,17916,13776,11403,8902,,10623,13100,46,029
"Corson County, South Dakota",4170,2120,2050,1248,16,2823,11,0,15,57,0,57,4142,28,0.5072,13830,28922,28922,3039,15625,7245,,-666666666,,11426,46,031
"Custer County, South Dakota",8447,4241,4206,7863,17,354,36,0,34,143,0,143,8194,253,0.4385,31275,32502,32933,18073,,16010,13692,-666666666,,15088,46,033
"Davison County, South Dakota",19824,9974,9850,18494,126,684,0,0,233,287,0,287,19351,473,0.4231,26416,27384,27574,21051,13391,7574,-666666666,-666666666,32311,9866,46,035
"Day County, South Dakota",5588,2883,2705,4921,0,558,26,0,6,77,0,77,5469,119,0.5345,28811,31034,31349,13869,-666666666,13462,,-666666666,,8157,46,037
"Deuel County, South Dakota",4309,2230,2079,4295,0,1,0,0,0,13,0,13,4279,30,0.4125,29953,29990,30020,25760,-666666666,,-666666666,-666666666,-666666666,19162,46,039
"Dewey County, South Dakota",5652,2784,2868,1178,8,4331,0,0,0,135,0,135,5595,57,0.4624,16305,33279,33279,,51600,11577,-666666666,-666666666,-666666666,17800,46,041
"Douglas County, South Dakota",2961,1458,1503,2817,0,96,1,0,2,45,16,29,2937,24,0.4262,27397,27800,27769,26571,-666666666,18919,,-666666666,,22007,46,043
"Edmunds County, South Dakota",4000,2001,1999,3858,5,87,14,0,11,25,3,22,3957,43,0.4355,30123,30864,31019,11028,,7339,,-666666666,15600,,46,045
"Fall River County, South Dakota",6874,3499,3375,5977,66,492,113,0,107,119,0,119,6620,254,0.4204,25591,26780,26878,17691,,14975,31835,-666666666,17856,17371,46,047
"Faulk County, South Dakota",2354,1182,1172,2216,1,128,4,0,0,5,0,5,2303,51,0.4655,28975,30008,30028,16306,,12435,,-666666666,-666666666,,46,049
"Grant County, South Dakota",7195,3707,3488,6999,29,141,1,0,9,16,0,16,6976,219,0.4132,28059,28493,28448,29684,,15533,,-666666666,28711,,46,051
"Gregory County, South Dakota",4217,2158,2059,3748,6,295,17,0,27,124,7,117,4158,59,0.4568,24738,26426,26496,11458,,10468,,-666666666,,11502,46,053
"Haakon County, South Dakota",2073,1009,1064,1864,0,154,0,0,0,55,0,55,2050,23,0.4413,22643,24150,23983,,-666666666,3224,-666666666,-666666666,-666666666,25953,46,055
"Hamlin County, South Dakota",5995,3034,2961,5800,12,38,27,0,74,44,8,36,5784,211,0.3619,26140,26114,26362,17821,,38355,15167,-666666666,25649,16998,46,057
"Hand County, South Dakota",3311,1680,1631,3275,1,0,10,0,0,25,0,25,3298,13,0.4633,33496,33264,33233,,,-666666666,,-666666666,-666666666,57512,46,059
"Hanson County, South Dakota",3390,1724,1666,3182,127,60,0,12,0,9,0,9,3370,20,0.3990,24159,25114,25140,,7067,7333,-666666666,,-666666666,43122,46,061
"Harding County, South Dakota",1277,655,622,1222,8,23,7,0,8,9,0,9,1260,17,0.4272,27239,27862,27999,,,,,-666666666,,,46,063
"Hughes County, South Dakota",17518,8548,8970,14623,84,1993,70,0,141,607,97,510,17001,517,0.4096,30863,34876,35115,14885,,11261,,-666666666,15195,7949,46,065
"Hutchinson County, South Dakota",7264,3641,3623,7013,29,179,7,0,5,31,2,29,7133,131,0.4890,28594,29350,29303,24428,,4002,,-666666666,,11810,46,067
"Hyde County, South Dakota",1440,705,735,1230,0,133,0,0,6,71,0,71,1425,15,0.3947,28343,30153,30375,,-666666666,18047,-666666666,-666666666,,18682,46,069
"Jackson County, South Dakota",3268,1676,1592,1435,7,1660,15,0,46,105,0,105,3214,54,0.4519,17601,25435,25506,19665,,8916,,-666666666,,47597,46,071
"Jerauld County, South Dakota",2029,975,1054,2005,0,4,0,0,3,17,0,17,1978,51,0.5274,36494,36737,37470,8229,-666666666,,-666666666,-666666666,,,46,073
"Jones County, South Dakota",767,418,349,734,16,17,0,0,0,0,0,0,763,4,0.4117,25229,26042,25874,,,,-666666666,-666666666,-666666666,-666666666,46,075
"Kingsbury County, South Dakota",5070,2561,2509,4881,0,11,68,0,43,67,0,67,4957,113,0.4458,31524,31350,31644,11642,-666666666,,74087,-666666666,18228,7510,46,077
"Lake County, South Dakota",12331,6355,5976,11826,66,20,234,0,14,171,0,171,12044,287,0.4658,29526,30513,31096,6149,3806,3485,6877,-666666666,,7396,46,079
"Lawrence County, South Dakota",24859,12353,12506,23165,259,694,255,11,130,345,20,325,24083,776,0.4189,27002,27965,27886,26073,6038,14465,15405,,26748,12051,46,081
"Lincoln County, South Dakota",51396,25464,25932,48805,445,271,541,15,336,983,52,931,50486,910,0.4273,36896,37441,37579,21962,22909,14875,64632,,17312,14091,46,083
"Lyman County, South Dakota",3855,2028,1827,2187,2,1537,35,0,0,94,0,94,3779,76,0.4015,20695,28826,28892,4332,,9850,,-666666666,-666666666,14989,46,085
"McCook County, South Dakota",5616,2793,2823,5396,37,65,0,0,68,50,1,49,5450,166,0.4115,28424,28552,28816,9751,8203,62311,-666666666,-666666666,11276,8796,46,087
"McPherson County, South Dakota",2252,1164,1088,2056,5,159,17,0,0,15,3,12,2152,100,0.4554,25302,26730,26711,26306,,6845,37159,-666666666,-666666666,,46,089
"Marshall County, South Dakota",4743,2477,2266,4067,27,488,1,0,95,65,5,60,4535,208,0.4201,27441,29814,30087,22087,,11576,,-666666666,24867,13385,46,091
"Meade County, South Dakota",26840,13990,12850,24176,486,710,312,22,318,816,39,777,25746,1094,0.3971,25884,26926,27193,14846,25143,15856,10996,,18432,13419,46,093
"Mellette County, South Dakota",2083,1039,1044,820,0,1219,0,0,0,44,0,44,1972,111,0.4769,13934,24445,24445,4804,-666666666,6966,-666666666,-666666666,-666666666,11105,46,095
"Miner County, South Dakota",2299,1180,1119,2221,31,3,0,0,10,34,0,34,2248,51,0.4659,28242,28763,29102,16982,17245,,-666666666,-666666666,,,46,097
"Minnehaha County, South Dakota",182014,91348,90666,156867,8190,4725,3563,57,3778,4834,618,4216,173502,8512,0.4244,28337,30747,31051,15902,12983,10241,24452,,13059,8829,46,099
"Moody County, South Dakota",6445,3268,3177,5151,58,821,119,0,34,262,3,259,6240,205,0.4380,27324,29683,30102,10629,18793,20053,19187,-666666666,17697,10569,46,101
"Oglala Lakota County, South Dakota",14263,6890,7373,662,34,13270,0,0,15,282,0,282,13769,494,0.5178,9286,26710,24344,12236,,8114,-666666666,-666666666,,16109,46,102
"Pennington County, South Dakota",107298,53929,53369,89293,1385,9292,1187,40,602,5499,264,5235,102162,5136,0.4457,27964,31032,31361,16340,23357,9691,19491,23978,20524,12848,46,103
"Perkins County, South Dakota",3019,1547,1472,2892,2,83,0,0,3,39,4,35,2971,48,0.4874,28576,28730,28998,18535,,30075,-666666666,-666666666,,10836,46,105
"Potter County, South Dakota",2306,1103,1203,2251,0,34,5,0,0,16,0,16,2299,7,0.4626,30294,30749,30818,,-666666666,11262,,-666666666,-666666666,5019,46,107
"Roberts County, South Dakota",10294,5167,5127,6113,59,3775,8,0,1,338,5,333,10036,258,0.4511,24426,33546,32643,38800,10842,11356,,-666666666,,7058,46,109
"Sanborn County, South Dakota",2349,1239,1110,2308,0,21,5,0,3,12,0,12,2290,59,0.4512,31991,32092,32389,20478,-666666666,13205,,-666666666,,,46,111
"Spink County, South Dakota",6539,3270,3269,6318,35,108,0,20,0,58,0,58,6415,124,0.4408,29158,29633,29724,23534,,14370,-666666666,,-666666666,19459,46,115
"Stanley County, South Dakota",2964,1522,1442,2648,0,268,0,0,0,48,15,33,2891,73,0.4469,33470,35825,34487,60370,-666666666,12759,-666666666,-666666666,-666666666,19179,46,117
"Sully County, South Dakota",1456,802,654,1446,0,4,0,0,0,6,0,6,1453,3,0.5003,40042,40195,40155,,-666666666,,-666666666,-666666666,-666666666,,46,119
"Todd County, South Dakota",10019,4890,5129,907,32,7668,169,0,0,1243,24,1219,9612,407,0.4996,11821,28682,27619,7053,40844,9707,12528,-666666666,-666666666,11710,46,121
"Tripp County, South Dakota",5475,2763,2712,4486,0,793,7,0,0,189,0,189,5447,28,0.4638,26270,28936,28936,,-666666666,8855,,-666666666,-666666666,35951,46,123
"Turner County, South Dakota",8289,4169,4120,8076,45,54,2,0,22,90,0,90,8124,165,0.4100,27405,27732,28001,9216,10569,26181,,-666666666,,13852,46,125
"Union County, South Dakota",14842,7464,7378,13995,99,102,181,0,126,339,65,274,14411,431,0.4439,35565,36202,36307,16919,36918,6861,77346,-666666666,11349,4203,46,127
"Walworth County, South Dakota",5538,2717,2821,4460,23,580,177,34,62,202,0,202,5443,95,0.4595,29199,31505,31572,12481,,25003,10144,,11826,18591,46,129
"Yankton County, South Dakota",22649,11888,10761,20971,459,546,154,20,93,406,46,360,21858,791,0.4781,28067,29187,29728,10723,16043,9423,41253,,9530,8346,46,135
"Ziebach County, South Dakota",2818,1388,1430,663,1,2090,25,0,2,37,0,37,2795,23,0.4420,14047,27191,27116,9913,,10035,,-666666666,,13532,46,137
"Anderson County, Tennessee",75545,36834,38711,69363,2756,183,1025,36,407,1775,74,1701,73637,1908,0.4719,26072,26608,26813,18058,19029,50854,30813,,21605,12334,47,001
"Bedford County, Tennessee",46331,22685,23646,38835,3661,290,156,0,2084,1305,92,1213,41016,5315,0.4496,21949,23380,24195,11021,17514,7137,42498,-666666666,12955,6996,47,003
"Benton County, Tennessee",16173,7958,8215,15401,466,53,109,0,10,134,9,125,15818,355,0.4654,20504,20756,20766,19835,19810,14049,,-666666666,,13586,47,005
"Bledsoe County, Tennessee",14073,7910,6163,12904,462,121,12,0,40,534,1,533,13778,295,0.4739,18962,19933,20223,4500,13687,6247,,-666666666,,3992,47,007
"Blount County, Tennessee",126192,61268,64924,118761,3581,395,1018,21,318,2098,82,2016,122372,3820,0.4608,26772,27458,27811,14415,14774,19101,17833,,15183,16025,47,009
"Bradley County, Tennessee",102860,49964,52896,94452,4947,176,1009,7,613,1656,206,1450,97131,5729,0.4788,24099,24804,25681,10282,16294,45882,22589,,14020,9670,47,011
"Campbell County, Tennessee",40008,19467,20541,39145,230,106,84,0,24,419,12,407,39524,484,0.4967,19948,20027,20128,12721,23710,9251,10710,-666666666,46313,13598,47,013
"Cannon County, Tennessee",13855,6856,6999,13195,195,58,102,0,116,189,0,189,13593,262,0.4547,22571,22956,23051,10846,15294,7157,7911,-666666666,15138,20428,47,015
"Carroll County, Tennessee",28417,13815,14602,24663,2970,103,93,10,65,513,51,462,27746,671,0.4579,19851,20878,21019,12437,14537,11065,18775,,12885,4392,47,017
"Carter County, Tennessee",56707,27824,28883,54806,707,182,202,0,52,758,64,694,55773,934,0.4719,20118,20292,20385,12707,15272,32205,16711,-666666666,7581,10910,47,019
"Cheatham County, Tennessee",39575,19558,20017,37570,549,58,219,89,476,614,0,614,38530,1045,0.3928,24279,24653,24724,16721,19728,16733,27948,,11247,16977,47,021
"Chester County, Tennessee",17355,8373,8982,15027,1573,7,205,0,350,193,4,189,16951,404,0.4268,19987,20667,20724,7566,14642,,18460,-666666666,8174,34304,47,023
"Claiborne County, Tennessee",31701,15470,16231,30556,335,54,162,43,19,532,100,432,31348,353,0.4719,19215,19550,19514,19292,4408,5096,7950,,,16273,47,025
"Clay County, Tennessee",7769,3823,3946,7518,111,61,34,0,18,27,7,20,7600,169,0.4438,16470,16592,16696,11008,10225,17926,7215,-666666666,,,47,027
"Cocke County, Tennessee",35256,17222,18034,33550,587,191,0,8,71,849,35,814,34521,735,0.4754,18959,19327,19261,19356,14387,15209,-666666666,,6752,9518,47,029
"Coffee County, Tennessee",53808,26166,27642,48936,1163,249,560,9,954,1937,132,1805,51650,2158,0.4407,23404,23880,23909,14624,20492,13595,59994,,10127,10413,47,031
"Crockett County, Tennessee",14558,6912,7646,11694,1884,25,27,0,584,344,16,328,13111,1447,0.4460,20542,22328,23257,8633,16189,12448,20274,-666666666,8443,4810,47,033
"Cumberland County, Tennessee",57895,28237,29658,56145,316,263,190,0,151,830,161,669,56315,1580,0.4282,22606,22734,22875,15337,22427,22283,34458,-666666666,8901,13862,47,035
"Davidson County, Tennessee",667885,322044,345841,420689,184318,1957,22901,403,21955,15662,2071,13591,601424,66461,0.4847,30595,36518,38936,14111,20458,30574,29486,17528,12945,17501,47,037
"Decatur County, Tennessee",11703,5698,6005,11115,325,1,30,5,0,227,37,190,11339,364,0.4818,21977,22531,23008,8434,13672,,9387,,-666666666,7689,47,039
"DeKalb County, Tennessee",19159,9493,9666,18108,255,55,108,22,340,271,0,271,17789,1370,0.5403,25273,24292,24961,9628,23786,,45419,,3970,117352,47,041
"Dickson County, Tennessee",50926,24989,25937,47130,2049,213,262,0,257,1015,63,952,49325,1601,0.4447,23426,24015,24308,12968,19150,13634,29809,-666666666,13942,7507,47,043
"Dyer County, Tennessee",37970,18329,19641,31305,5130,131,230,50,253,871,145,726,36787,1183,0.4837,23936,25771,26055,13465,15816,11722,29955,40900,12704,8307,47,045
"Fayette County, Tennessee",39071,19264,19807,27171,10805,65,257,1,435,337,3,334,38122,949,0.4659,29018,34503,34807,16320,16530,17154,16074,,15228,17262,47,047
"Fentress County, Tennessee",17936,8806,9130,17561,23,50,74,0,57,171,0,171,17695,241,0.4570,17487,17555,17684,8176,,12590,42189,-666666666,,3371,47,049
"Franklin County, Tennessee",41348,20171,21177,37283,1447,195,298,22,616,1487,149,1338,40131,1217,0.4563,23797,24871,25025,14564,18210,24807,5423,,17818,8435,47,051
"Prince William County, Virginia",443630,220996,222634,268015,91551,1529,35253,574,22871,23837,2834,21003,346513,97117,0.3766,37063,41262,47453,21644,35965,25263,30449,25195,19314,21927,51,153
"Pulaski County, Virginia",34417,17147,17270,31666,1820,13,118,0,173,627,52,575,33892,525,0.4265,25738,26125,26241,14805,23459,,33033,-666666666,6159,17240,51,155
"Rappahannock County, Virginia",7416,3643,3773,6836,311,14,48,0,19,188,35,153,7159,257,0.4543,34886,36410,36847,18200,20105,,15810,-666666666,8800,10953,51,157
"Richmond County, Virginia",8868,4960,3908,5906,2312,25,200,0,72,353,39,314,8307,561,0.4473,19191,21960,22998,8503,14602,,25584,-666666666,1531,1331,51,159
"Roanoke County, Virginia",93655,44946,48709,83351,5398,100,2580,0,379,1847,261,1586,91138,2517,0.4269,32220,33179,33274,26414,26271,29565,28546,-666666666,21972,13688,51,161
"Rockbridge County, Virginia",22450,11150,11300,20977,580,22,138,28,165,540,76,464,22099,351,0.4589,29603,30277,30290,10103,25219,106791,28307,,9402,12773,51,163
"Rockingham County, Virginia",78427,38501,39926,73682,1637,215,551,35,1218,1089,51,1038,73563,4864,0.4266,27160,27958,28708,11423,20439,14111,23617,36369,10548,5891,51,165
"Russell County, Virginia",27973,13693,14280,27209,277,14,33,0,148,292,87,205,27655,318,0.4389,21171,21382,21427,19358,13325,16843,,-666666666,29144,5267,51,167
"Scott County, Virginia",22378,11259,11119,21947,151,36,62,0,22,160,0,160,22094,284,0.4543,20935,21189,21289,12383,3344,,14555,-666666666,,9333,51,169
"Shenandoah County, Virginia",42857,20972,21885,40058,913,16,239,0,630,1001,61,940,39986,2871,0.4197,26444,26326,26718,19531,50041,69256,23075,-666666666,21897,12633,51,171
"Smyth County, Virginia",31513,15623,15890,30207,679,20,94,22,41,450,69,381,30899,614,0.4625,22161,22573,22736,13335,11459,,23253,,23812,9783,51,173
"Southampton County, Virginia",18291,9555,8736,11194,6482,43,24,0,106,442,15,427,18040,251,0.4275,24018,29209,29550,13446,16121,37402,,-666666666,23047,8321,51,175
"Spotsylvania County, Virginia",129181,63429,65752,95246,20763,560,3273,159,5245,3935,533,3402,118045,11136,0.3836,32367,34822,35349,21213,28244,35254,24327,12087,17626,21450,51,177
"Stafford County, Virginia",139548,70245,69303,96726,23914,439,4552,115,7443,6359,936,5423,123934,15614,0.3775,37782,40647,41280,25390,38259,36430,32542,46550,20393,16457,51,179
"Surry County, Virginia",6731,3317,3414,3508,3104,13,29,0,15,62,0,62,6707,24,0.3665,25838,28979,28925,39100,22458,,9983,-666666666,20347,29092,51,181
"Sussex County, Virginia",11733,7715,4018,4514,6660,38,51,5,171,294,6,288,11417,316,0.4433,16653,22235,22322,8805,13626,1534,8824,,11328,4845,51,183
"Tazewell County, Virginia",43367,21489,21878,41090,1318,62,153,17,58,669,8,661,42982,385,0.4939,23548,24111,24134,17034,10210,13463,20305,,5278,17698,51,185
"Warren County, Virginia",38807,19357,19450,35282,1520,63,422,4,208,1308,87,1221,37261,1546,0.4018,29179,29993,30351,19515,28707,12738,19958,,25650,12191,51,187
"Washington County, Virginia",54562,27008,27554,52516,699,46,307,12,305,677,115,562,53790,772,0.4470,25287,25370,25386,16240,14718,26700,48239,,13338,23451,51,191
"Westmoreland County, Virginia",17528,8640,8888,12016,4728,78,64,0,183,459,7,452,16458,1070,0.4357,29824,32525,33744,19224,24854,41368,18498,-666666666,34141,8181,51,193
"Wise County, Virginia",40074,20706,19368,37110,2115,35,179,20,117,498,35,463,39581,493,0.4815,20896,21910,22032,7123,5030,13420,36863,,15428,9644,51,195
"Wythe County, Virginia",29171,14234,14937,27709,987,36,214,0,61,164,0,164,28850,321,0.4653,24431,24768,24835,21186,15376,8656,28803,-666666666,,17257,51,197
"York County, Virginia",66919,32825,34094,51476,8771,159,3522,176,373,2442,136,2306,63116,3803,0.3881,36722,38520,39647,20789,30020,40601,39974,30718,38732,18090,51,199
"Alexandria city, Virginia",151473,73054,78419,95026,32678,240,9804,46,6238,7441,1676,5765,126114,25359,0.4461,55534,68375,76477,27368,30454,47807,53045,,22293,33216,51,510
"Bristol city, Virginia",17340,8084,9256,15480,1160,36,12,0,346,306,0,306,16997,343,0.4690,21865,23430,23704,4020,9772,,,-666666666,6875,7137,51,520
"Buena Vista city, Virginia",6610,2916,3694,5934,110,0,485,0,0,81,0,81,6527,83,0.4431,16405,17570,17613,14553,11061,-666666666,5968,-666666666,-666666666,835,51,530
"Charlottesville city, Virginia",45538,22057,23481,32001,8501,163,3164,66,176,1467,87,1380,43243,2295,0.5127,30729,35950,36912,19738,18963,45291,16564,,16486,16528,51,540
"Chesapeake city, Virginia",233194,113888,119306,145131,69273,455,7515,271,3116,7433,445,6988,220900,12294,0.4048,30764,34637,34979,25169,24964,23110,31322,14624,18031,15010,51,550
"Colonial Heights city, Virginia",17554,8068,9486,13707,2329,106,632,0,413,367,7,360,16623,931,0.4178,27209,29937,30285,20072,16244,26653,16548,-666666666,19738,21802,51,570
"Covington city, Virginia",5650,2903,2747,4610,835,0,36,17,0,152,24,128,5579,71,0.4533,21512,21702,21732,48703,19340,-666666666,,,-666666666,32761,51,580
"Danville city, Virginia",42360,19379,22981,19358,20807,64,453,9,675,994,186,808,40841,1519,0.4929,21742,28412,28614,15997,16577,32820,17749,,15020,5616,51,590
"Emporia city, Virginia",5565,2564,3001,1787,3559,0,13,0,154,52,0,52,5384,181,0.5373,18608,27453,27599,19418,14422,-666666666,,-666666666,19669,,51,595
"Fairfax city, Virginia",23620,11626,11994,16385,1136,99,3641,11,1084,1264,380,884,19682,3938,0.4017,45222,52678,56705,26163,27460,13349,34186,,23554,17725,51,600
"Falls Church city, Virginia",13597,6577,7020,10472,742,0,1243,0,520,620,67,553,12248,1349,0.4689,66104,74491,77877,31057,44268,-666666666,44223,-666666666,45799,11484,51,610
"Franklin city, Virginia",8413,3699,4714,3226,4930,0,33,0,41,183,0,183,8323,90,0.4623,23182,33989,33940,41578,16792,-666666666,,-666666666,46890,3679,51,620
"Fredericksburg city, Virginia",27853,13066,14787,17816,6446,54,629,26,1277,1605,305,1300,24838,3015,0.4751,30480,34604,35565,14537,27351,58889,23199,,11044,14935,51,630
"Galax city, Virginia",6858,3290,3568,6097,470,3,8,0,99,181,58,123,5661,1197,0.5341,20796,20984,22932,10745,26603,,,-666666666,10379,5188,51,640
"Hampton city, Virginia",136789,65983,70806,57799,68872,531,3377,112,1927,4171,164,4007,129553,7236,0.4291,25943,30565,31170,18756,22710,17003,27295,64979,20316,16889,51,650
"Harrisonburg city, Virginia",51979,24857,27122,43920,3542,59,2039,34,697,1688,196,1492,42527,9452,0.4700,18892,19528,21175,13332,15051,,16067,,26158,11343,51,660
"Hopewell city, Virginia",22332,10383,11949,11701,8706,48,274,0,847,756,83,673,20728,1604,0.4464,21827,25571,25438,23524,17538,,19472,-666666666,23384,11195,51,670
"Lexington city, Virginia",7036,3979,3057,5942,642,0,278,0,10,164,39,125,6742,294,0.5190,15745,15936,16345,7052,21567,-666666666,6116,-666666666,,3276,51,678
"Lynchburg city, Virginia",78755,36987,41768,51300,22362,201,2096,29,683,2084,279,1805,76125,2630,0.4897,22016,25587,25990,15684,14455,18841,28135,,21800,9253,51,680
"Manassas city, Virginia",41149,20455,20694,28650,5660,333,2195,103,2528,1680,376,1304,27119,14030,0.3901,29365,31202,40679,15759,29679,19489,28470,45490,16020,19207,51,683
"Manassas Park city, Virginia",15827,8387,7440,10533,2055,21,1574,13,937,694,99,595,10046,5781,0.3662,28851,28085,37024,16762,42952,,26336,,18899,18225,51,685
"Martinsville city, Virginia",13551,6225,7326,6657,6295,35,34,0,305,225,24,201,12913,638,0.5147,22221,29388,30436,11505,15864,,,-666666666,10943,5700,51,690
"Newport News city, Virginia",181606,88071,93535,90072,73309,538,5462,350,3224,8651,852,7799,166377,15229,0.4324,25520,31312,32748,17696,20198,22284,22938,17985,18141,15193,51,700
"Norfolk city, Virginia",245724,128011,117713,117165,103652,1117,8381,214,6068,9127,905,8222,227480,18244,0.4854,25450,33598,34689,19756,17391,28846,26443,25134,17267,16488,51,710
"Norton city, Virginia",3978,1763,2215,3469,237,3,132,0,68,69,0,69,3875,103,0.4851,19522,19935,19924,19868,16270,,24658,-666666666,19268,,51,720
"Petersburg city, Virginia",31997,14709,17288,5420,24578,98,365,9,755,772,182,590,30558,1439,0.4801,20464,27932,29960,14952,18912,9867,34944,,15752,16805,51,730
"Poquoson city, Virginia",12068,5912,6156,11396,129,6,194,0,27,316,11,305,11784,284,0.4069,39020,39384,39894,20789,62247,,33314,-666666666,70170,17626,51,735
"Portsmouth city, Virginia",96071,46306,49765,39135,50626,408,1183,122,1345,3252,313,2939,92343,3728,0.4245,23878,30298,30639,19741,19824,15300,23959,16131,19119,13018,51,740
"Radford city, Virginia",17186,8544,8642,14509,1710,7,302,0,130,528,86,442,16678,508,0.5616,18108,17641,17802,50788,12208,,21709,-666666666,18233,48205,51,750
"Richmond city, Virginia",216773,102936,113837,95796,105384,1004,4606,60,2342,7581,499,7082,203044,13729,0.5428,29011,43337,46292,15969,17459,22628,25320,19107,15257,15981,51,760
"Roanoke city, Virginia",99329,47524,51805,63336,28073,272,2691,174,1259,3524,353,3171,93401,5928,0.4640,23611,27761,28611,13618,16640,14390,17059,42932,17310,11577,51,770
"Salem city, Virginia",25290,11904,13386,22248,1951,20,509,0,111,451,41,410,24443,847,0.4458,28892,30128,30561,15320,18351,,32990,-666666666,40458,7356,51,775
"Staunton city, Virginia",24234,10937,13297,20197,2723,71,256,0,85,902,96,806,23579,655,0.4610,26678,28446,28634,16597,18963,35141,12304,-666666666,8654,15502,51,790
"Suffolk city, Virginia",87061,42144,44917,45514,36522,148,1394,33,554,2896,293,2603,83796,3265,0.4268,30331,36719,37191,23653,23837,42082,26186,54321,19135,15103,51,800
"Virginia Beach city, Virginia",449733,221023,228710,304213,85906,1187,29069,409,6865,22084,1955,20129,415345,34388,0.4148,33250,37354,38384,21695,24923,31111,30773,47898,20282,16248,51,810
"Waynesboro city, Virginia",21366,10205,11161,17478,2702,27,230,46,314,569,0,569,19819,1547,0.3912,22967,24634,25412,12669,17876,,12128,,19735,3986,51,820
"Williamsburg city, Virginia",14988,6532,8456,11207,2223,31,904,0,36,587,143,444,13877,1111,0.5281,25548,29336,31136,9520,19140,7826,7582,-666666666,10114,7033,51,830
"Winchester city, Virginia",27349,13355,13994,22131,2642,102,569,0,666,1239,45,1194,22840,4509,0.4623,26984,29244,32503,11942,17455,47831,46808,-666666666,8240,6202,51,840
"Van Buren County, Tennessee",5641,2835,2806,5452,22,0,4,0,0,163,39,124,5590,51,0.4189,21348,21682,21688,21084,,-666666666,,-666666666,-666666666,11409,47,175
"Warren County, Tennessee",40099,19775,20324,36852,461,54,236,8,953,1535,117,1418,36697,3402,0.4696,20749,21518,22235,9930,15864,12802,25742,,9795,10178,47,177
"Washington County, Tennessee",126044,61224,64820,115871,5017,450,1838,13,564,2291,131,2160,122032,4012,0.4873,26662,27180,27431,20941,15435,13310,35802,,38867,17219,47,179
"Wayne County, Tennessee",16842,9338,7504,15448,1128,69,47,0,89,61,0,61,16530,312,0.4458,17735,18926,19040,10304,2680,24246,4396,-666666666,8166,11602,47,181
"Weakley County, Tennessee",34024,16549,17475,30238,3047,49,37,11,86,556,79,477,33283,741,0.4376,19847,20717,20754,16383,13293,18292,8768,,12538,10702,47,183
"White County, Tennessee",26373,12880,13493,25363,485,0,5,0,14,506,0,506,25778,595,0.4475,18785,18966,19120,12564,17418,-666666666,,-666666666,,11373,47,185
"Williamson County, Tennessee",205645,100438,105207,184114,8788,285,7752,104,1359,3243,395,2848,196132,9513,0.4505,46494,47532,48707,20801,39617,58026,42650,,15888,28371,47,187
"Wilson County, Tennessee",125616,61321,64295,111183,8409,542,1838,187,1626,1831,103,1728,120996,4620,0.4141,29762,31036,31297,20251,19784,27301,21306,11775,15498,21991,47,189
"Anderson County, Texas",57772,35381,22391,42632,12287,307,336,8,1420,782,180,602,47973,9799,0.4514,18087,21390,24397,9067,7579,16562,15882,,14572,11121,48,001
"Andrews County, Texas",17215,8734,8481,15926,351,15,36,0,535,352,32,320,7855,9360,0.4429,29240,28051,35843,21744,15760,,,-666666666,21950,34434,48,003
"Angelina County, Texas",87657,42765,44892,67999,12883,635,885,9,3557,1689,207,1482,69152,18505,0.4624,21486,23018,25902,11473,16852,9168,38864,,11887,10949,48,005
"Aransas County, Texas",24729,12246,12483,21823,413,166,249,0,717,1361,369,992,18233,6496,0.5168,29426,30510,35584,13965,17093,14181,66918,-666666666,22472,14464,48,007
"Archer County, Texas",8750,4344,4406,8260,104,111,43,0,113,119,6,113,8028,722,0.4194,29086,30093,31294,12468,6291,10296,,-666666666,17946,16491,48,009
"Armstrong County, Texas",1913,973,940,1771,26,23,0,0,20,73,28,45,1670,243,0.3773,28542,29290,30890,14926,52285,26374,-666666666,-666666666,33210,,48,011
"Atascosa County, Texas",47710,23760,23950,44209,351,140,161,0,1418,1431,236,1195,17616,30094,0.4396,23416,23733,35341,16662,23738,67474,38295,-666666666,17642,13304,48,013
"Austin County, Texas",29107,14358,14749,24123,2519,8,15,0,1570,872,206,666,21684,7423,0.4469,28351,31065,34389,17654,17048,,,-666666666,11334,16853,48,015
"Bailey County, Texas",7131,3787,3344,6021,163,6,35,7,884,15,15,0,2730,4401,0.4029,17710,18568,28918,11795,4797,,8591,,14852,,48,017
"Bandera County, Texas",21015,10420,10595,19449,142,252,40,0,150,982,28,954,17297,3718,0.4292,28547,29368,29664,25795,14396,16137,65588,-666666666,29497,15864,48,019
"Bastrop County, Texas",78286,39861,38425,60846,6264,505,733,0,8385,1553,674,879,50758,27528,0.4336,25242,27525,32049,15588,22289,18047,26638,-666666666,12571,17809,48,021
"Baylor County, Texas",3639,1759,1880,3379,67,20,0,0,52,121,6,115,3335,304,0.5584,30495,31589,32397,17860,38975,,-666666666,-666666666,11410,6487,48,023
"Bee County, Texas",32706,19761,12945,28220,2694,242,164,3,1013,370,232,138,13766,18940,0.4744,17504,18188,25714,13902,5487,20356,70899,,19420,22220,48,025
"Bell County, Texas",330859,165045,165814,213137,74113,2357,9153,2441,12931,16727,1527,15200,252980,77879,0.4336,24213,26635,30217,15972,21770,18083,21558,17431,17566,12626,48,027
"Bexar County, Texas",1858699,915173,943526,1457657,141020,12929,50650,1295,140017,55131,14491,40640,753459,1105240,0.4638,25317,26445,39570,18486,23540,18489,29214,29769,17918,16740,48,029
"Blanco County, Texas",10918,5501,5417,10067,77,148,77,0,232,317,6,311,8857,2061,0.4623,30982,31847,34662,16810,30695,9504,,-666666666,21849,27030,48,031
"Borden County, Texas",698,374,324,685,0,11,0,0,0,2,0,2,665,33,0.5375,42236,42815,43543,27121,-666666666,,-666666666,-666666666,-666666666,,48,033
"Bosque County, Texas",17953,8845,9108,16929,252,65,77,0,282,348,27,321,14904,3049,0.4525,24815,25383,27823,12284,22377,34132,7304,-666666666,11625,11770,48,035
"Bowie County, Texas",93483,47076,46407,64734,22777,759,960,40,1812,2401,121,2280,86727,6756,0.5023,23705,27782,28768,10711,15458,16152,17473,,7968,9165,48,037
"Brazoria County, Texas",338419,171456,166963,251028,44000,1422,20810,11,14388,6760,918,5842,239492,98927,0.4267,31180,31807,36494,21407,30812,22235,37759,,17208,21718,48,039
"Brazos County, Texas",209896,106391,103505,155512,22208,874,12608,71,12507,6116,654,5462,158232,51664,0.5214,24157,26820,30236,14625,17277,21784,19365,19607,13232,14045,48,041
"Brewster County, Texas",9188,4363,4825,8622,25,126,149,0,131,135,37,98,5148,4040,0.4794,26156,26729,34194,17692,20828,20347,7406,-666666666,29224,13667,48,043
"Briscoe County, Texas",1672,849,823,1511,42,0,0,7,31,81,5,76,1150,522,0.4324,22906,23743,29464,11698,10967,-666666666,-666666666,,22794,15147,48,045
"Brooks County, Texas",7217,3706,3511,6276,7,70,0,0,728,136,51,85,398,6819,0.5233,14885,15114,21193,14529,,,-666666666,-666666666,14291,12485,48,047
"Brown County, Texas",37935,18756,19179,34794,1657,101,201,0,587,595,130,465,29968,7967,0.4580,22090,22432,24475,14318,20089,18925,21618,-666666666,15680,14682,48,049
"Burleson County, Texas",17417,8687,8730,13632,2147,32,69,0,1185,352,130,222,13954,3463,0.4375,25833,28468,30602,17108,17316,20334,12154,-666666666,18861,2380,48,051
"Burnet County, Texas",44584,22025,22559,41800,804,330,317,0,771,562,143,419,34995,9589,0.4506,27434,27777,30643,16917,19077,31065,43611,-666666666,21264,11103,48,053
"Caldwell County, Texas",39848,20019,19829,30425,2844,184,60,19,5335,981,327,654,19995,19853,0.4167,21485,23209,29670,15906,12191,15730,,65184,17671,16480,48,055
"Calhoun County, Texas",21805,11039,10766,18841,606,9,1030,40,308,971,34,937,11373,10432,0.4160,25181,25472,31620,18996,13286,15133,37181,,20604,16474,48,057
"Callahan County, Texas",13596,6528,7068,12856,188,7,76,11,115,343,30,313,12383,1213,0.4911,22557,23333,23552,19622,6418,,11971,,20759,6262,48,059
"Cameron County, Texas",418785,202517,216268,389429,2361,902,2717,65,19550,3761,2197,1564,46100,372685,0.4952,15457,15358,33491,13196,19973,54141,38050,19248,12673,11703,48,061
"Camp County, Texas",12631,6191,6440,8923,2094,27,58,0,1180,349,30,319,9642,2989,0.4400,20034,22192,24821,12970,14097,49293,56072,-666666666,11362,21546,48,063
"Carson County, Texas",6027,2846,3181,5746,51,28,21,7,30,144,31,113,5451,576,0.3866,28943,30004,30405,23988,,14743,,,14410,5239,48,065
"Cass County, Texas",30346,14694,15652,24110,5281,74,129,13,308,431,15,416,29061,1285,0.4445,21608,23366,23703,14872,15073,40607,5137,,9384,14131,48,067
"Castro County, Texas",7875,4002,3873,7040,66,27,46,2,373,321,50,271,2924,4951,0.4838,21230,22491,37901,12612,14571,19822,,,10970,8950,48,069
"Chambers County, Texas",38072,18954,19118,33013,3061,56,518,0,913,511,47,464,30025,8047,0.4300,29729,30740,34222,17220,25808,19096,30284,-666666666,11848,20504,48,071
"Cherokee County, Texas",51257,26069,25188,40972,7114,131,298,0,825,1917,670,1247,39929,11328,0.4606,19871,21656,24862,11118,11389,15501,37094,-666666666,12269,14100,48,073
"Childress County, Texas",7059,3954,3105,5807,505,66,175,250,151,105,22,83,5627,1432,0.4585,18745,20015,23786,6276,7787,,14316,,9925,5577,48,075
"Clay County, Texas",10367,5177,5190,9797,89,137,41,0,121,182,15,167,9796,571,0.4693,26696,27575,28181,11324,8098,14923,,-666666666,3922,16249,48,077
"Cochran County, Texas",2955,1512,1443,2613,99,6,1,0,136,100,25,75,1276,1679,0.4967,20408,21291,29291,15452,8547,,,-666666666,21843,7080,48,079
"Coke County, Texas",3228,1682,1546,2989,26,41,4,0,161,7,0,7,2550,678,0.4832,27755,28556,31118,17233,,20200,,-666666666,19976,,48,081
"Coleman County, Texas",8476,4277,4199,7850,234,67,72,0,162,91,16,75,7011,1465,0.4995,25178,25871,27820,15510,21720,9087,11651,-666666666,17945,9712,48,083
"Collin County, Texas",886633,435186,451447,638396,81491,3818,114915,625,19646,27742,4672,23070,753788,132845,0.4316,39933,42479,46614,21398,30092,38658,40217,30677,21705,22371,48,085
"Collingsworth County, Texas",3032,1537,1495,2444,111,141,3,0,294,39,8,31,2038,994,0.4334,21116,23845,28304,11327,10611,8817,,-666666666,9617,12726,48,087
"Colorado County, Texas",20792,10306,10486,15576,2864,113,21,0,2132,86,66,20,14938,5854,0.4755,26161,28644,31552,17793,20829,,30476,-666666666,16834,5586,48,089
"Comal County, Texas",124234,61175,63059,112597,2467,367,1237,59,4888,2619,766,1853,91488,32746,0.4420,33872,34805,39367,19487,41319,32095,24535,110973,17991,19304,48,091
"Comanche County, Texas",13506,6708,6798,12888,189,35,35,0,188,171,51,120,9869,3637,0.4590,21681,21803,24857,13970,15802,15991,7786,-666666666,29318,14568,48,093
"Concho County, Texas",4142,2851,1291,3882,29,0,34,0,182,15,0,15,1845,2297,0.4774,16599,17204,29679,6457,,-666666666,,-666666666,3340,6760,48,095
"Cooke County, Texas",38878,19299,19579,36011,1027,247,312,44,328,909,59,850,32298,6580,0.4381,28045,28662,32199,11733,18959,24849,51052,18452,21762,9584,48,097
"Coryell County, Texas",75710,37638,38072,54254,10755,639,1458,670,1756,6178,248,5930,62434,13276,0.4162,20555,22923,24640,13174,16332,15485,22065,20524,16688,8375,48,099
"Cottle County, Texas",1560,763,797,1197,235,33,0,0,72,23,0,23,1114,446,0.4510,20397,22471,26686,11444,16112,5694,-666666666,-666666666,11894,3961,48,101
"Crane County, Texas",4823,2462,2361,2396,210,25,0,0,2124,68,63,5,1860,2963,0.4428,25367,31242,35407,19893,20891,13492,-666666666,-666666666,19416,22450,48,103
"Crockett County, Texas",3836,1894,1942,1782,14,0,0,0,1998,42,0,42,1415,2421,0.4596,23861,32296,35606,17502,,-666666666,-666666666,-666666666,16621,,48,105
"Crosby County, Texas",5987,2908,3079,5448,238,0,0,13,164,124,92,32,2736,3251,0.4471,19651,20243,29572,12887,12935,-666666666,-666666666,,15351,14294,48,107
"Culberson County, Texas",2259,1168,1091,1767,9,0,0,3,378,102,0,102,495,1764,0.4723,18862,19674,24801,16520,,-666666666,-666666666,,10121,38287,48,109
"Dallam County, Texas",7052,3730,3322,6401,96,135,66,0,170,184,45,139,4045,3007,0.4081,19908,20458,26497,12134,25957,12826,22564,-666666666,16953,4600,48,111
"Dallas County, Texas",2513054,1238199,1274855,1526798,563370,8603,145680,1493,200536,66574,17058,49516,1525205,987849,0.5034,28552,33224,51137,14683,20892,18614,32930,22185,14628,19993,48,113
"Dawson County, Texas",13317,7478,5839,10332,780,292,86,4,1605,218,80,138,5916,7401,0.4888,21193,25205,36381,13205,3656,3571,4500,,10563,2613,48,115
"Deaf Smith County, Texas",19039,9478,9561,16540,236,102,73,21,1203,864,160,704,5581,13458,0.3976,19823,21122,33483,14960,8807,17199,,,14673,6659,48,117
"Delta County, Texas",5226,2543,2683,4444,455,9,39,0,62,217,75,142,4875,351,0.4371,20822,21461,21704,21686,8728,,31913,-666666666,,14719,48,119
"Denton County, Texas",754650,371110,383540,578108,68449,3096,56563,533,22139,25762,4228,21534,612031,142619,0.4362,36238,38605,43138,20067,28995,26205,34798,25876,21018,20023,48,121
"DeWitt County, Texas",20660,10847,9813,14335,2060,18,23,0,3823,401,346,55,13643,7017,0.5242,27370,32732,37218,15753,10954,20194,,-666666666,18198,8920,48,123
"Dickens County, Texas",2237,1160,1077,2008,95,23,1,0,74,36,34,2,1612,625,0.4834,22526,23394,27312,13368,8247,38474,,-666666666,9227,29525,48,125
"Dimmit County, Texas",10842,5243,5599,10111,33,7,23,0,668,0,0,0,1502,9340,0.5301,19528,19182,32622,16721,28673,22129,,-666666666,14437,-666666666,48,127
"Donley County, Texas",3506,1785,1721,3228,142,33,19,2,5,77,0,77,3143,363,0.4379,22454,22368,23917,9551,30761,47848,5026,,,4757,48,129
"Duval County, Texas",11510,5882,5628,9791,148,82,39,0,1425,25,20,5,1254,10256,0.5176,19853,20255,33737,18436,3452,8143,,-666666666,17352,18944,48,131
"Eastland County, Texas",18252,9045,9207,17040,387,45,62,0,431,287,23,264,15400,2852,0.5508,21577,22409,24439,9228,12865,8016,25403,-666666666,5473,9458,48,133
"Ector County, Texas",153177,77333,75844,130130,6561,812,1520,2,9595,4557,751,3806,64805,88372,0.4553,27295,28456,37498,21340,19195,22519,41412,,20823,15565,48,135
"Edwards County, Texas",2028,935,1093,1992,2,1,0,0,33,0,0,0,928,1100,0.4325,27333,27749,41864,15176,,,-666666666,-666666666,4309,-666666666,48,137
"Ellis County, Texas",160225,79024,81201,130401,15097,1954,1057,59,7206,4451,764,3687,120091,40134,0.4118,27313,29210,32831,15379,21778,11752,41343,,15285,13582,48,139
"El Paso County, Texas",833592,408310,425282,690665,29082,5870,9502,1297,79621,17555,5705,11850,151883,681709,0.4611,19145,19395,34913,16296,22739,17017,28709,22018,15001,17450,48,141
"Erath County, Texas",40641,19969,20672,37319,651,200,297,0,1179,995,162,833,32424,8217,0.5088,22781,22814,24910,12710,7681,4994,53480,-666666666,12670,37824,48,143
"Falls County, Texas",17265,8234,9031,12396,4209,43,42,23,274,278,0,278,13378,3887,0.4449,17257,19689,23672,9765,10726,10926,19138,,14079,9136,48,145
"Fannin County, Texas",33757,17824,15933,29734,2283,114,175,20,556,875,65,810,30241,3516,0.4318,21429,22738,24020,10640,8982,16461,27167,,3306,19896,48,147
"Fayette County, Texas",24909,12292,12617,22469,1600,11,169,8,467,185,41,144,19956,4953,0.4839,28665,29768,33313,15237,15257,34255,61316,,15830,14042,48,149
"Fisher County, Texas",3847,1807,2040,3453,138,28,14,4,141,69,11,58,2644,1203,0.4835,26796,28112,30519,21097,14634,10486,,,20867,8362,48,151
"Floyd County, Texas",6088,2961,3127,5631,170,13,5,0,123,146,10,136,2609,3479,0.4629,23133,23780,36762,14345,12558,,,-666666666,18600,13876,48,153
"Foard County, Texas",1320,642,678,1171,26,0,0,0,114,9,9,0,1104,216,0.3664,23323,22846,22862,26292,17785,-666666666,-666666666,-666666666,30168,,48,155
"Fort Bend County, Texas",683756,335925,347831,356027,141901,1717,128432,230,37179,18270,4874,13396,519691,164065,0.4308,37134,42990,52255,22939,28776,37898,37213,71319,20498,20711,48,157
"Franklin County, Texas",10571,5369,5202,9458,457,71,4,12,287,282,133,149,9126,1445,0.5010,25250,26577,28233,12490,18669,,,,14605,7678,48,159
"Freestone County, Texas",19585,10246,9339,15765,3118,116,68,0,243,275,20,255,16763,2822,0.4591,23370,25823,28751,9978,13799,6997,21415,-666666666,10674,9858,48,161
"Frio County, Texas",18542,10950,7592,13342,690,10,84,0,4256,160,29,131,4014,14528,0.5274,17547,19083,34364,14741,5031,,2698,-666666666,15174,14094,48,163
"Gaines County, Texas",19485,9940,9545,17861,455,73,93,12,780,211,45,166,11743,7742,0.4478,22837,23304,24382,20811,14675,43859,24540,,17623,10426,48,165
"Galveston County, Texas",314485,155271,159214,245054,41083,1236,10311,67,8070,8664,1557,7107,240404,74081,0.4691,32756,35318,40042,20573,22856,31226,34823,29569,21520,15511,48,167
"Garza County, Texas",6614,4213,2401,5633,237,50,17,15,548,114,63,51,2962,3652,0.4627,19043,20655,35051,7233,17984,,,,5734,17386,48,169
"Gillespie County, Texas",25732,12550,13182,24205,54,336,69,0,211,857,38,819,20119,5613,0.4514,30939,31595,35374,15006,46543,12574,19203,-666666666,11323,24405,48,171
"Glasscock County, Texas",1253,670,583,1111,0,0,0,0,142,0,0,0,786,467,0.4733,34834,37826,45889,16228,-666666666,-666666666,-666666666,-666666666,11428,-666666666,48,173
"Goliad County, Texas",7463,3754,3709,5421,412,0,16,0,1549,65,10,55,4829,2634,0.4948,30581,35741,37328,21380,17342,-666666666,,-666666666,16492,25405,48,175
"Gonzales County, Texas",20370,10296,10074,11556,1268,39,21,8,6981,497,161,336,10262,10108,0.4834,22631,28075,32414,14925,19169,9118,,,15160,11620,48,177
"Gray County, Texas",23028,12142,10886,19510,1066,342,143,27,1278,662,122,540,16728,6300,0.4288,22409,24082,27455,14009,8646,12791,20080,,18153,9719,48,179
"Grayson County, Texas",124231,60695,63536,107803,7235,1423,1439,76,2606,3649,494,3155,108875,15356,0.4457,25541,27005,28605,14208,14090,20693,18973,35893,16621,15630,48,181
"Gregg County, Texas",123283,60416,62867,91711,24837,506,1701,228,1723,2577,556,2021,101258,22025,0.4600,24386,27036,30778,12763,16480,29717,29762,,15360,9246,48,183
"Grimes County, Texas",27140,14936,12204,20435,4366,360,25,0,1252,702,166,536,20890,6250,0.4655,21173,24638,27481,14080,9738,14275,,-666666666,13901,8345,48,185
"Guadalupe County, Texas",147313,72752,74561,110958,10521,531,2509,181,17870,4743,863,3880,92901,54412,0.4073,28310,29708,34008,20329,31235,34636,22561,27571,21732,16253,48,187
"Hale County, Texas",35007,18158,16849,29772,1551,233,141,7,1314,1989,214,1775,14579,20428,0.4219,18888,20268,29174,13636,8767,13937,24348,,13647,9762,48,189
"Hall County, Texas",3162,1585,1577,2592,221,8,15,0,164,162,22,140,2087,1075,0.5170,18453,20819,23264,12775,9324,,,-666666666,10266,3480,48,191
"Hamilton County, Texas",8232,4015,4217,7921,59,49,21,2,61,119,37,82,7285,947,0.4978,26183,24936,26580,11517,14963,,,,12113,16888,48,193
"Hansford County, Texas",5552,2757,2795,5100,13,31,18,0,336,54,45,9,3018,2534,0.4599,23605,24180,33211,12542,29623,10884,,-666666666,16035,21772,48,195
"Hardeman County, Texas",3952,1934,2018,3322,327,0,14,0,170,119,17,102,3041,911,0.4526,19493,21072,23081,13870,9662,-666666666,,-666666666,17693,6868,48,197
"Hardin County, Texas",55624,27484,28140,51251,3091,74,321,22,135,730,26,704,52745,2879,0.4659,28321,29394,30021,18849,14200,,17321,,31864,19327,48,199
"Harris County, Texas",4434257,2205342,2228915,2804918,839349,19696,295792,3155,371689,99658,24576,75082,2578653,1855604,0.4982,29850,34053,51320,17076,21330,21920,34456,18068,16842,20100,48,201
"Harrison County, Texas",66431,32573,33858,48547,14184,259,349,40,1888,1164,270,894,58238,8193,0.4702,23836,25549,27315,12375,19760,27426,23224,,12178,21202,48,203
"Hartley County, Texas",5966,3596,2370,5044,496,2,28,0,178,218,57,161,4451,1515,0.3806,21642,24240,28836,11359,2261,,20896,-666666666,12985,12928,48,205
"Haskell County, Texas",5812,3236,2576,5256,179,30,62,0,164,121,24,97,4269,1543,0.4460,21072,21861,26082,10742,15845,6017,8535,-666666666,20662,5242,48,207
"Hays County, Texas",185686,92221,93465,162209,6823,536,2548,174,8030,5366,1167,4199,116854,68832,0.4596,28396,29707,35486,18785,21390,43105,28691,,16247,15003,48,209
"Hemphill County, Texas",4151,1985,2166,3687,49,31,10,0,253,121,69,52,2705,1446,0.4131,29110,30905,38046,13617,12376,24248,,-666666666,10890,21226,48,211
"Henderson County, Texas",79213,38586,40627,70843,5381,643,515,91,778,962,135,827,69901,9312,0.4688,23605,23811,25443,11121,26853,14653,17028,,10529,12235,48,213
"Hidalgo County, Texas",828334,404079,424255,744392,4890,2448,8186,129,60542,7747,5057,2690,70609,757725,0.4915,15240,15019,30653,13815,16708,14438,38508,16534,14545,16576,48,215
"Hill County, Texas",34901,17216,17685,31058,2451,329,131,4,488,440,103,337,28066,6835,0.4441,22154,23011,25362,12997,15391,9730,20301,,20679,10963,48,217
"Hockley County, Texas",23377,11525,11852,20497,883,242,69,7,1183,496,222,274,12534,10843,0.4374,22718,23534,28893,17218,14300,17082,18980,,20611,12424,48,219
"Hood County, Texas",54217,26724,27493,51552,385,414,375,0,900,591,73,518,47909,6308,0.4546,31508,31932,33729,19336,7075,67399,17460,-666666666,16490,17092,48,221
"Hopkins County, Texas",35844,17592,18252,30171,2434,144,245,16,2176,658,45,613,30112,5732,0.4538,23063,24894,26553,11983,15366,15607,16806,,11217,10742,48,223
"Houston County, Texas",22802,12225,10577,15627,5701,31,102,0,867,474,28,446,20394,2408,0.4653,17624,21236,22888,6929,10061,,15760,-666666666,9102,6407,48,225
"Howard County, Texas",36423,20654,15769,30134,2059,398,312,152,2232,1136,438,698,21666,14757,0.4660,23054,24450,32882,11668,16034,17532,22884,,16027,16256,48,227
"Hudspeth County, Texas",3481,1745,1736,2741,44,0,45,0,589,62,2,60,752,2729,0.5027,14776,16579,37091,9383,6611,-666666666,21227,-666666666,6600,13876,48,229
"Hunt County, Texas",89068,43952,45116,69967,7373,778,1110,0,8432,1408,77,1331,75850,13218,0.4468,22229,24665,25355,12981,13932,19083,15116,-666666666,12073,12743,48,231
"Hutchinson County, Texas",21782,10853,10929,19371,494,262,138,15,774,728,102,626,16952,4830,0.4499,25117,25733,27375,19375,16563,16897,39138,,17829,22723,48,233
"Irion County, Texas",1631,838,793,1430,0,0,0,0,155,46,5,41,1252,379,0.4323,31096,32451,34107,24126,-666666666,-666666666,-666666666,-666666666,25027,9411,48,235
"Jack County, Texas",8866,5037,3829,8223,397,36,4,0,118,88,23,65,7458,1408,0.4857,24677,25823,28633,10697,4840,54978,,-666666666,15366,7753,48,237
"Jackson County, Texas",14678,7199,7479,12787,1074,16,29,10,414,348,151,197,10038,4640,0.4255,25594,27017,31831,15926,20168,24688,25993,,14735,2928,48,239
"Jasper County, Texas",35640,17406,18234,28058,5908,104,236,53,750,531,52,479,33318,2322,0.4384,21116,22982,23539,14803,13505,27511,17633,,15176,7989,48,241
"Jeff Davis County, Texas",2221,1054,1167,2144,12,13,18,0,26,8,0,8,1424,797,0.4123,26493,27003,33177,15628,,27523,5600,-666666666,8923,,48,243
"Jefferson County, Texas",252993,129384,123609,147838,85677,985,8973,103,4880,4537,1520,3017,205030,47963,0.4906,24738,29265,34780,14981,17604,14320,26344,34388,16982,19146,48,245
"Jim Hogg County, Texas",5218,2605,2613,5091,2,1,0,0,91,33,22,11,517,4701,0.4697,16637,16666,11466,17168,,,-666666666,-666666666,9338,32561,48,247
"Jim Wells County, Texas",41486,20332,21154,39442,268,124,171,33,1257,191,25,166,8327,33159,0.4949,21556,21486,29646,19721,26056,21435,19518,,25043,6457,48,249
"Johnson County, Texas",157544,78506,79038,144430,4014,951,1220,628,2685,3616,388,3228,126409,31135,0.4125,25721,26438,28892,15820,22071,17236,22798,19928,16644,12097,48,251
"Jones County, Texas",19944,12822,7122,13968,2930,170,72,0,2111,693,222,471,14590,5354,0.4626,17279,22201,24746,9799,4587,5546,,-666666666,7975,4544,48,253
"Karnes County, Texas",14984,8933,6051,9298,1370,6,20,0,4172,118,84,34,7166,7818,0.5541,25306,31661,40293,17633,5374,,,-666666666,17794,26145,48,255
"Kaufman County, Texas",111830,54970,56860,92578,11254,509,1117,53,3586,2733,662,2071,90402,21428,0.4120,25445,26778,29406,14859,19935,25289,23641,49809,15090,16858,48,257
"Kendall County, Texas",39010,18735,20275,36296,324,141,301,11,654,1283,48,1235,30278,8732,0.4456,36724,37779,40574,24329,35201,6825,45431,,24504,15033,48,259
"Kenedy County, Texas",558,297,261,543,0,0,1,0,14,0,0,0,161,397,0.4285,13822,13511,8589,15825,-666666666,-666666666,,-666666666,,-666666666,48,261
"Kent County, Texas",667,322,345,622,4,7,0,0,33,1,0,1,551,116,0.4656,27434,28343,31186,10824,,19414,-666666666,-666666666,15491,,48,263
"Kerr County, Texas",50505,24368,26137,46452,770,370,459,28,1529,897,73,824,37539,12966,0.4625,26210,27006,30556,15020,12379,34245,24774,,10701,21409,48,265
"Kimble County, Texas",4453,2162,2291,4146,1,11,0,5,252,38,6,32,3446,1007,0.5001,26969,28190,29870,18249,,,-666666666,,10752,5737,48,267
"King County, Texas",274,141,133,274,0,0,0,0,0,0,0,0,210,64,0.3845,30016,30016,35170,13106,-666666666,-666666666,-666666666,-666666666,-666666666,-666666666,48,269
"Kinney County, Texas",3578,2111,1467,3499,3,3,0,0,73,0,0,0,1341,2237,0.4398,17818,18088,24639,13730,,,-666666666,-666666666,4340,-666666666,48,271
"Kleberg County, Texas",31877,16476,15401,27520,1240,170,634,0,1817,496,58,438,8942,22935,0.4590,19700,20200,27369,17503,15327,22135,21282,-666666666,14380,19526,48,273
"Knox County, Texas",3807,1938,1869,3302,271,26,2,1,169,36,18,18,2572,1235,0.4079,19673,20654,23881,13554,11235,29673,,,14311,12433,48,275
"Lamar County, Texas",49626,23988,25638,40272,6094,138,395,152,364,2211,132,2079,46037,3589,0.4750,22438,23884,24717,12892,14777,27695,39191,66794,13491,12333,48,277
"Lamb County, Texas",13561,6873,6688,11906,677,35,73,0,541,329,118,211,6243,7318,0.4519,20933,21778,30507,14467,10644,11534,29538,-666666666,21466,9714,48,279
"Lampasas County, Texas",20357,9972,10385,17860,727,124,208,65,555,818,170,648,16549,3808,0.4145,24382,24876,27089,13729,33203,29435,30310,12611,17388,9173,48,281
"La Salle County, Texas",7319,4240,3079,5798,94,0,10,0,1250,167,20,147,1196,6123,0.6040,23939,25199,51027,19876,2362,-666666666,,-666666666,19878,24171,48,283
"Lavaca County, Texas",19654,9520,10134,15354,1331,2,80,0,2462,425,291,134,16170,3484,0.4680,28491,32512,33116,14929,14108,,30349,-666666666,15024,5782,48,285
"Lee County, Texas",16754,8456,8298,13420,1934,8,86,0,1121,185,60,125,12881,3873,0.4582,25549,27584,30835,13889,21057,,,-666666666,12027,10925,48,287
"Leon County, Texas",16923,8410,8513,15113,1263,60,84,0,175,228,16,212,14558,2365,0.4752,27271,28784,31869,10535,15704,17665,14087,-666666666,15901,7219,48,289
"Liberty County, Texas",78598,38970,39628,64099,8134,262,513,13,4268,1309,328,981,62316,16282,0.4435,22065,23351,26266,11080,15728,35355,17858,,14255,23122,48,291
"Limestone County, Texas",23469,12023,11446,18265,4184,185,147,11,388,289,21,268,18588,4881,0.4659,20506,22852,26466,10987,12129,14144,17508,,13433,7627,48,293
"Lipscomb County, Texas",3507,1898,1609,3004,17,28,15,2,314,127,29,98,2484,1023,0.4335,29103,29072,31555,23459,18524,32936,39173,,30348,26597,48,295
"Live Oak County, Texas",11976,6566,5410,10605,356,13,279,0,486,237,43,194,7434,4542,0.4364,22047,22502,28344,11963,6885,,42131,-666666666,10346,26022,48,297
"Llano County, Texas",19624,9518,10106,18587,255,19,67,0,233,463,110,353,17748,1876,0.5170,34633,35528,36752,18212,15328,,,-666666666,10796,26638,48,299
"Loving County, Texas",76,40,36,67,0,3,0,0,0,6,0,6,64,12,0.4162,32707,34481,40496,6908,-666666666,,-666666666,-666666666,-666666666,,48,301
"Lubbock County, Texas",294682,145467,149215,235352,21288,2441,5983,232,21034,8352,2585,5767,194819,99863,0.4780,25139,27216,32348,15706,15258,17259,26887,19507,17101,13254,48,303
"Lynn County, Texas",5723,2891,2832,4749,127,62,18,5,587,175,123,52,3012,2711,0.4787,24299,24838,32174,15092,42456,15821,,,21098,10365,48,305
"McCulloch County, Texas",8242,4182,4060,6800,197,283,0,0,592,370,36,334,5691,2551,0.4500,22049,24944,27564,12710,14504,2719,-666666666,-666666666,6334,12794,48,307
"McLennan County, Texas",243394,118704,124690,187257,35059,1058,3893,74,9871,6182,1376,4806,182233,61161,0.4747,22878,25154,28957,13828,15732,17166,16466,18168,14032,13640,48,309
"McMullen County, Texas",671,365,306,636,0,6,0,0,29,0,0,0,348,323,0.4999,27971,27945,36415,18891,-666666666,,-666666666,-666666666,26993,-666666666,48,311
"Madison County, Texas",13843,8758,5085,10095,2564,18,118,21,516,511,67,444,10772,3071,0.4361,17698,22260,26314,7886,5454,,14165,,6539,2285,48,313
"Marion County, Texas",10191,5013,5178,7567,2422,33,86,0,43,40,0,40,9801,390,0.4849,22536,25219,24254,44238,14697,28270,,-666666666,35665,8610,48,315
"Martin County, Texas",5451,2783,2668,4520,38,129,0,5,727,32,29,3,2937,2514,0.4849,27692,31321,36952,17683,5229,12016,-666666666,,10346,,48,317
"Mason County, Texas",4064,2095,1969,3645,1,24,110,0,125,159,0,159,3051,1013,0.4720,25834,26675,29538,17637,,12183,4506,-666666666,24814,24271,48,319
"Matagorda County, Texas",36719,18133,18586,28199,3909,109,778,86,2393,1245,182,1063,21792,14927,0.4801,22939,25059,31775,15350,17559,7800,11143,17277,19789,6948,48,321
"Maverick County, Texas",56830,28129,28701,52764,112,628,302,19,2638,367,207,160,2588,54242,0.4656,16086,15703,29171,15275,74218,26318,58653,,12622,26331,48,323
"Medina County, Texas",47920,25100,22820,43402,1083,217,258,15,1766,1179,407,772,23553,24367,0.4435,24731,25615,33853,17165,7805,15106,29598,,16590,20968,48,325
"Menard County, Texas",2163,1150,1013,1772,28,34,0,0,96,233,69,164,1311,852,0.4823,23331,24264,27665,17421,16225,37068,-666666666,-666666666,20993,16048,48,327
"Midland County, Texas",155817,77923,77894,128996,9717,642,2775,55,10016,3616,705,2911,89961,65856,0.4773,36869,39324,51167,22540,22062,40109,42373,13724,24182,19758,48,329
"Milam County, Texas",24372,12126,12246,20167,2078,106,130,0,1101,790,86,704,18214,6158,0.4649,22132,23712,26926,13131,14852,14886,41502,-666666666,16327,6803,48,331
"Mills County, Texas",4871,2332,2539,4808,15,0,3,0,28,17,3,14,4039,832,0.4665,24099,24301,26275,14248,,-666666666,,-666666666,9643,14724,48,333
"Mitchell County, Texas",8995,5553,3442,7123,970,47,75,0,570,210,101,109,5467,3528,0.4001,19334,21756,26804,12986,8608,57613,680,-666666666,9319,11983,48,335
"Montague County, Texas",19384,9485,9899,18537,19,41,18,0,214,555,21,534,17363,2021,0.4481,25403,26006,27255,13204,7942,39590,,-666666666,9056,11777,48,337
"Montgomery County, Texas",518849,256808,262041,448305,22986,2178,13498,423,18223,13236,1592,11644,402420,116429,0.4752,35912,37456,42496,17389,26299,23084,48284,21048,17267,15948,48,339
"Moore County, Texas",22186,11429,10757,16984,829,118,1886,0,1803,566,147,419,10359,11827,0.3943,20159,21760,29696,15162,21139,6303,12058,-666666666,17750,8241,48,341
"Morris County, Texas",12653,6069,6584,8782,3060,17,14,10,511,259,74,185,11545,1108,0.4582,21616,23660,24433,9916,18905,,,,9421,6910,48,343
"Motley County, Texas",1022,541,481,978,3,0,0,0,19,22,6,16,908,114,0.4369,23131,23674,24885,10780,,-666666666,-666666666,-666666666,,19086,48,345
"Nacogdoches County, Texas",65556,31292,34264,49786,11851,273,1221,0,1264,1161,212,949,53318,12238,0.5042,21343,23277,26612,10309,14669,40443,25437,-666666666,11225,8772,48,347
"Navarro County, Texas",48177,23714,24463,36813,6569,897,299,506,2135,958,85,873,35830,12347,0.4500,21347,23380,26793,12396,16487,12561,16125,10063,13268,10376,48,349
"Newton County, Texas",14138,7082,7056,10870,2990,36,58,0,0,184,0,184,13659,479,0.4341,19293,21062,21257,16553,12790,40639,5767,-666666666,-666666666,20577,48,351
"Nolan County, Texas",15017,7593,7424,13207,829,89,55,2,672,163,48,115,9638,5379,0.4793,22240,23378,26492,16998,12369,11822,34693,,17389,1587,48,353
"Nueces County, Texas",355667,175151,180516,310741,13902,1613,6676,229,16383,6123,2163,3960,133194,222473,0.4611,25826,26372,38169,19833,20981,24882,31773,47478,19847,18044,48,355
"Ochiltree County, Texas",10577,5398,5179,9182,23,166,18,0,785,403,106,297,5060,5517,0.4642,24997,26041,34540,17377,,19863,70661,-666666666,19974,11529,48,357
"Oldham County, Texas",2069,1082,987,1834,120,3,3,0,3,106,3,103,1734,335,0.4815,23644,25825,29501,8029,2946,,,-666666666,,7376,48,359
"Orange County, Texas",83751,41429,42322,73658,6814,332,924,12,389,1622,102,1520,78042,5709,0.4512,26611,27539,28242,18701,21346,27735,23225,30975,23577,9008,48,361
"Palo Pinto County, Texas",27922,13754,14168,25558,638,331,136,25,767,467,112,355,22452,5470,0.4879,24891,25651,27442,15487,14899,15805,26946,,11401,25419,48,363
"Panola County, Texas",23771,11688,12083,19162,3996,16,126,13,253,205,36,169,21746,2025,0.4441,25345,27904,29365,11814,15074,,7613,6892,10603,17803,48,365
"Parker County, Texas",123601,61585,62016,115369,1823,1059,757,50,2573,1970,313,1657,109813,13788,0.4437,32274,33115,34390,19283,18975,30595,31924,,15844,18084,48,367
"Parmer County, Texas",9921,5097,4824,8417,146,93,21,23,913,308,185,123,3794,6127,0.4265,21655,22829,32687,15749,17177,11158,,1048,18569,7008,48,369
"Pecos County, Texas",15826,9075,6751,12939,694,93,32,9,1958,101,30,71,5037,10789,0.4099,19738,20803,27331,17779,4278,24977,17331,,18323,14652,48,371
"Polk County, Texas",46583,24995,21588,39248,4936,667,274,29,423,1006,66,940,39929,6654,0.4476,21411,22572,24744,10757,14970,22337,14599,,13882,12770,48,373
"Potter County, Texas",121883,62660,59223,95425,11585,527,6121,119,3416,4690,953,3737,76596,45287,0.4819,20984,22816,29584,13196,12011,23795,19193,16302,16717,11118,48,375
"Presidio County, Texas",7144,3508,3636,6628,0,99,243,0,174,0,0,0,1301,5843,0.4491,16326,16631,34817,13192,-666666666,15440,11183,-666666666,12403,-666666666,48,377
"Rains County, Texas",11087,5653,5434,9986,264,96,37,0,478,226,27,199,10155,932,0.4021,23577,24759,25442,13264,18965,,8114,-666666666,15807,4638,48,379
"Randall County, Texas",128603,63181,65422,116396,3580,757,2084,67,2502,3217,552,2665,103662,24941,0.4263,31383,32353,35040,19822,19291,27586,38867,3593,20493,14870,48,381
"Reagan County, Texas",3625,1933,1692,1809,67,0,0,0,1726,23,10,13,1233,2392,0.4045,25754,33552,41011,18215,24969,-666666666,-666666666,-666666666,17464,36883,48,383
"Real County, Texas",3348,1611,1737,3308,5,0,1,0,31,3,0,3,2690,658,0.4231,21135,21225,23635,11077,13200,-666666666,,-666666666,14329,,48,385
"Red River County, Texas",12455,5917,6538,9862,2168,58,5,0,105,257,23,234,11559,896,0.4629,20798,22908,24200,7230,12273,15298,,-666666666,8404,18226,48,387
"Reeves County, Texas",14438,8676,5762,11301,663,114,156,0,1889,315,153,162,3637,10801,0.4644,18458,18169,33696,14501,12639,29302,53038,-666666666,20374,8526,48,389
"Refugio County, Texas",7315,3599,3716,5940,366,13,9,0,533,454,4,450,3707,3608,0.4484,24776,26244,32738,18543,21361,22838,,-666666666,18686,15759,48,391
"Roberts County, Texas",939,457,482,924,0,0,4,0,3,8,0,8,912,27,0.3690,31655,31833,32222,17848,-666666666,-666666666,,-666666666,,30325,48,393
"Robertson County, Texas",16537,8214,8323,12515,3311,99,52,26,283,251,35,216,13264,3273,0.4246,22980,25561,29450,13886,14507,30457,25406,11415,18146,9279,48,395
"Rockwall County, Texas",88010,43084,44926,76141,4850,146,2140,29,1726,2978,491,2487,73290,14720,0.4101,37231,38882,42235,19973,27830,36184,42381,,17248,18327,48,397
"Runnels County, Texas",10411,5181,5230,9479,141,57,139,0,403,192,56,136,6926,3485,0.4686,22856,23131,25939,16886,28062,9595,26779,-666666666,20449,11581,48,399
"Rusk County, Texas",53197,27866,25331,42064,9203,138,288,0,710,794,134,660,44758,8439,0.4518,22704,24975,28013,10784,14294,20020,20900,-666666666,10657,11804,48,401
"Sabine County, Texas",10367,5131,5236,9328,736,6,16,0,54,227,0,227,9969,398,0.4826,20120,21429,22291,1693,8024,,,-666666666,3548,7350,48,403
"San Augustine County, Texas",8556,4174,4382,6338,1855,159,7,0,89,108,0,108,7980,576,0.5334,19251,21687,22606,9809,13766,,,-666666666,8399,,48,405
"San Jacinto County, Texas",27172,13260,13912,23449,2847,162,178,0,140,396,71,325,23831,3341,0.4470,22563,23033,24751,11503,22568,,3794,-666666666,17052,4190,48,407
"San Patricio County, Texas",66706,33444,33262,61431,1259,373,647,15,1635,1346,276,1070,29278,37428,0.4246,24008,24626,32579,18351,14306,18120,18913,,20205,13831,48,409
"San Saba County, Texas",5881,3076,2805,5272,199,0,19,0,278,113,7,106,4164,1717,0.4482,19583,21122,23715,12542,3051,-666666666,,-666666666,7528,7767,48,411
"Schleicher County, Texas",3171,1615,1556,2169,8,0,7,0,985,2,0,2,1555,1616,0.4495,26408,28951,33161,19770,,-666666666,,-666666666,20463,,48,413
"Scurry County, Texas",17314,9353,7961,15172,820,96,57,0,846,323,72,251,10531,6783,0.4023,23758,24969,30011,16655,16732,6979,,-666666666,18189,8322,48,415
"Shackelford County, Texas",3323,1655,1668,3125,5,0,7,0,107,79,0,79,2941,382,0.4338,24190,24654,25973,15066,,-666666666,,-666666666,25563,6153,48,417
"Shelby County, Texas",25705,12614,13091,20426,4590,38,353,29,117,152,19,133,21182,4523,0.4846,20233,22742,26019,10260,11348,9363,3287,,12195,3509,48,419
"Sherman County, Texas",3069,1609,1460,2826,16,24,0,0,119,84,59,25,1779,1290,0.4063,23863,24138,30364,14923,6938,52654,-666666666,-666666666,27954,3814,48,421
"Smith County, Texas",219745,106129,113616,168400,39042,767,3333,240,4543,3420,801,2619,178914,40831,0.4632,25299,28143,31988,13342,15564,24599,23227,8439,15636,12586,48,423
"Somervell County, Texas",8673,4265,4408,8121,45,59,0,51,315,82,28,54,7016,1657,0.4431,26547,27254,29357,16142,4456,,-666666666,12512,19865,20982,48,425
"Starr County, Texas",63008,30589,32419,59500,39,37,52,0,3088,292,192,100,656,62352,0.4997,12663,12631,33834,12501,10454,13819,10112,-666666666,13503,10956,48,427
"Stephens County, Texas",9787,5291,4496,8766,246,190,42,0,457,86,10,76,7503,2284,0.4539,22307,23373,25715,13942,7817,21423,35036,-666666666,10533,13345,48,429
"Sterling County, Texas",1233,651,582,1142,3,0,0,0,75,13,0,13,768,465,0.4177,25104,25215,29560,18221,,-666666666,-666666666,-666666666,25412,,48,431
"Stonewall County, Texas",1233,619,614,1087,60,0,0,0,42,44,36,8,949,284,0.4511,24285,26286,28468,12908,17375,-666666666,-666666666,-666666666,4919,2764,48,433
"Sutton County, Texas",3936,2094,1842,2960,21,8,0,14,914,19,3,16,1639,2297,0.4358,28140,29119,37618,21704,3871,,-666666666,,26100,,48,435
"Swisher County, Texas",7639,3964,3675,6359,450,171,16,5,234,404,167,237,4397,3242,0.4615,18699,20485,26497,12271,8858,7688,,,18663,6795,48,437
"Tarrant County, Texas",1947529,953334,994195,1360100,304741,8629,98095,3283,113478,59203,10753,48450,1405582,541947,0.4627,29791,33326,40336,16434,22113,29932,29259,18758,16050,15937,48,439
"Taylor County, Texas",135234,66259,68975,108142,10374,855,2621,38,9614,3590,882,2708,103600,31634,0.4612,24328,26480,29151,14768,16316,15663,20129,,15791,10718,48,441
"Terrell County, Texas",778,376,402,543,10,3,0,0,222,0,0,0,236,542,0.5430,25147,28377,42118,18615,,,-666666666,-666666666,18347,-666666666,48,443
"Terry County, Texas",12724,6764,5960,11083,654,59,0,0,683,245,159,86,5963,6761,0.4857,21936,23263,34684,13325,7335,13934,-666666666,-666666666,15055,21989,48,445
"Throckmorton County, Texas",1520,709,811,1462,5,0,8,0,0,45,0,45,1290,230,0.4901,28860,29619,31850,17667,,-666666666,,-666666666,-666666666,11042,48,447
"Titus County, Texas",32592,16017,16575,24033,3037,252,296,7,4308,659,228,431,19074,13518,0.4453,20043,23014,29273,11240,13169,16828,19905,,9726,12139,48,449
"Tom Green County, Texas",116264,57521,58743,100440,5038,392,1544,38,6148,2664,849,1815,72011,44253,0.4635,26252,26800,31235,19807,18908,27431,51866,,21269,16101,48,451
"Travis County, Texas",1148176,578199,569977,874352,95335,5235,71203,904,64335,36812,6264,30548,760819,387357,0.4883,36649,39668,50429,19182,24207,29220,41133,52394,17392,22823,48,453
"Trinity County, Texas",14360,6844,7516,12432,1426,75,44,0,234,149,29,120,13058,1302,0.4438,19661,20656,21352,11710,13303,49371,,-666666666,7255,5709,48,455
"Tyler County, Texas",21371,11624,9747,17953,2333,54,76,0,615,340,20,320,19822,1549,0.4192,20720,22421,23151,13088,7097,34487,19178,-666666666,20242,23371,48,457
"Upshur County, Texas",40295,19908,20387,34122,3498,253,196,0,1236,990,222,768,37204,3091,0.4383,23215,24523,25118,11610,19618,16536,9823,-666666666,13799,6975,48,459
"Upton County, Texas",3475,1688,1787,1733,167,3,9,0,1498,65,0,65,1652,1823,0.4761,24254,31523,32119,17986,10277,,,-666666666,17332,5365,48,461
"Uvalde County, Texas",27055,13221,13834,24350,40,308,311,37,1478,531,479,52,7996,19059,0.4432,18294,18414,29300,13358,,34122,43646,,12670,6115,48,463
"Val Verde County, Texas",48862,24804,24058,45209,689,106,190,47,1857,764,166,598,9324,39538,0.4593,19522,19634,37330,15672,24809,12085,33186,,13711,19370,48,465
"Van Zandt County, Texas",53070,26096,26974,49480,1379,356,236,48,501,1070,94,976,47754,5316,0.4596,24399,25124,26185,14307,16378,22459,14953,13598,13534,9513,48,467
"Victoria County, Texas",90989,44622,46367,78863,6034,189,1223,47,2663,1970,425,1545,49617,41372,0.4566,27509,28541,36847,18864,19786,11433,42552,,20042,11977,48,469
"Walker County, Texas",69926,40883,29043,51148,16100,186,844,10,875,763,16,747,57613,12313,0.4796,16419,18578,21600,7830,10170,17513,17403,,9030,10877,48,471
"Waller County, Texas",47049,23520,23529,31581,11946,138,401,18,1819,1146,128,1018,33392,13657,0.4591,23338,28442,36091,14435,12012,27843,43261,,14741,7214,48,473
"Ward County, Texas",11396,5668,5728,9499,608,232,26,0,898,133,42,91,5540,5856,0.4627,26091,26578,33431,20060,24851,23984,55169,-666666666,23835,10203,48,475
"Washington County, Texas",34544,17235,17309,26919,5851,242,684,35,401,412,55,357,29336,5208,0.4509,25976,28710,32275,12002,16097,14819,20572,,22060,7790,48,477
"Webb County, Texas",266006,129588,136418,252215,1045,547,1427,22,9170,1580,860,720,12024,253982,0.4912,15691,15563,31567,14935,26743,16497,37665,,14881,13491,48,479
"Wharton County, Texas",41377,20325,21052,33682,5834,42,39,0,1342,438,121,317,24976,16401,0.4647,23245,24950,31412,16501,16003,31067,16851,-666666666,16694,8513,48,481
"Wheeler County, Texas",5642,2866,2776,5004,159,7,22,12,274,164,17,147,4149,1493,0.4182,26736,27674,31720,13035,16234,,64364,,11804,30395,48,483
"Wichita County, Texas",132148,68567,63581,105403,13471,1136,2861,49,4019,5209,679,4530,108136,24012,0.4602,23239,25408,27827,12647,14852,24059,19910,44251,12373,10879,48,485
"Wilbarger County, Texas",13061,6502,6559,10961,1215,136,69,0,417,263,41,222,9397,3664,0.4213,21638,22563,26119,13720,15835,32772,47362,-666666666,15885,6508,48,487
"Willacy County, Texas",21944,11652,10292,21113,151,42,19,7,498,114,29,85,2674,19270,0.4931,12564,12557,25181,10974,15723,21062,,,12254,9135,48,489
"Williamson County, Texas",490619,241189,249430,400363,30836,1377,28449,128,12539,16927,2664,14263,373676,116943,0.3949,32705,33853,37871,21148,25360,21355,37368,18348,24064,18515,48,491
"Wilson County, Texas",46444,23309,23135,43615,647,118,136,33,825,1070,181,889,28445,17999,0.4090,28419,29042,34923,19245,20135,25393,29048,,17886,16500,48,493
"Winkler County, Texas",7723,3959,3764,6864,300,4,27,0,362,166,23,143,3207,4516,0.4243,23051,24430,28908,19557,9620,,,-666666666,12876,11473,48,495
"Wise County, Texas",62089,31097,30992,58788,729,343,267,30,691,1241,276,965,50664,11425,0.4403,27104,27496,29381,18622,25131,32272,22669,41920,21776,11832,48,497
"Wood County, Texas",43198,21423,21775,38697,2259,301,250,0,1184,507,62,445,39137,4061,0.4524,25353,26827,27891,11585,11849,29707,12802,-666666666,12051,7646,48,499
"Yoakum County, Texas",8316,4228,4088,7829,53,25,23,0,186,200,37,163,3031,5285,0.4129,22871,23337,34267,17265,,,35078,-666666666,26113,6821,48,501
"Young County, Texas",18275,8997,9278,17267,230,144,87,0,335,212,50,162,15046,3229,0.4494,25837,26706,29189,13513,11694,10359,16770,-666666666,11074,7927,48,503
"Zapata County, Texas",14335,7185,7150,13708,140,0,0,0,487,0,0,0,843,13492,0.4709,16007,15943,27420,15297,8797,-666666666,-666666666,-666666666,19890,-666666666,48,505
"Zavala County, Texas",12107,6087,6020,10878,76,10,5,0,1089,49,9,40,808,11299,0.4944,13393,12829,25887,12652,9074,,,-666666666,19451,13651,48,507
"Beaver County, Utah",6437,3291,3146,6218,9,5,15,0,176,14,9,5,5741,696,0.3999,21394,21699,22463,12570,,,,-666666666,11495,,49,001
"Box Elder County, Utah",51528,25937,25591,48153,185,553,466,41,1209,921,143,778,46906,4622,0.3815,21854,22381,23158,11543,5031,17056,17712,,15108,10642,49,003
"Cache County, Utah",118824,59450,59374,107139,954,584,2738,407,4560,2442,444,1998,106548,12276,0.4357,21055,21986,22824,11142,17052,15231,12808,10814,12981,9223,49,005
"Carbon County, Utah",20733,10315,10418,19159,183,151,128,27,586,499,188,311,18009,2724,0.4124,21953,22268,22980,16025,24705,29957,14280,51333,17648,11846,49,007
"Daggett County, Utah",751,434,317,732,0,6,0,0,0,13,0,13,733,18,0.3617,27182,27871,28238,4033,-666666666,,-666666666,-666666666,-666666666,,49,009
"Davis County, Utah",329292,165706,163586,294509,4264,1544,6285,2156,10501,10033,2571,7462,299440,29852,0.3869,27059,28093,28618,16902,19648,23900,28498,22958,16634,11212,49,011
"Duchesne County, Utah",20078,10166,9912,18165,33,923,93,77,460,327,25,302,18499,1579,0.3923,22941,23764,24183,14804,18379,14779,21947,7538,14489,16505,49,013
"Emery County, Utah",10570,5359,5211,10303,17,54,160,3,7,26,4,22,9914,656,0.3664,20280,20627,21289,10979,,19748,923,,15686,16700,49,015
"Garfield County, Utah",5020,2641,2379,4764,32,51,31,34,20,88,0,88,4740,280,0.4140,21006,21401,22110,9773,20444,13398,9742,,,7819,49,017
"Grand County, Utah",9428,4814,4614,9159,24,131,45,8,51,10,10,0,8498,930,0.4231,23927,24352,25463,13005,4758,14877,,,,,49,019
"Iron County, Utah",47751,23735,24016,43623,342,1235,332,127,1069,1023,141,882,43810,3941,0.4390,19085,19925,20310,9851,11570,9320,31083,12216,5236,8976,49,021
"Juab County, Utah",10507,5465,5042,9928,26,71,26,17,290,149,5,144,10035,472,0.3672,19194,19718,19943,8029,,13718,11381,,8879,13152,49,023
"Kane County, Utah",7216,3574,3642,6731,16,54,9,0,115,291,22,269,6893,323,0.4123,24488,24874,25044,12406,,38467,,-666666666,6432,22088,49,025
"Millard County, Utah",12604,6389,6215,11250,46,137,84,7,899,181,15,166,10995,1609,0.3807,21643,22849,23530,12331,,17519,8579,,12952,5399,49,027
"Morgan County, Utah",10645,5404,5241,10365,50,1,109,8,44,68,4,64,10362,283,0.3780,27850,28339,28827,8316,,,,,,7750,49,029
"Piute County, Utah",1859,995,864,1848,1,2,0,0,4,4,0,4,1778,81,0.4002,17416,17511,18048,5135,,,-666666666,-666666666,,,49,031
"Rich County, Utah",2284,1086,1198,2214,2,0,0,0,64,4,2,2,2097,187,0.4055,19749,20051,21268,6993,,-666666666,-666666666,-666666666,10039,,49,033
"Salt Lake County, Utah",1092518,548834,543684,886578,18297,8065,41324,16817,90103,31334,5737,25597,898750,193768,0.4370,28578,31221,32851,15257,19001,17994,27888,16295,13244,13682,49,035
"San Juan County, Utah",15540,7789,7751,7669,16,7314,87,95,90,269,12,257,14735,805,0.4697,15817,21662,22332,12896,,9867,3172,18669,5831,17112,49,037
"Sanpete County, Utah",28551,15074,13477,25508,194,403,151,155,1608,532,81,451,25832,2719,0.3925,16924,18171,18391,8006,1740,4832,10606,8082,6547,7536,49,039
"Sevier County, Utah",20913,10688,10225,19894,72,305,38,44,319,241,76,165,19892,1021,0.4100,20074,20440,20711,11383,,13066,69774,,10876,8666,49,041
"Summit County, Utah",39009,19914,19095,37016,237,134,738,17,459,408,33,375,34521,4488,0.4810,49143,50021,54205,14535,25551,23006,51536,24982,15585,26137,49,043
"Tooele County, Utah",61986,31323,30663,56164,402,568,516,318,2671,1347,218,1129,54623,7363,0.3569,22978,23764,24348,16027,20612,16702,18909,14448,15658,11651,49,045
"Uintah County, Utah",36308,18533,17775,31973,175,2662,171,50,343,934,211,723,33359,2949,0.4257,25488,25575,26585,11928,,33427,21080,19126,12662,9339,49,047
"Utah County, Utah",564177,284413,279764,520064,3328,2716,8173,4204,10286,15406,1343,14063,501258,62919,0.4165,22088,22657,23606,13750,19195,12434,19974,17837,15405,11941,49,049
"Wasatch County, Utah",27895,14176,13719,26750,18,31,301,12,221,562,14,548,24185,3710,0.4119,28818,29186,31442,13529,15344,13242,27802,,21363,15900,49,051
"Washington County, Utah",151959,74981,76978,138580,968,2136,1047,1240,4446,3542,572,2970,136884,15075,0.4289,23549,24436,25226,13694,8625,14081,27056,14053,14433,12351,49,053
"Wayne County, Utah",2716,1388,1328,2637,11,11,24,19,7,7,0,7,2579,137,0.4172,21501,21533,21169,29058,,7464,31688,13153,,,49,055
"Weber County, Utah",241328,121181,120147,215502,2610,1839,2948,528,10766,7135,911,6224,198896,42432,0.3986,24226,25112,26863,14303,20995,16973,25465,15289,15039,14542,49,057
"Addison County, Vermont",36926,18312,18614,34962,411,112,707,0,125,609,46,563,36161,765,0.4190,30154,30821,31044,14696,8895,16763,22915,-666666666,7182,21756,50,001
"Bennington County, Vermont",36503,17838,18665,35076,236,29,211,14,117,820,42,778,35869,634,0.4557,30197,30880,30758,31722,16167,5638,27131,,15165,8952,50,003
"Caledonia County, Vermont",30859,15385,15474,29773,259,116,210,0,23,478,42,436,30436,423,0.4207,24948,25222,25336,15072,10432,25978,18826,-666666666,15396,18688,50,005
"Chittenden County, Vermont",160510,78529,81981,146371,4088,424,5631,38,791,3167,137,3030,157011,3499,0.4420,34658,36122,36252,26099,14022,26597,24697,114863,18910,15355,50,007
"Essex County, Vermont",6173,3119,3054,5974,43,19,42,0,3,92,16,76,6095,78,0.4056,22191,22575,22732,9124,6793,8337,12443,-666666666,,12343,50,009
"Franklin County, Vermont",48625,24147,24478,46321,207,307,93,27,269,1401,47,1354,47954,671,0.4240,28892,29595,29643,20898,21797,25937,12601,,17874,11107,50,011
"Grand Isle County, Vermont",6945,3455,3490,6569,0,69,39,0,9,259,16,243,6832,113,0.4439,35613,36451,36645,19267,-666666666,19168,17656,-666666666,,22340,50,013
"Lamoille County, Vermont",25136,12471,12665,24015,204,202,145,0,165,405,1,404,24741,395,0.4433,29180,29457,29534,19857,24182,14948,72921,-666666666,28265,7114,50,015
"Orange County, Vermont",28897,14381,14516,27912,154,141,143,0,108,439,15,424,28537,360,0.4081,28691,29002,29120,13664,11731,19240,27391,-666666666,8635,23272,50,017
"Orleans County, Vermont",27076,13573,13503,26137,124,134,88,0,59,534,4,530,26721,355,0.4355,24204,24571,24651,14939,12824,13332,11042,-666666666,35573,12526,50,019
"Rutland County, Vermont",60133,29550,30583,58201,408,175,485,0,138,726,35,691,59328,805,0.4389,27795,28093,28227,15374,20211,23020,24506,-666666666,11706,14596,50,021
"Washington County, Vermont",58963,29131,29832,56607,482,132,450,18,83,1191,13,1178,57883,1080,0.4346,31464,31900,32116,18001,21785,15825,35041,22533,10580,16665,50,023
"Windham County, Vermont",43609,21419,22190,41368,387,61,503,41,124,1125,46,1079,42699,910,0.4397,28923,29575,29654,18261,14660,20251,13797,15451,22954,18223,50,025
"Windsor County, Vermont",55894,27401,28493,53679,401,63,465,68,295,923,6,917,55082,812,0.4688,33257,33431,33553,21589,29768,19173,35622,232149,25397,12269,50,027
"Accomack County, Virginia",33060,16125,16935,22369,9573,122,62,0,488,446,9,437,30150,2910,0.4662,23337,26418,28303,10026,17155,22277,35627,-666666666,9447,15270,51,001
"Albemarle County, Virginia",104287,49946,54341,84955,9747,250,4733,34,1627,2941,182,2759,98455,5832,0.4709,38039,41257,42213,21641,23930,16077,30612,80741,20323,14968,51,003
"Alleghany County, Virginia",15919,7788,8131,14745,829,2,23,6,68,246,31,215,15691,228,0.4314,25220,26189,26147,23396,13346,,10665,,26522,7880,51,005
"Amelia County, Virginia",12793,6642,6151,9389,3010,65,16,0,33,280,38,242,12641,152,0.3772,25335,27437,27513,,20176,,,-666666666,,11995,51,007
"Amherst County, Virginia",31999,15346,16653,24609,5717,117,185,14,267,1090,23,1067,31300,699,0.4179,23372,24800,25060,9564,19260,21874,20402,,7979,17140,51,009
"Appomattox County, Virginia",15314,7424,7890,11869,3149,13,12,0,31,240,8,232,15128,186,0.4293,24902,27032,27180,10623,18037,13577,,-666666666,,11348,51,011
"Arlington County, Virginia",226092,112644,113448,163181,19477,883,22655,195,12744,6957,947,6010,191316,34776,0.4377,64746,74121,78967,33890,36761,40356,53523,47206,19088,46964,51,013
"Augusta County, Virginia",74330,37572,36758,69292,2993,171,438,66,382,988,71,917,72526,1804,0.4378,28601,29586,29841,13153,16349,14523,15193,,9613,11861,51,015
"Bath County, Virginia",4558,2465,2093,4269,96,0,0,0,23,170,23,147,4421,137,0.4293,28210,28892,29467,10226,33456,-666666666,-666666666,-666666666,21626,9025,51,017
"Bedford County, Virginia",76933,37888,39045,69167,5345,93,983,21,191,1133,91,1042,75421,1512,0.4314,29561,30661,30825,20447,19605,38573,23282,,11716,16677,51,019
"Bland County, Virginia",6612,3733,2879,6283,286,0,3,4,0,36,0,36,6573,39,0.3953,22249,23137,23053,32944,3690,-666666666,,,-666666666,6025,51,021
"Botetourt County, Virginia",33192,16425,16767,31160,1007,87,239,0,229,470,31,439,32710,482,0.4382,32518,33386,33272,26846,26889,17974,13254,-666666666,8578,11169,51,023
"Brunswick County, Virginia",16573,8668,7905,6964,9091,42,117,0,103,256,36,220,16244,329,0.4434,19461,26871,27506,5896,14328,,1044,-666666666,9163,9603,51,025
"Buchanan County, Virginia",23158,11673,11485,22117,650,25,116,0,21,229,0,229,23095,63,0.4680,18160,18502,18515,5603,4790,,21660,-666666666,,24264,51,027
"Buckingham County, Virginia",17030,9453,7577,10513,5825,23,75,11,240,343,23,320,16627,403,0.4143,19264,23355,23647,6091,12957,,27476,,6693,9886,51,029
"Campbell County, Virginia",55061,26745,28316,44871,7716,60,449,32,408,1525,162,1363,53973,1088,0.4308,25219,26879,26847,24876,19871,14620,9901,,21499,9126,51,031
"Caroline County, Virginia",29640,14677,14963,19562,8655,138,243,0,387,655,16,639,28414,1226,0.3825,26577,28172,28254,27929,23093,40035,11623,-666666666,39632,19963,51,033
"Carroll County, Virginia",29733,14897,14836,28961,237,15,73,0,40,407,75,332,28855,878,0.4254,21484,21740,21865,14064,8097,,48279,-666666666,31558,5964,51,035
"Charles City County, Virginia",7086,3456,3630,2984,3346,460,56,0,20,220,3,217,6959,127,0.4764,30477,34986,34971,30072,27481,27812,24846,-666666666,17525,23066,51,036
"Charlotte County, Virginia",12232,6121,6111,8292,3784,21,16,0,20,99,1,98,12116,116,0.4533,18150,20039,20135,3922,13764,29876,26444,-666666666,,27382,51,037
"Chesterfield County, Virginia",331839,159789,172050,226791,75210,814,11471,83,7556,9914,951,8963,305479,26360,0.4070,33848,37535,39092,18308,26676,21376,32843,74439,17315,18344,51,041
"Clarke County, Virginia",14307,7087,7220,12757,642,58,156,0,292,402,11,391,13685,622,0.4364,37630,40191,40673,16134,21146,25462,11696,-666666666,18460,8411,51,043
"Craig County, Virginia",5195,2509,2686,5097,8,0,9,0,1,80,0,80,5194,1,0.4323,22371,22616,22616,,,-666666666,,-666666666,,11830,51,045
"Culpeper County, Virginia",48952,24612,24340,38196,7073,226,717,4,884,1852,153,1699,44390,4562,0.4144,28969,31973,33477,15429,20192,27867,18306,,15675,11210,51,047
"Cumberland County, Virginia",9769,4779,4990,6144,3272,67,0,0,0,286,0,286,9754,15,0.4509,22126,25824,25824,,17204,,-666666666,-666666666,-666666666,3840,51,049
"Dickenson County, Virginia",15304,7814,7490,15049,117,0,4,0,14,120,39,81,15190,114,0.5195,20757,20916,20935,11675,8125,-666666666,,-666666666,,11738,51,051
"Dinwiddie County, Virginia",28155,13903,14252,18260,9078,38,144,13,213,409,24,385,27294,861,0.4303,24001,26470,26980,14393,20316,,9366,,15177,7991,51,053
"Essex County, Virginia",11130,5137,5993,6123,4555,88,23,0,19,322,0,322,11102,28,0.4357,25477,30250,30333,,20294,19523,,-666666666,,6990,51,057
"Fairfax County, Virginia",1132887,560803,572084,713476,107346,2218,209723,726,49776,49622,6419,43203,950947,181940,0.4224,51851,60595,67199,25909,38431,40240,42484,40691,20797,26581,51,059
"Fauquier County, Virginia",68025,33659,34366,59339,5141,172,916,2,523,1932,206,1726,63142,4883,0.4302,41921,44320,46012,20615,27168,32760,32718,,13001,20508,51,061
"Floyd County, Virginia",15587,7682,7905,14926,356,76,2,0,50,177,36,141,15164,423,0.4110,24121,24640,24924,10924,12490,5151,,-666666666,,17559,51,063
"Fluvanna County, Virginia",26046,11826,14220,21128,3615,15,180,0,241,867,5,862,25188,858,0.3950,30230,32785,33148,16990,22624,,20882,-666666666,4765,9205,51,065
"Franklin County, Virginia",56230,27592,28638,50007,4646,103,124,0,687,663,21,642,54718,1512,0.4373,26188,27383,27760,11028,17627,17526,25496,-666666666,10651,13652,51,067
"Frederick County, Virginia",82321,40925,41396,75113,3343,236,1191,54,731,1653,127,1526,76198,6123,0.3967,31555,32389,33525,16934,26907,19773,27028,58137,21889,11398,51,069
"Giles County, Virginia",16871,8233,8638,16306,421,28,59,8,4,45,3,42,16616,255,0.4124,25333,25673,25923,9691,17454,,14946,,,4502,51,071
"Gloucester County, Virginia",37021,18267,18754,32455,3015,63,228,0,85,1175,90,1085,35862,1159,0.4056,31072,31902,32081,25422,26390,40952,34564,-666666666,40669,18279,51,073
"Goochland County, Virginia",21979,10791,11188,17434,3726,26,228,0,111,454,11,443,21439,540,0.4960,45995,53065,53669,23681,18591,9473,50003,-666666666,6200,9197,51,075
"Grayson County, Virginia",15180,7463,7717,14550,356,7,22,0,71,174,4,170,14736,444,0.4625,20190,20585,20859,9980,7616,,,-666666666,13477,15926,51,077
"Greene County, Virginia",19085,9321,9764,16884,1195,0,273,38,171,524,7,517,18099,986,0.3985,28647,29563,30437,14998,22838,-666666666,33705,,24344,13062,51,079
"Greensville County, Virginia",11698,7254,4444,4584,6833,36,19,0,65,161,52,109,11247,451,0.3982,15988,19893,20755,1420,13758,,,-666666666,1835,8507,51,081
"Halifax County, Virginia",35305,16844,18461,21442,12979,85,244,8,224,323,71,252,34629,676,0.4508,20706,23752,23823,14787,15983,13202,25831,,13192,8854,51,083
"Hanover County, Virginia",102199,50104,52095,88821,9281,171,1413,40,376,2097,47,2050,99489,2710,0.3908,35881,37162,37500,24292,29525,25057,28283,12610,23553,18371,51,085
"Henrico County, Virginia",321921,152084,169837,186820,95259,671,24655,172,4921,9423,846,8577,305068,16853,0.4546,34993,40801,41858,19180,24907,27080,39186,31691,16771,20975,51,087
"Henry County, Virginia",52209,25094,27115,37817,11641,32,297,0,1437,985,140,845,49488,2721,0.4521,20645,21685,21875,10422,19700,,16820,-666666666,7883,12206,51,089
"Highland County, Virginia",2230,994,1236,2220,0,4,0,0,0,6,0,6,2230,0,0.4211,28736,28693,28693,-666666666,-666666666,,-666666666,-666666666,-666666666,33950,51,091
"Isle of Wight County, Virginia",36027,17600,18427,26162,8055,56,318,13,185,1238,136,1102,35082,945,0.4050,32090,35494,35953,17479,24452,39864,18888,,23461,13782,51,093
"James City County, Virginia",71900,34876,37024,57738,9505,298,1986,7,384,1982,188,1794,68098,3802,0.4410,41314,44932,45753,27641,24897,23693,42341,,26653,18903,51,095
"King and Queen County, Virginia",7140,3673,3467,4901,1891,46,11,0,22,269,12,257,6919,221,0.3827,25392,28112,28567,22510,20174,23150,,-666666666,,8884,51,097
"King George County, Virginia",25260,12588,12672,19389,4272,62,302,13,158,1064,120,944,24138,1122,0.3748,35201,37728,38028,30856,25451,,36852,,30904,26447,51,099
"King William County, Virginia",16156,8003,8153,12384,3030,215,133,0,47,347,12,335,16031,125,0.3760,29311,32018,32135,16607,20635,23787,19823,-666666666,,16772,51,101
"Lancaster County, Virginia",11055,5128,5927,7760,3125,0,40,0,13,117,0,117,10869,186,0.4541,32013,37662,38031,20269,19040,-666666666,12325,-666666666,,11738,51,103
"Lee County, Virginia",24911,13083,11828,23286,1032,104,43,0,253,193,53,140,24463,448,0.4611,17820,18238,18304,3401,9469,7645,190809,-666666666,1409,491,51,105
"Loudoun County, Virginia",362435,179315,183120,244078,26600,841,60404,325,12586,17601,2602,14999,314228,48207,0.3756,48578,52431,56160,26453,43011,37538,47200,33678,23603,26942,51,107
"Louisa County, Virginia",34350,16874,17476,26952,5426,123,193,0,668,988,23,965,33474,876,0.4391,28767,30926,31141,15281,21990,11694,32966,-666666666,10765,20593,51,109
"Lunenburg County, Virginia",12450,6498,5952,7699,3952,18,327,0,193,261,51,210,11925,525,0.3992,18383,21275,21624,10478,12968,,23435,-666666666,9405,16684,51,111
"Madison County, Virginia",13122,6410,6712,11231,934,0,106,0,170,681,79,602,12831,291,0.4678,27144,29459,29543,12792,14868,-666666666,,-666666666,18028,11370,51,113
"Mathews County, Virginia",8848,4144,4704,7619,869,69,47,4,20,220,18,202,8759,89,0.4209,34918,37461,37482,7106,22034,6417,12353,,,14563,51,115
"Mecklenburg County, Virginia",31209,15133,16076,19148,11077,47,44,6,401,486,17,469,30391,818,0.4432,21492,25003,24801,25701,16301,18332,23984,,16616,5074,51,117
"Middlesex County, Virginia",10728,5295,5433,8351,2110,39,0,13,46,169,6,163,10665,63,0.4557,29391,33557,33629,15079,14716,55910,-666666666,,,8938,51,119
"Montgomery County, Virginia",97227,50364,46863,83979,4239,207,6032,45,794,1931,139,1792,94291,2936,0.5053,26819,27610,27774,21345,19720,23121,25915,,8947,16347,51,121
"Nelson County, Virginia",14831,7171,7660,12439,1929,37,49,0,234,143,0,143,14287,544,0.4766,29769,31072,31550,12389,16671,,,-666666666,11860,,51,125
"New Kent County, Virginia",20051,10215,9836,16367,2435,154,196,0,96,803,17,786,19527,524,0.3842,35723,35723,35974,25505,41643,37569,30453,-666666666,,21296,51,127
"Northampton County, Virginia",12118,5772,6346,7477,4325,14,99,8,65,130,6,124,11119,999,0.4949,23331,29086,30719,17271,13695,,10468,,17342,16681,51,131
"Northumberland County, Virginia",12272,5966,6306,8605,3570,60,6,0,0,31,0,31,12228,44,0.4340,32238,37397,37489,8320,20369,,,-666666666,-666666666,,51,133
"Nottoway County, Virginia",15641,8483,7158,8916,6166,22,92,23,196,226,0,226,15043,598,0.4391,19256,23078,23441,12330,14408,,1775,,16660,8680,51,135
"Orange County, Virginia",34873,17110,17763,28791,4278,97,345,0,313,1049,48,1001,33405,1468,0.3918,30361,31955,32683,14899,27090,,21915,-666666666,16778,8419,51,137
"Page County, Virginia",23759,11636,12123,22769,380,30,131,0,100,349,60,289,23322,437,0.4006,22683,23069,23254,9686,20943,23770,12684,-666666666,6727,7689,51,139
"Patrick County, Virginia",18180,8967,9213,16735,1051,29,49,0,156,160,0,160,17683,497,0.4286,20526,20930,21262,6479,16445,,,-666666666,15265,10480,51,141
"Pittsylvania County, Virginia",62392,30667,31725,46715,13207,35,261,22,1040,1112,50,1062,60873,1519,0.4243,22650,24540,24628,12067,17766,73803,24117,,11341,10112,51,143
"Powhatan County, Virginia",28286,15198,13088,24190,3403,88,59,22,55,469,31,438,27726,560,0.3821,32770,35817,36186,14127,14802,6093,81202,,358,10157,51,145
"Prince Edward County, Virginia",23077,11532,11545,14697,7526,127,303,0,188,236,47,189,22513,564,0.4535,18789,21675,22019,4937,13997,25743,15374,-666666666,966,6736,51,147
"Prince George County, Virginia",37664,20615,17049,22230,12157,246,822,141,870,1198,238,960,34918,2746,0.3894,26721,29920,29905,20907,23286,17334,21205,13577,15151,17878,51,149
"Adams County, Washington",19100,9716,9384,13538,122,342,161,45,4533,359,101,258,7280,11820,0.4125,17781,19618,27034,12261,9883,6588,29232,,12011,30177,53,001
"Asotin County, Washington",22113,10635,11478,20759,63,240,199,11,139,702,34,668,21322,791,0.4335,25760,26261,26386,16425,14484,16874,40082,,5610,15147,53,003
"Benton County, Washington",187519,93970,93549,150774,2674,1342,4391,201,20221,7916,1751,6165,149373,38146,0.4343,29529,32030,33937,14596,26494,25190,43137,19356,14536,14666,53,005
"Chelan County, Washington",74761,37199,37562,67799,370,922,680,97,3032,1861,276,1585,54454,20307,0.4531,26109,26910,31239,13949,9587,15524,19488,14071,16950,23444,53,007
"Clallam County, Washington",72969,36072,36897,64423,775,3425,1127,47,648,2524,97,2427,68695,4274,0.4291,26967,28240,28919,15432,11849,15240,25662,24645,11165,19712,53,009
"Clark County, Washington",450893,222759,228134,381593,8486,2841,19282,3502,14547,20642,1830,18812,411851,39042,0.4259,30207,31704,32593,15171,24854,24928,32306,21686,14633,15935,53,011
"Columbia County, Washington",3971,1950,2021,3594,15,21,47,29,149,116,30,86,3701,270,0.4604,26536,28163,28498,14596,20487,15110,11264,,7297,16532,53,013
"Cowlitz County, Washington",102854,50660,52194,93319,634,1209,1310,294,1405,4683,386,4297,94214,8640,0.4357,24756,25671,26704,11032,22773,17348,25525,3628,11742,13727,53,015
"Douglas County, Washington",40101,20132,19969,28917,152,390,320,55,8531,1736,611,1125,27854,12247,0.3851,23966,28099,29350,13193,25507,15645,28609,77849,12431,10971,53,017
"Ferry County, Washington",7639,3874,3765,5819,13,1186,61,50,64,446,45,401,7323,316,0.4479,21146,23408,23381,18480,,14481,,10154,11433,14024,53,019
"Franklin County, Washington",87810,45747,42063,61659,2046,438,1790,104,18846,2927,971,1956,42125,45685,0.4023,20997,23847,30642,13693,19533,13756,19735,9567,13613,11787,53,021
"Garfield County, Washington",2231,1102,1129,2132,0,7,19,0,0,73,0,73,2157,74,0.3574,23313,24065,24897,912,-666666666,,,-666666666,-666666666,6303,53,023
"Grant County, Washington",92530,46630,45900,65396,642,1015,930,69,20593,3885,1499,2386,55406,37124,0.4083,20409,23447,26565,12121,15244,20115,23889,32057,12422,11502,53,025
"Grays Harbor County, Washington",71233,36656,34577,62665,756,3287,1202,244,566,2513,86,2427,64369,6864,0.4504,23799,24718,25898,13135,9471,15261,22352,10326,14537,20450,53,027
"Island County, Washington",80113,39928,40185,68488,2416,877,3609,374,974,3375,389,2986,74711,5402,0.4250,32503,34308,35135,19910,22058,23158,25413,17906,20160,18528,53,029
"Jefferson County, Washington",30333,14876,15457,27602,278,607,482,44,200,1120,24,1096,29288,1045,0.4539,30871,31955,32242,15260,11389,15553,36655,6118,4231,20524,53,031
"King County, Washington",2079550,1037792,1041758,1397436,127902,14581,332246,16215,65354,125816,11066,114750,1885361,194189,0.4682,43629,49717,51732,21911,23487,23664,40390,20035,19818,22752,53,033
"Kitsap County, Washington",257488,131150,126338,210358,6273,2996,11966,2037,4899,18959,1385,17574,239113,18375,0.4267,32801,35128,35825,20563,23830,19937,29362,28232,23876,16954,53,035
"Kittitas County, Washington",42785,21381,21404,38315,484,341,823,58,1435,1329,19,1310,39132,3653,0.4564,25147,26127,26675,15915,17400,27767,9755,11328,15013,20104,53,037
"Klickitat County, Washington",20930,10486,10444,19093,142,560,143,62,548,382,33,349,18410,2520,0.3857,23227,24187,25542,11690,5197,14920,27887,,13218,10515,53,039
"Lewis County, Washington",75724,37742,37982,69619,588,515,889,43,969,3101,363,2738,68432,7292,0.4209,22947,23632,24648,12676,13539,19037,17924,,15593,14035,53,041
"Lincoln County, Washington",10326,5249,5077,9739,35,124,59,13,52,304,0,304,10018,308,0.4066,25382,25801,26108,13800,8811,30901,32859,41338,18556,10666,53,043
"Mason County, Washington",61060,31442,29618,51497,1118,2050,907,136,2330,3022,265,2757,55595,5465,0.4323,25628,27638,28065,9986,17388,15619,26444,51862,7328,13890,53,045
"Okanogan County, Washington",41299,20785,20514,30875,251,4058,360,81,3760,1914,147,1767,33430,7869,0.4459,22544,24986,26950,11070,14311,18037,24088,11388,13552,11638,53,047
"Pacific County, Washington",20743,10368,10375,18523,62,377,367,48,422,944,23,921,18888,1855,0.4241,22187,23341,24125,11454,6811,19391,9749,7171,6577,14255,53,049
"Pend Oreille County, Washington",13001,6677,6324,11962,30,475,79,42,34,379,34,345,12546,455,0.4472,24163,24771,25204,13582,,20172,30548,,25950,11146,53,051
"Pierce County, Washington",832896,413477,419419,619585,55676,10151,49787,11457,23734,62506,3242,59264,748875,84021,0.4257,29750,32587,33837,16665,26140,20185,26962,19697,16106,15633,53,053
"San Juan County, Washington",16056,7739,8317,14866,110,145,230,32,339,334,46,288,15119,937,0.4954,40327,41588,42540,16116,62716,28330,18652,18469,16240,23497,53,055
"Skagit County, Washington",120475,59573,60902,101897,942,1958,2364,357,8353,4604,841,3763,99165,21310,0.4361,28586,30798,32820,14010,17297,17058,26645,20613,13298,16197,53,057
"Skamania County, Washington",11316,5713,5603,10549,104,263,106,5,115,174,9,165,10648,668,0.4557,28556,29455,30169,16011,5795,14660,34274,,14145,15311,53,059
"Snohomish County, Washington",758649,380430,378219,591763,20511,7368,73386,3661,19518,42442,3583,38859,685790,72859,0.4102,33883,35917,37242,19209,27445,26381,33211,25685,18193,19020,53,061
"Spokane County, Washington",485859,240656,245203,431646,8754,6487,11327,2171,5750,19724,1271,18453,460716,25143,0.4518,26860,28073,28422,17465,17822,15143,22556,15916,18831,14187,53,063
"Stevens County, Washington",43744,21911,21833,38901,200,2012,313,15,476,1827,50,1777,42276,1468,0.4161,22745,23760,23990,11710,19725,14494,25994,,12136,12671,53,065
"Thurston County, Washington",266311,130394,135917,219735,7963,4053,15229,2314,2766,14251,1102,13149,244455,21856,0.4083,30583,32194,33167,19723,28386,19806,27200,22576,21843,16653,53,067
"Wahkiakum County, Washington",4051,1975,2076,3761,5,101,78,1,32,73,24,49,3863,188,0.4459,27619,28492,29130,11405,,26009,,,7581,8721,53,069
"Walla Walla County, Washington",59809,30670,29139,50996,946,520,985,115,3833,2414,475,1939,47301,12508,0.4579,24736,26279,28726,13186,11738,16274,34966,17922,16758,7880,53,071
"Whatcom County, Washington",209729,103878,105851,177367,2059,6455,8401,610,6408,8429,1129,7300,191212,18517,0.4507,27810,29584,30392,14793,18557,14927,24211,18690,14918,16652,53,073
"Whitman County, Washington",47494,24138,23356,39433,962,243,3774,42,838,2202,109,2093,44813,2681,0.4966,20957,21875,22382,12146,20270,12955,20456,,17353,8094,53,075
"Yakima County, Washington",247681,123899,123782,194173,2431,10044,2603,189,30546,7695,1883,5812,129590,118091,0.4459,20653,22197,29779,12414,17102,14925,36235,21774,13846,11990,53,077
"Barbour County, West Virginia",16892,8175,8717,16308,118,116,65,0,5,280,0,280,16749,143,0.4449,18602,18968,19048,6699,4601,18174,5328,-666666666,,5744,54,001
"Berkeley County, West Virginia",110173,54159,56014,96609,8293,56,1151,115,1063,2886,92,2794,105888,4285,0.4025,27015,27920,28217,16582,23705,27164,27838,,15741,10197,54,003
"Boone County, West Virginia",23645,11731,11914,23239,182,5,25,0,37,157,2,155,23511,134,0.4646,20711,20762,20732,23016,17285,,18072,-666666666,,20480,54,005
"Braxton County, West Virginia",14463,7234,7229,14208,49,10,0,46,6,144,0,144,14277,186,0.4343,20178,20242,20428,3674,3159,,-666666666,,,21151,54,007
"Brooke County, West Virginia",23473,11407,12066,22699,390,12,97,3,44,228,0,228,23275,198,0.4127,24428,24873,25023,7743,12817,,11263,,12609,8365,54,009
"Cabell County, West Virginia",96623,47314,49309,88036,4764,157,1220,33,259,2154,63,2091,95311,1312,0.5028,23853,24554,24609,17124,15564,23603,36535,,13174,7969,54,011
"Calhoun County, West Virginia",7482,3685,3797,7365,12,9,5,0,1,90,9,81,7399,83,0.4217,20640,20587,20717,8536,,,,-666666666,,28472,54,013
"Clay County, West Virginia",9033,4523,4510,8850,3,48,0,16,9,107,0,107,9024,9,0.4306,16980,16910,16911,,,,-666666666,,,27007,54,015
"Doddridge County, West Virginia",8363,4483,3880,8028,98,6,35,0,4,192,8,184,8337,26,0.4123,19703,20152,20197,,6567,,,-666666666,,9559,54,017
"Fayette County, West Virginia",45192,22716,22476,42205,2304,129,62,0,102,390,23,367,44734,458,0.4326,20286,20447,20532,13298,18023,19036,21540,-666666666,17185,17178,54,019
"Gilmer County, West Virginia",8497,5080,3417,7228,920,24,24,0,93,208,38,170,8193,304,0.4590,17361,19375,19648,7945,3749,,,-666666666,11818,12205,54,021
"Grant County, West Virginia",11770,5908,5862,11526,174,0,0,0,13,57,0,57,11635,135,0.4124,20648,20588,20573,21861,26616,-666666666,-666666666,-666666666,,,54,023
"Greenbrier County, West Virginia",35580,17384,18196,33533,887,0,112,11,129,908,79,829,35087,493,0.4654,23204,23678,23687,17398,23330,-666666666,13252,,8200,9088,54,025
"Hampshire County, West Virginia",23455,12082,11373,22793,276,97,41,0,17,231,0,231,23166,289,0.4354,19997,20254,20296,17772,12718,,,-666666666,,3048,54,027
"Hancock County, West Virginia",30024,14559,15465,28654,702,24,95,14,0,535,8,527,29627,397,0.4336,24041,24290,24447,11375,24062,47725,41124,,-666666666,6336,54,029
"Hardy County, West Virginia",13942,6935,7007,13106,580,17,182,0,23,34,9,25,13366,576,0.4313,21956,22386,22759,10793,16708,,11181,-666666666,,8518,54,031
"Harrison County, West Virginia",68775,33599,35176,65807,1243,135,360,79,84,1067,22,1045,67746,1029,0.4637,25702,25918,25993,18409,23563,8353,29001,,15665,18304,54,033
"Jackson County, West Virginia",29199,14443,14756,28517,21,141,186,0,18,316,0,316,29105,94,0.4403,22591,22591,22646,,,43586,36395,-666666666,,5165,54,035
"Jefferson County, West Virginia",55531,27512,28019,48881,3758,98,768,0,541,1485,220,1265,52629,2902,0.4152,32227,33023,33622,20756,29141,17634,28480,-666666666,28077,18248,54,037
"Kanawha County, West Virginia",189636,91385,98251,168005,9900,373,2076,0,409,8873,87,8786,187619,2017,0.4691,28030,29053,29079,25167,17936,14307,52444,-666666666,33806,14528,54,039
"Lewis County, West Virginia",16422,8229,8193,16007,52,41,101,0,0,221,74,147,16290,132,0.4330,20954,21033,21182,,5683,,22532,-666666666,-666666666,16057,54,041
"Lincoln County, West Virginia",21482,10732,10750,21162,113,16,69,0,0,122,0,122,21386,96,0.4352,19416,19492,19578,,7699,,27372,-666666666,-666666666,15038,54,043
"Logan County, West Virginia",35166,17402,17764,33957,662,83,129,0,59,276,6,270,34865,301,0.4557,20843,20645,20664,21858,28429,,50804,-666666666,45869,10436,54,045
"McDowell County, West Virginia",20273,10323,9950,18060,1903,22,0,0,170,118,37,81,19992,281,0.4722,14259,14595,14626,5321,12698,,-666666666,-666666666,5408,,54,047
"Marion County, West Virginia",56716,27861,28855,53195,2081,38,290,18,171,923,33,890,56066,650,0.4341,24250,24884,24877,21666,13765,,14738,,,19815,54,049
"Marshall County, West Virginia",32296,15904,16392,31505,312,131,101,23,55,169,23,146,31992,304,0.4222,23166,23470,23541,12268,7398,14477,25647,,12505,4891,54,051
"Mason County, West Virginia",27060,13057,14003,26370,126,16,22,0,36,490,57,433,26895,165,0.4332,20253,20204,20251,12713,8148,,,-666666666,,25174,54,053
"Mercer County, West Virginia",61476,29344,32132,56043,3702,212,371,20,131,997,36,961,60857,619,0.4535,21190,21716,21792,10575,16537,13762,31174,,24394,6536,54,055
"Mineral County, West Virginia",27606,13724,13882,26212,923,2,89,0,83,297,15,282,27365,241,0.4314,20093,20233,20338,6460,11939,,110989,-666666666,11507,8400,54,057
"Mingo County, West Virginia",25549,12539,13010,24538,389,17,23,0,263,319,0,319,25459,90,0.4726,19502,19618,19624,10234,17816,,,-666666666,4794,6048,54,059
"Monongalia County, West Virginia",102827,53232,49595,92708,4031,137,3363,0,532,2056,160,1896,100731,2096,0.5259,28041,28832,28969,19422,16460,15809,32515,-666666666,20773,10453,54,061
"Monroe County, West Virginia",13496,6682,6814,13179,89,50,0,0,0,178,13,165,13341,155,0.4262,21257,21543,21542,21547,10561,11320,-666666666,-666666666,-666666666,8232,54,063
"Morgan County, West Virginia",17514,8678,8836,17026,156,13,67,0,22,230,0,230,17269,245,0.4312,23966,24017,24243,8581,46410,10908,22554,-666666666,,8362,54,065
"Nicholas County, West Virginia",25743,12552,13191,25090,133,46,141,0,61,272,0,272,25608,135,0.5003,24244,24251,24228,33175,18824,,,-666666666,17890,11233,54,067
"Ohio County, West Virginia",43257,20831,22426,40306,1808,99,349,0,88,607,34,573,42798,459,0.5099,28160,29185,29159,26656,12015,9564,37136,-666666666,3819,9566,54,069
"Pendleton County, West Virginia",7291,3674,3617,6981,235,0,4,0,0,71,0,71,7229,62,0.4856,23325,23663,23724,16885,15860,-666666666,,-666666666,-666666666,12896,54,071
"Pleasants County, West Virginia",7612,4013,3599,7428,10,0,0,0,0,174,28,146,7480,132,0.4480,23580,23984,24164,11148,,-666666666,-666666666,-666666666,-666666666,6106,54,073
"Pocahontas County, West Virginia",8620,4451,4169,8326,100,0,0,0,16,178,0,178,8543,77,0.4374,22328,22679,22643,26543,18304,-666666666,-666666666,-666666666,,8097,54,075
"Preston County, West Virginia",33793,17411,16382,31634,1522,139,53,27,126,292,139,153,33174,619,0.4174,21716,22761,22936,7976,4943,14312,15702,,6097,8801,54,077
"Putnam County, West Virginia",56743,27863,28880,54756,824,51,326,11,121,654,0,654,56135,608,0.4383,29173,29233,29318,20580,22328,,48819,,,28215,54,079
"Raleigh County, West Virginia",78051,39244,38807,68855,6223,277,808,71,529,1288,106,1182,76899,1152,0.4520,22590,23238,23334,12559,15747,15956,42798,8601,15919,13281,54,081
"Randolph County, West Virginia",29287,15020,14267,28345,515,114,129,0,54,130,4,126,29048,239,0.4646,22079,22306,22357,15037,15080,10691,15798,-666666666,,17042,54,083
"Ritchie County, West Virginia",10044,4982,5062,9874,34,0,0,0,0,136,0,136,9968,76,0.4168,20711,20923,21029,,23918,-666666666,-666666666,-666666666,-666666666,4521,54,085
"Roane County, West Virginia",14513,7145,7368,14196,6,30,12,1,28,240,0,240,14374,139,0.4507,18954,19121,19255,1764,,12220,16183,,28139,9304,54,087
"Summers County, West Virginia",13325,6170,7155,12399,717,26,0,0,9,174,9,165,13099,226,0.4184,19652,20210,20027,27532,12970,,-666666666,-666666666,,9487,54,089
"Taylor County, West Virginia",16949,8602,8347,16431,162,15,163,0,57,121,9,112,16785,164,0.4222,22915,23164,22987,35456,19227,,13901,-666666666,,15588,54,091
"Tucker County, West Virginia",6922,3444,3478,6788,31,0,34,0,0,69,0,69,6877,45,0.4216,22958,23176,23236,4467,,-666666666,,-666666666,-666666666,9762,54,093
"Tyler County, West Virginia",9000,4481,4519,8864,42,21,0,0,20,53,0,53,8936,64,0.4700,22083,22151,22236,13953,,39943,-666666666,-666666666,,9411,54,095
"Upshur County, West Virginia",24632,12356,12276,24008,356,39,21,27,0,181,10,171,24341,291,0.4369,21361,21731,21811,15555,7070,7000,,,-666666666,8643,54,097
"Wayne County, West Virginia",41237,20050,21187,40383,136,30,159,0,62,467,4,463,40984,253,0.4593,20450,20391,20318,25865,,,66702,-666666666,1342,17858,54,099
"Webster County, West Virginia",8820,4374,4446,8791,2,5,0,5,0,17,0,17,8811,9,0.4789,18652,18596,18609,,,,-666666666,,-666666666,48776,54,101
"Wetzel County, West Virginia",15997,7839,8158,15686,69,6,47,0,0,189,0,189,15920,77,0.4483,21484,21721,21733,19266,,,,-666666666,-666666666,6145,54,103
"Wirt County, West Virginia",5826,2986,2840,5699,45,24,0,0,4,54,0,54,5800,26,0.4556,22021,22038,22100,8535,,,-666666666,-666666666,,9398,54,105
"Wood County, West Virginia",86262,41616,44646,83014,969,120,561,128,149,1321,51,1270,85371,891,0.4584,25465,25592,25632,18453,15555,20938,63577,12195,11938,11764,54,107
"Wyoming County, West Virginia",22537,11145,11392,21998,153,4,54,0,28,300,0,300,22479,58,0.4493,19833,20098,20108,7138,10254,,,-666666666,,6885,54,109
"Adams County, Wisconsin",20294,10955,9339,18913,646,126,52,16,154,387,58,329,19520,774,0.4182,23668,24537,24943,10055,5198,11751,43108,,12693,17976,55,001
"Ashland County, Wisconsin",15936,8000,7936,13533,74,1727,89,0,29,484,0,484,15544,392,0.4263,22270,23350,23548,14360,6645,16059,7074,-666666666,10666,20136,55,003
"Barron County, Wisconsin",45548,22945,22603,43591,529,379,273,0,276,500,5,495,44489,1059,0.4257,25426,25947,26150,14666,17502,13006,14828,-666666666,14619,9542,55,005
"Bayfield County, Wisconsin",14987,7668,7319,12918,92,1558,77,0,37,305,2,303,14744,243,0.4164,27321,29045,29132,18418,3458,15715,10822,-666666666,29773,24656,55,007
"Brown County, Wisconsin",256621,127380,129241,220790,5859,6343,7851,23,7926,7829,1394,6435,235788,20833,0.4395,28787,31093,32009,12061,13360,17411,21013,,12846,8505,55,009
"Buffalo County, Wisconsin",13256,6743,6513,12929,53,26,14,0,94,140,0,140,12976,280,0.4106,26973,27212,27335,19792,12998,16219,29307,-666666666,22311,15044,55,011
"Burnett County, Wisconsin",15259,7803,7456,13974,70,714,42,5,37,417,17,400,15024,235,0.4311,25073,25930,26066,12485,17013,15060,14595,,26830,15852,55,013
"Calumet County, Wisconsin",49653,24933,24720,46951,453,268,1098,0,394,489,24,465,47704,1949,0.3759,30856,31594,32124,13043,14948,50853,16214,-666666666,8703,14552,55,015
"Chippewa County, Wisconsin",63355,32937,30418,60255,851,130,754,0,93,1272,21,1251,62383,972,0.4049,26299,27080,27287,7457,10411,15245,15239,-666666666,4884,9208,55,017
"Clark County, Wisconsin",34486,17482,17004,33301,187,97,146,0,383,372,16,356,33036,1450,0.4288,22560,22774,23117,11531,14269,23157,38223,-666666666,12074,12009,55,019
"Columbia County, Wisconsin",56650,28819,27831,54028,821,307,326,9,331,828,50,778,54946,1704,0.3980,29936,30708,31050,14235,5521,15872,33883,,15989,13139,55,021
"Crawford County, Wisconsin",16415,8525,7890,15762,292,82,40,0,27,212,26,186,16218,197,0.4221,23466,24037,24092,12557,3911,20072,16920,-666666666,,12659,55,023
"Dane County, Wisconsin",516818,256341,260477,434792,26699,1375,28645,147,10250,14910,1770,13140,484730,32088,0.4491,35687,38551,39465,16473,17151,23842,28200,22085,15314,14977,55,025
"Dodge County, Wisconsin",88404,46157,42247,82988,1870,641,498,0,771,1636,165,1471,84439,3965,0.3863,25617,26593,27108,11985,5687,15071,15963,-666666666,13405,11699,55,027
"Door County, Wisconsin",27669,13651,14018,26775,176,153,145,0,93,327,28,299,26907,762,0.4421,32767,33218,33655,13725,17736,42763,21839,-666666666,9582,10697,55,029
"Douglas County, Wisconsin",43705,21814,21891,40624,515,777,487,3,152,1147,45,1102,43082,623,0.4178,26036,26951,27059,11733,12173,19548,13501,,8682,11923,55,031
"Dunn County, Wisconsin",44348,22351,21997,41845,220,128,961,0,136,1058,86,972,43577,771,0.4273,25120,25720,25887,11881,7476,23046,16806,-666666666,15090,14147,55,033
"Eau Claire County, Wisconsin",101907,50071,51836,94470,846,521,3805,129,204,1932,136,1796,99632,2275,0.4424,26795,27788,28079,12710,10471,11847,18696,14164,14844,7489,55,035
"Florence County, Wisconsin",4474,2331,2143,4428,11,6,0,0,0,29,15,14,4428,46,0.4724,28358,28554,28619,14770,,,-666666666,-666666666,-666666666,11110,55,037
"Fond du Lac County, Wisconsin",101968,49884,52084,95247,1187,493,1333,13,1973,1722,129,1593,97056,4912,0.4071,28036,29029,29417,15157,10699,25694,19231,,14533,8144,55,039
"Forest County, Wisconsin",9108,4589,4519,7411,116,1285,36,9,35,216,9,207,8923,185,0.4196,22559,23600,23813,9464,24516,19772,13519,,11194,6205,55,041
"Grant County, Wisconsin",51723,26874,24849,49966,740,79,376,18,151,393,15,378,50990,733,0.4064,23103,23427,23594,11894,6368,18865,24894,13494,27120,11411,55,043
"Green County, Wisconsin",37050,18347,18703,36034,139,94,245,19,97,422,2,420,35950,1100,0.4103,28867,29208,29636,14968,17068,23833,24126,,26493,9207,55,045
"Green Lake County, Wisconsin",18881,9535,9346,18155,110,77,105,8,255,171,0,171,18017,864,0.4257,26115,26622,27139,9695,17996,19091,11813,,7125,18813,55,047
"Iowa County, Wisconsin",23751,11936,11815,22996,119,65,108,25,194,244,12,232,23358,393,0.4290,29610,30027,30060,20800,9184,31674,15956,,12838,21943,55,049
"Iron County, Wisconsin",5850,2970,2880,5660,39,39,4,0,23,85,4,81,5789,61,0.4238,25536,25982,25944,21233,3405,15069,,-666666666,7365,16318,55,051
"Jackson County, Wisconsin",20566,10972,9594,18151,412,1222,79,0,215,487,45,442,19932,634,0.3996,24074,25292,25451,15666,5197,20166,17110,-666666666,19542,7569,55,053
"Jefferson County, Wisconsin",84538,42212,42326,79778,701,116,601,21,1701,1620,341,1279,78717,5821,0.3885,27272,28019,28783,12905,13028,43466,17359,,14462,12303,55,055
"Juneau County, Wisconsin",26399,14023,12376,24911,621,387,123,3,87,267,17,250,25621,778,0.4217,23519,24173,24456,14587,6071,17052,21013,,10969,16228,55,057
"Kenosha County, Wisconsin",167896,82941,84955,145980,12406,642,2283,26,2351,4208,871,3337,146816,21080,0.4327,27335,29090,30901,15184,13632,26632,30804,4746,16822,11104,55,059
"Kewaunee County, Wisconsin",20459,10392,10067,19838,74,58,80,0,143,266,7,259,19947,512,0.3855,27539,27958,28147,13193,10235,19626,29448,-666666666,6031,13800,55,061
"La Crosse County, Wisconsin",117538,57392,60146,107415,1446,400,5168,29,852,2228,79,2149,115511,2027,0.4492,28240,29277,29337,15087,13794,14750,21139,37783,10747,13055,55,063
"Lafayette County, Wisconsin",16793,8531,8262,16280,57,66,40,0,207,143,1,142,16204,589,0.4045,25877,26027,26416,15029,13111,13323,19865,-666666666,24959,22709,55,065
"Langlade County, Wisconsin",19414,9763,9651,18648,169,172,74,0,63,288,9,279,19051,363,0.4313,24772,25102,25263,12099,3492,13427,74630,-666666666,16232,11718,55,067
"Lincoln County, Wisconsin",28171,14126,14045,27293,189,103,116,0,47,423,10,413,27779,392,0.3986,27322,27479,27603,14351,26446,25621,61699,-666666666,8074,10697,55,069
"Manitowoc County, Wisconsin",80178,39917,40261,75800,441,436,2153,32,317,999,69,930,77322,2856,0.4087,26751,27520,27954,13718,7406,19168,13834,,9967,13531,55,071
"Marathon County, Wisconsin",135367,68051,67316,123898,889,428,7501,26,363,2262,49,2213,131864,3503,0.4386,28773,30160,30599,10894,11183,14427,15021,41565,10082,10923,55,073
"Marinette County, Wisconsin",41090,20622,20468,39808,167,164,238,17,121,575,6,569,40478,612,0.4255,25231,25208,25283,18955,11477,17909,66861,59559,15098,16810,55,075
"Marquette County, Wisconsin",15082,7661,7421,14448,75,54,81,6,209,209,0,209,14627,455,0.4028,25268,25753,25883,17847,7179,35291,21785,,15522,6735,55,077
"Menominee County, Wisconsin",4457,2205,2252,426,14,3811,94,0,7,105,0,105,4203,254,0.4648,15171,36029,37343,3414,12107,13112,9404,-666666666,,10987,55,078
"Milwaukee County, Wisconsin",955306,462020,493286,583848,252459,5602,37458,195,44664,31080,4338,26742,818697,136609,0.4781,25881,32399,35145,14137,15292,18049,23650,18922,13025,12085,55,079
"Monroe County, Wisconsin",45365,22874,22491,42365,549,389,372,8,770,912,156,756,43540,1825,0.3884,24971,25606,25764,16215,21897,22307,13130,21038,17090,9968,55,081
"Oconto County, Wisconsin",37475,19134,18341,36103,89,378,183,0,206,516,43,473,36857,618,0.3985,27623,27685,27828,14496,21147,23071,82651,-666666666,15681,13011,55,083
"Oneida County, Wisconsin",35604,17961,17643,34265,247,323,235,8,99,427,22,405,35121,483,0.4317,28084,28596,28703,13359,4481,18006,12843,,15559,20165,55,085
"Outagamie County, Wisconsin",181799,90637,91162,164096,2076,2910,5878,30,3595,3214,275,2939,174456,7343,0.4110,29663,31084,31259,16944,18005,18759,18890,17773,13143,12794,55,087
"Ozaukee County, Wisconsin",87625,42971,44654,82717,1161,320,1853,21,276,1277,132,1145,85298,2327,0.4841,44369,44624,45190,21306,44112,31353,56240,,39259,15527,55,089
"Pepin County, Wisconsin",7349,3716,3633,7208,26,10,34,0,15,56,6,50,7235,114,0.4228,26280,25946,26136,12143,14308,,128321,-666666666,23267,11604,55,091
"Pierce County, Wisconsin",40881,20328,20553,39465,209,119,438,0,104,546,12,534,40122,759,0.4162,30009,30568,30782,18223,20537,12894,10044,-666666666,23437,14238,55,093
"Polk County, Wisconsin",43483,21904,21579,41878,170,471,217,0,336,411,30,381,42701,782,0.4056,27066,27602,27666,15383,10296,19488,11282,-666666666,11313,9286,55,095
"Portage County, Wisconsin",70551,35384,35167,66118,488,393,1833,8,523,1188,161,1027,68469,2082,0.4276,26832,27541,27811,13815,18793,47327,11280,,14268,13244,55,097
"Price County, Wisconsin",13707,6893,6814,13236,68,65,79,75,17,167,2,165,13500,207,0.4522,27987,25858,25927,178618,28918,12294,11913,16151,12518,216943,55,099
"Racine County, Wisconsin",194873,96388,98485,156176,21450,1158,2249,65,7496,6279,1329,4950,170607,24266,0.4293,28436,31762,33283,15013,14253,32393,38346,74954,14374,6186,55,101
"Richland County, Wisconsin",17642,8912,8730,16983,139,61,82,6,190,181,16,165,17260,382,0.4239,24961,25607,25691,10503,6191,6957,15509,,6604,8641,55,103
"Rock County, Wisconsin",160986,79211,81775,143993,5568,467,1809,0,2761,6388,323,6065,147773,13213,0.4178,25884,27188,28284,11649,15979,17057,22281,-666666666,14158,11841,55,105
"Rusk County, Wisconsin",14272,7180,7092,13814,144,62,57,0,39,156,5,151,14043,229,0.4277,22651,22899,22992,14210,8686,10455,15651,-666666666,12533,23572,55,107
"St. Croix County, Wisconsin",86726,43307,43419,83534,703,413,880,1,117,1078,72,1006,84835,1891,0.4049,34679,35300,35691,15199,16968,18584,25688,,7161,14695,55,109
"Sauk County, Wisconsin",63317,31647,31670,60137,390,742,437,3,471,1137,252,885,60306,3011,0.4079,26736,27274,27567,19034,12617,19154,25655,,28872,7683,55,111
"Sawyer County, Wisconsin",16438,8333,8105,12771,109,2884,88,0,121,465,29,436,16065,373,0.4601,25680,28999,29068,9349,4475,14147,13103,-666666666,4255,18968,55,113
"Shawano County, Wisconsin",41384,20689,20695,37041,133,3090,179,11,53,877,36,841,40343,1041,0.4146,25286,26270,26652,10391,14573,18024,18047,,19030,12986,55,115
"Sheboygan County, Wisconsin",115269,57928,57341,103755,1760,252,6058,7,1188,2249,239,2010,108381,6888,0.4055,27796,29357,30105,13203,13471,16923,15809,,8675,10476,55,117
"Taylor County, Wisconsin",20521,10498,10023,20056,77,52,44,0,85,207,7,200,20163,358,0.4280,24907,25048,25158,13087,21471,12913,58618,-666666666,8889,14956,55,119
"Trempealeau County, Wisconsin",29521,14895,14626,27543,124,71,195,0,1359,229,53,176,27447,2074,0.3973,26002,26937,27275,12466,12102,13932,19737,-666666666,12896,7957,55,121
"Vernon County, Wisconsin",30442,15269,15173,29612,141,69,163,0,181,276,28,248,29979,463,0.4299,24414,24646,24711,15283,12496,9943,34105,-666666666,9404,13364,55,123
"Vilas County, Wisconsin",21373,10705,10668,18471,59,1939,116,12,73,703,15,688,20943,430,0.4522,27537,29770,29983,14155,12339,11555,33094,,47979,11275,55,125
"Walworth County, Wisconsin",103021,51470,51551,96192,1091,380,954,90,2307,2007,592,1415,91797,11224,0.4383,28085,28947,30287,13302,12878,26320,29936,16930,13038,12298,55,127
"Washburn County, Wisconsin",15685,7808,7877,14989,82,273,92,2,28,219,8,211,15430,255,0.4355,26570,26912,26980,15834,13333,24227,20702,,,14256,55,129
"Washington County, Wisconsin",133422,66198,67224,127480,1447,196,1478,24,643,2154,467,1687,129456,3966,0.4058,34722,35235,35674,16954,23849,38807,33074,,22510,16080,55,131
"Waukesha County, Wisconsin",395377,194157,201220,366591,5709,898,12347,166,3968,5698,603,5095,377602,17775,0.4357,40174,40836,41488,20702,19758,25025,48503,20180,15828,19942,55,133
"Waupaca County, Wisconsin",51974,26369,25605,50292,223,280,180,8,431,560,53,507,50477,1497,0.4239,28145,28631,29002,11408,13064,18679,21551,,13485,8823,55,135
"Waushara County, Wisconsin",24238,12720,11518,22695,383,125,97,8,504,426,63,363,22732,1506,0.4296,24861,25871,26501,10139,6062,21244,20356,,7757,10506,55,137
"Winnebago County, Wisconsin",169487,85414,84073,156765,3559,1048,4391,36,1312,2376,122,2254,162977,6510,0.4323,28446,29444,29887,15866,7954,18112,26556,19100,16518,8105,55,139
"Wood County, Wisconsin",73621,36286,37335,69994,522,470,1460,10,308,857,103,754,71659,1962,0.4262,27687,27825,28086,14914,28608,22856,34799,,11919,11599,55,141
"Albany County, Wyoming",37836,19767,18069,33960,577,275,1139,7,819,1059,150,909,34344,3492,0.4966,25227,26517,27149,17274,10501,7651,14034,,15438,16204,56,001
"Big Horn County, Wyoming",11931,6037,5894,11385,28,151,69,11,113,174,16,158,10874,1057,0.3936,23041,23186,24275,11189,31279,27248,23855,17482,15985,13150,56,003
"Campbell County, Wyoming",48473,25202,23271,45793,361,649,305,0,371,994,159,835,44422,4051,0.3740,33317,33999,35315,17658,14224,18220,47310,-666666666,15418,21076,56,005
"Carbon County, Wyoming",15696,8501,7195,14283,200,149,60,16,341,647,66,581,12926,2770,0.4002,27399,28585,30213,17772,24854,15584,3512,,22605,10142,56,007
"Converse County, Wyoming",14223,7121,7102,13532,12,80,123,1,119,356,41,315,13129,1094,0.3951,31470,32118,32595,22882,,27510,,,9697,7501,56,009
"Crook County, Wyoming",7284,3761,3523,7209,12,7,10,0,13,33,0,33,7109,175,0.4261,32817,32999,32569,51356,,,,-666666666,47138,4964,56,011
"Fremont County, Wyoming",40683,20379,20304,29893,211,8306,177,30,570,1496,256,1240,37925,2758,0.4275,26606,30676,31356,15811,20329,13985,22588,28640,18703,19694,56,013
"Goshen County, Wyoming",13546,7167,6379,12528,20,67,33,0,503,395,88,307,12121,1425,0.4371,25883,25640,25775,25383,,15421,120445,-666666666,31011,20592,56,015
"Hot Springs County, Wyoming",4781,2388,2393,4607,7,66,0,0,44,57,0,57,4634,147,0.4248,29499,29725,30137,16218,,19048,-666666666,-666666666,26857,28830,56,017
"Johnson County, Wyoming",8572,4546,4026,7941,38,338,0,0,91,164,62,102,8389,183,0.4583,31888,32788,32984,23619,,,-666666666,-666666666,31282,13708,56,019
"Laramie County, Wyoming",96459,48755,47704,85228,2760,682,1120,165,3248,3256,569,2687,82762,13697,0.4069,30249,31685,32740,20071,27092,20408,24765,14543,15910,14385,56,021
"Lincoln County, Wyoming",18543,9499,9044,17833,39,49,77,15,117,413,32,381,17724,819,0.3916,29748,30168,30754,14827,22744,15814,11312,,13248,20812,56,023
"Natrona County, Wyoming",80871,40903,39968,75254,964,764,748,6,908,2227,304,1923,74241,6630,0.4379,30902,31866,32837,17548,18091,21843,22174,,23821,12867,56,025
"Niobrara County, Wyoming",2498,1138,1360,2314,3,88,13,0,24,56,0,56,2392,106,0.4555,23356,22718,22867,44992,,14322,,-666666666,,13684,56,027
"Park County, Wyoming",29083,14308,14775,27431,243,158,177,3,537,534,42,492,27449,1634,0.3953,30179,31210,31814,14458,10512,18434,21440,,9645,13306,56,029
"Platte County, Wyoming",8740,4570,4170,8229,5,36,11,0,142,317,15,302,8057,683,0.4981,30054,31399,32275,12507,5780,,,-666666666,9537,9000,56,031
"Sheridan County, Wyoming",29924,14821,15103,28209,259,415,220,0,332,489,5,484,28693,1231,0.4151,29630,30150,30393,18202,10074,21215,41053,-666666666,13880,22684,56,033
"Sublette County, Wyoming",10032,5322,4710,9978,0,0,10,0,0,44,0,44,9248,784,0.3209,30295,30307,30707,25617,-666666666,-666666666,,-666666666,-666666666,24780,56,035
"Sweetwater County, Wyoming",44812,23381,21431,41314,405,398,276,137,750,1532,111,1421,37705,7107,0.3929,30945,31414,33440,19306,6318,13742,23707,64997,34779,25644,56,037
"Teton County, Wyoming",22623,11742,10881,20964,168,95,410,0,760,226,28,198,19190,3433,0.4861,46499,47399,51152,28582,170548,35721,9574,-666666666,19989,31501,56,039
"Uinta County, Wyoming",20893,10587,10306,19705,39,204,31,0,280,634,0,634,19021,1872,0.4412,25636,25621,26345,17798,6690,9961,33397,-666666666,14954,36640,56,041
"Washakie County, Wyoming",8351,4062,4289,7575,66,47,15,0,321,327,71,256,7185,1166,0.4333,26325,26867,27877,19823,,35923,,-666666666,25974,17988,56,043
"Weston County, Wyoming",7175,3734,3441,6686,18,9,361,0,0,101,0,101,7103,72,0.4291,29493,30243,30394,15083,,7411,13031,-666666666,-666666666,45545,56,045
"Adjuntas Municipio, Puerto Rico",18760,9161,9599,15198,108,21,0,0,3244,189,26,163,36,18724,0.5849,7124,6837,6246,7129,8533,,-666666666,-666666666,8651,3639,72,001
"Aguada Municipio, Puerto Rico",40083,19637,20446,23137,968,0,74,0,1544,14360,164,14196,2612,37471,0.4973,8592,8886,15106,8181,8371,-666666666,18204,-666666666,6905,8266,72,003
"Aguadilla Municipio, Puerto Rico",56893,27711,29182,38292,2219,106,661,11,7501,8103,333,7770,1902,54991,0.5364,10335,10530,18779,10216,12314,2673,7491,,9128,10332,72,005
"Aguas Buenas Municipio, Puerto Rico",27323,13315,14008,22633,2086,147,3,0,621,1833,53,1780,147,27176,0.5802,9647,9966,32859,9522,7643,15843,,-666666666,9087,7667,72,007
"Aibonito Municipio, Puerto Rico",24438,11787,12651,20236,1654,14,55,0,2284,195,70,125,100,24338,0.4585,9262,9434,28465,9228,8077,,,-666666666,8651,11450,72,009
"Arecibo Municipio, Puerto Rico",91096,43771,47325,77732,4038,287,711,0,6374,1954,612,1342,411,90685,0.5221,9438,9337,5834,9447,11015,15084,2885,-666666666,9840,10443,72,013
"Arroyo Municipio, Puerto Rico",18778,8758,10020,10767,4146,0,0,0,3665,200,67,133,29,18749,0.4747,7655,7894,,7634,7761,-666666666,-666666666,-666666666,6977,5035,72,015
"Barceloneta Municipio, Puerto Rico",24699,11785,12914,22692,560,0,96,0,998,353,27,326,157,24542,0.5100,8245,8016,,8246,13130,-666666666,13669,-666666666,9957,8891,72,017
"Barranquitas Municipio, Puerto Rico",29548,14565,14983,21754,855,0,0,0,1414,5525,189,5336,1,29547,0.5138,7369,7550,-666666666,7370,10169,-666666666,-666666666,-666666666,7089,6296,72,019
"Cabo Rojo Municipio, Puerto Rico",50096,23828,26268,30116,1552,38,11,0,17962,417,42,375,125,49971,0.5306,9833,10107,21271,9805,8929,7626,,-666666666,9496,8434,72,023
"Caguas Municipio, Puerto Rico",136372,63752,72620,104587,11515,222,562,0,16541,2945,918,2027,1310,135062,0.5162,13911,14020,20114,13855,14390,7385,10887,-666666666,13660,10615,72,025
"Camuy Municipio, Puerto Rico",33481,16098,17383,26674,716,38,0,0,5734,319,154,165,243,33238,0.5037,9271,9792,4253,9296,9555,,-666666666,-666666666,6565,14155,72,027
"Carolina Municipio, Puerto Rico",165040,75944,89096,92130,38540,4254,557,18,15242,14299,1493,12806,1968,163072,0.4695,15403,16762,37558,15165,13130,10761,16846,,13216,16429,72,031
"Cayey Municipio, Puerto Rico",46071,22174,23897,35965,1837,65,114,0,6336,1754,182,1572,270,45801,0.5337,12441,12955,16699,12417,12572,10300,12054,-666666666,9837,11284,72,035
"Ceiba Municipio, Puerto Rico",12538,5905,6633,7502,1061,9,153,0,3633,180,42,138,147,12391,0.5001,10584,11648,30458,10394,12664,,8163,-666666666,7759,7195,72,037
"Ciales Municipio, Puerto Rico",17644,8631,9013,16938,127,0,0,0,205,374,62,312,68,17576,0.5181,7080,7131,5503,7086,3192,-666666666,-666666666,-666666666,10880,4010,72,039
"Cidra Municipio, Puerto Rico",41782,20336,21446,33131,2310,128,163,0,5141,909,9,900,176,41606,0.4899,11107,11104,39068,11035,10902,4846,4918,-666666666,12027,8554,72,041
"Coamo Municipio, Puerto Rico",40090,19502,20588,26428,6264,0,0,0,7130,268,24,244,243,39847,0.5068,9699,9553,6885,9714,8999,-666666666,-666666666,-666666666,10976,6416,72,043
"Corozal Municipio, Puerto Rico",35484,17261,18223,25580,1682,0,0,0,2199,6023,174,5849,262,35222,0.5344,7793,7870,,7793,5225,-666666666,-666666666,-666666666,6393,8696,72,047
"Culebra Municipio, Puerto Rico",1508,832,676,758,70,5,15,0,615,45,0,45,88,1420,0.4216,10069,10587,19446,9597,8441,,,-666666666,10246,3969,72,049
"Dorado Municipio, Puerto Rico",38013,18187,19826,29295,4904,0,48,0,1283,2483,138,2345,677,37336,0.5375,14504,15469,33067,14213,10309,-666666666,14610,-666666666,16806,10223,72,051
"Fajardo Municipio, Puerto Rico",33912,15898,18014,19661,3510,25,180,0,9704,832,362,470,311,33601,0.4889,10784,10713,12234,10771,15252,,14402,-666666666,9253,10702,72,053
"Florida Municipio, Puerto Rico",12287,5896,6391,11843,71,0,26,0,294,53,0,53,53,12234,0.4451,7451,7461,,7456,7134,-666666666,,-666666666,7533,,72,054
"Guayama Municipio, Puerto Rico",43210,21461,21749,31769,5491,0,102,0,5224,624,82,542,403,42807,0.5285,9034,8800,7641,9058,11687,-666666666,20251,-666666666,7941,4890,72,057
"Guayanilla Municipio, Puerto Rico",20025,9619,10406,16745,548,124,49,0,2096,463,31,432,95,19930,0.4896,7864,7798,21489,7817,12586,4099,5680,-666666666,7375,8114,72,059
"Guaynabo Municipio, Puerto Rico",92444,43750,48694,71755,4945,360,129,0,9471,5784,413,5371,1232,91212,0.5635,23834,26111,40071,23556,18975,13262,18355,-666666666,13717,17086,72,061
"Gurabo Municipio, Puerto Rico",46990,22315,24675,30863,6501,55,82,0,8397,1092,296,796,699,46291,0.5176,16238,16718,20656,16201,14167,15540,11378,-666666666,14591,28058,72,063
"Hatillo Municipio, Puerto Rico",41327,19913,21414,40183,304,0,15,0,353,472,193,279,77,41250,0.4953,10116,10180,,10131,10910,-666666666,,-666666666,8454,5511,72,065
"Hormigueros Municipio, Puerto Rico",16678,7732,8946,5945,325,0,75,0,7824,2509,214,2295,93,16585,0.4645,11432,11764,22405,11352,37102,-666666666,28933,-666666666,9895,11590,72,067
"Humacao Municipio, Puerto Rico",55621,26358,29263,32215,7256,203,435,0,14662,850,239,611,618,55003,0.5091,10994,11985,30399,10831,9945,9735,3714,-666666666,9524,11795,72,069
"Isabela Municipio, Puerto Rico",43919,21399,22520,30811,2532,109,0,0,9516,951,117,834,609,43310,0.5128,8578,8991,15217,8533,10133,,-666666666,-666666666,6910,8340,72,071
"Jayuya Municipio, Puerto Rico",15605,7778,7827,13508,114,40,20,0,1267,656,78,578,25,15580,0.4783,7258,7165,,7253,7223,6958,,-666666666,7565,8818,72,073
"Juncos Municipio, Puerto Rico",39942,19073,20869,25582,1889,7,0,0,12299,165,0,165,234,39708,0.4765,9282,9248,3450,9311,12870,,-666666666,-666666666,8896,2726,72,077
"Lajas Municipio, Puerto Rico",24323,11859,12464,14999,474,47,0,0,8261,542,395,147,29,24294,0.5427,7097,7705,,7106,9445,,-666666666,-666666666,5402,13897,72,079
"Lares Municipio, Puerto Rico",28052,13847,14205,22103,229,10,32,0,5380,298,9,289,148,27904,0.5649,7958,7670,10492,7943,15227,,,-666666666,8691,11565,72,081
"Las Piedras Municipio, Puerto Rico",38466,18571,19895,24572,11955,0,138,0,1200,601,69,532,155,38311,0.5179,9906,9752,25121,9881,10275,-666666666,,-666666666,11321,8045,72,085
"Luquillo Municipio, Puerto Rico",19237,9053,10184,11206,1656,61,109,0,5930,275,100,175,304,18933,0.5053,10617,11242,32388,10368,11928,6620,18767,-666666666,8364,23499,72,089
"Maricao Municipio, Puerto Rico",6274,3115,3159,3706,175,0,0,0,2233,160,77,83,11,6263,0.4907,5663,6162,,5673,7320,-666666666,-666666666,-666666666,4853,3576,72,093
"Maunabo Municipio, Puerto Rico",11506,5678,5828,5135,5544,10,0,0,473,344,106,238,143,11363,0.4751,8552,7901,,8656,9351,,-666666666,-666666666,7489,6850,72,095
"Moca Municipio, Puerto Rico",38289,18759,19530,27908,1246,92,24,18,6857,2144,67,2077,336,37953,0.5096,7621,7261,13849,7607,7901,,,,9112,7332,72,099
"Morovis Municipio, Puerto Rico",32087,15954,16133,29699,331,35,32,0,1320,670,136,534,73,32014,0.4911,8294,8270,,8293,12490,,,-666666666,7778,8060,72,101
"Naguabo Municipio, Puerto Rico",26722,12636,14086,17108,1321,0,291,0,7728,274,37,237,111,26611,0.5218,9809,8636,23004,9750,9173,-666666666,,-666666666,12897,7285,72,103
"Naranjito Municipio, Puerto Rico",29467,14543,14924,21563,1842,11,11,0,1437,4603,281,4322,84,29383,0.5228,9886,9990,,9911,9184,,,-666666666,9447,9864,72,105
"Orocovis Municipio, Puerto Rico",22258,11187,11071,18931,480,0,0,0,1960,887,40,847,46,22212,0.4902,7187,7560,,7176,5522,-666666666,-666666666,-666666666,4966,5045,72,107
"Patillas Municipio, Puerto Rico",18135,8909,9226,9237,7449,146,0,12,1242,49,26,23,47,18088,0.5208,8127,7845,,8139,8506,1861,-666666666,,8247,21310,72,109
"Ponce Municipio, Puerto Rico",152594,73452,79142,120260,7851,193,178,0,7917,16195,584,15611,1256,151338,0.5807,10587,11042,15499,10555,8864,4662,15242,-666666666,10071,8320,72,113
"Quebradillas Municipio, Puerto Rico",24904,12078,12826,19028,1241,63,28,0,4333,211,12,199,247,24657,0.5197,8499,8923,22245,8388,8589,3195,,-666666666,6601,9435,72,115
"Sabana Grande Municipio, Puerto Rico",24013,11376,12637,19023,611,73,0,0,3771,535,134,401,173,23840,0.5205,8638,8352,15075,8592,9453,12181,-666666666,-666666666,9803,9199,72,121
"Salinas Municipio, Puerto Rico",29722,14417,15305,17140,5897,61,129,0,6066,429,74,355,215,29507,0.4806,8535,8511,,8563,8298,,6119,-666666666,8672,8150,72,123
"San Juan Municipio, Puerto Rico",363744,166874,196870,254499,47193,1847,2103,33,36438,21631,3288,18343,6728,357016,0.6150,17348,19473,30315,17200,12208,11690,10629,,11890,13912,72,127
"San Lorenzo Municipio, Puerto Rico",39283,19209,20074,33426,2587,46,24,0,616,2584,188,2396,63,39220,0.5438,10671,10303,,10679,11649,,,-666666666,11412,14313,72,129
"Santa Isabel Municipio, Puerto Rico",22732,10991,11741,13377,4460,29,0,0,4678,188,27,161,80,22652,0.5378,9545,9840,,9570,9248,,-666666666,-666666666,9078,7700,72,133
"Toa Alta Municipio, Puerto Rico",74467,35897,38570,55277,5991,181,267,14,4274,8463,359,8104,559,73908,0.4889,13816,14016,9868,13843,12904,5206,8710,,11854,14518,72,135
"Toa Baja Municipio, Puerto Rico",83645,39379,44266,45490,6894,140,42,7,6872,24200,451,23749,600,83045,0.4756,12008,12921,26413,11953,10638,21764,6288,,10779,10988,72,137
"Trujillo Alto Municipio, Puerto Rico",70737,33423,37314,53033,6236,121,0,12,4379,6956,374,6582,481,70256,0.4949,15760,16220,28902,15671,14499,7661,-666666666,,15665,13606,72,139
"Utuado Municipio, Puerto Rico",30869,15045,15824,24013,618,49,295,0,5149,745,301,444,126,30743,0.4985,7841,7723,10172,7836,8864,,2474,-666666666,8113,11440,72,141
"Vega Alta Municipio, Puerto Rico",39018,18596,20422,31018,3874,32,89,0,2295,1710,175,1535,607,38411,0.5549,10448,10701,14943,10415,9015,,3431,-666666666,9989,10025,72,143
"Vega Baja Municipio, Puerto Rico",55866,26869,28997,50186,2125,156,60,34,2602,703,313,390,1925,53941,0.5344,9632,9186,5752,9755,11205,13654,,,15396,11506,72,145
"Vieques Municipio, Puerto Rico",9046,4551,4495,4347,1113,113,176,0,3133,164,0,164,329,8717,0.4036,9808,11690,26007,9310,6772,3747,,-666666666,9263,5057,72,147
"Villalba Municipio, Puerto Rico",24186,11806,12380,13024,854,24,10,0,2813,7461,144,7317,13,24173,0.4569,8733,9355,5822,8733,10711,,,-666666666,7990,7718,72,149
"Yabucoa Municipio, Puerto Rico",35670,17329,18341,19428,13014,91,9,0,2683,445,87,358,40,35630,0.4925,8531,8792,,8532,8039,9562,,-666666666,9182,7182,72,151
"Yauco Municipio, Puerto Rico",38519,18540,19979,32403,1196,127,6,0,3888,899,281,618,136,38383,0.5380,7998,8070,31959,7917,9750,7333,,-666666666,7153,6820,72,153
"Peñuelas Municipio, Puerto Rico",22231,10825,11406,18642,713,28,35,0,2464,349,110,239,78,22153,0.4662,7581,7652,2412,7599,7528,11696,,-666666666,6568,11160,72,111
"Rincón Municipio, Puerto Rico",14700,7108,7592,8561,205,0,27,0,327,5580,26,5554,1418,13282,0.4791,9445,10174,12258,9062,10617,-666666666,,-666666666,11736,8143,72,117
"Añasco Municipio, Puerto Rico",28250,13706,14544,16464,1030,0,33,1,7009,3713,103,3610,582,27668,0.4620,8673,8913,14134,8565,8595,-666666666,,,8259,8459,72,011
"Las Marías Municipio, Puerto Rico",9093,4507,4586,6680,57,14,0,0,2311,31,10,21,97,8996,0.5280,6730,6978,6007,6738,6225,,-666666666,-666666666,6069,6468,72,083
"Guánica Municipio, Puerto Rico",17788,8577,9211,13817,475,19,0,0,3096,381,106,275,56,17732,0.5258,7223,7401,2525,7238,19884,15616,-666666666,-666666666,4268,8563,72,055
"Mayagüez Municipio, Puerto Rico",81594,39059,42535,34603,3017,244,42,6,35524,8158,836,7322,728,80866,0.6008,10133,12275,44500,9901,14894,2479,24357,,7658,10226,72,097
"Comerío Municipio, Puerto Rico",20153,10022,10131,13695,1173,59,16,0,1745,3465,42,3423,92,20061,0.5474,6975,7514,14989,6950,8535,5581,,-666666666,7295,4213,72,045
"San Germán Municipio, Puerto Rico",33546,16312,17234,24897,728,22,0,0,7571,328,183,145,142,33404,0.5376,9445,9850,18046,9407,8959,,-666666666,-666666666,8012,10911,72,125
"Loíza Municipio, Puerto Rico",27857,13031,14826,6595,9956,40,78,0,10885,303,164,139,60,27797,0.5091,8694,10967,,8689,8639,,12521,-666666666,7242,11846,72,087
"San Sebastián Municipio, Puerto Rico",39755,19358,20397,31919,876,0,34,0,6283,643,118,525,366,39389,0.5132,7578,7642,20671,7481,8830,-666666666,,-666666666,6853,9319,72,131
"Cataño Municipio, Puerto Rico",26137,12382,13755,16885,2575,16,69,0,4861,1731,156,1575,218,25919,0.5633,11039,12446,24588,10991,10526,,8486,-666666666,7961,6924,72,033
"Manatí Municipio, Puerto Rico",41468,19651,21817,35530,1737,38,17,0,3820,326,109,217,549,40919,0.5171,10216,10278,7114,10244,11277,6768,,-666666666,9147,10790,72,091
"Juana Díaz Municipio, Puerto Rico",48658,23302,25356,25245,5234,8,52,0,4232,13887,205,13682,136,48522,0.4996,10053,10778,11314,10051,8648,,,-666666666,11410,8869,72,075
"Río Grande Municipio, Puerto Rico",52479,25534,26945,27604,6941,76,180,0,16202,1476,334,1142,280,52199,0.4561,10648,11206,12421,10629,11483,5480,11965,-666666666,9606,7818,72,119
"Bayamón Municipio, Puerto Rico",192974,91526,101448,120384,14050,1216,429,16,14289,42590,1196,41394,1823,191151,0.4936,13472,14419,14771,13437,13422,6898,11759,,10823,11909,72,021
"Canóvanas Municipio, Puerto Rico",47174,22812,24362,23000,6165,19,173,0,17559,258,45,213,108,47066,0.5092,10664,11982,,10651,11351,,11866,-666666666,8753,6001,72,029