NAME,B01003_001E,B01001_002E,B01001_026E,B02001_002E,B02001_003E,B02001_004E,B02001_005E,B02001_006E,B02001_007E,B02001_008E,B02001_009E,B02001_010E,B03003_001E,B03003_002E,B03003_003E,B19083_001E,B19083_001M,B19301_001E,B19301A_001E,B19301H_001E,B19301I_001E,B19301B_001E,B19301C_001E,B19301D_001E,B19301E_001E,B19301F_001E,B19301G_001E,state,county
"Washington County, Mississippi",47086,22018,25068,12097,33982,56,282,0,391,278,74,204,47086,46357,729,0.5328,0.0241,19884,33274,31644,44672,15031,34279,34193,-666666666,16376,17975,28,151
"Perry County, Mississippi",12028,5845,6183,9475,2368,0,17,0,16,152,5,147,12028,11847,181,0.4818,0.0517,21611,22803,23155,4721,16900,-666666666,,-666666666,,16319,28,111
"Choctaw County, Mississippi",8321,4174,4147,5631,2596,23,15,8,13,35,0,35,8321,8288,33,0.4432,0.0249,20589,24903,24886,16485,11369,34804,,,,9486,28,019
"Itawamba County, Mississippi",23480,11821,11659,21346,1681,75,57,7,170,144,12,132,23480,23120,360,0.4299,0.0246,20629,21406,21477,14814,13690,6755,,,17314,6221,28,057
"Carroll County, Mississippi",10129,5116,5013,6523,3503,6,0,0,0,97,15,82,10129,10100,29,0.4489,0.0319,22567,27585,27636,,13420,,-666666666,-666666666,-666666666,14429,28,015
"Grenada County, Mississippi",21278,10103,11175,11736,9238,135,23,0,16,130,0,130,21278,21138,140,0.4787,0.0280,21668,25806,25857,20711,16700,8310,,-666666666,,17823,28,043
"Jefferson County, Mississippi",7346,3642,3704,979,6310,11,33,0,7,6,0,6,7346,7318,28,0.4982,0.0484,13374,27214,27676,,10943,,5127,-666666666,,,28,063
"Greene County, Mississippi",13714,8294,5420,10054,3496,53,0,0,4,107,2,105,13714,13552,162,0.4116,0.0350,17453,20991,21201,10773,7515,18168,-666666666,-666666666,,5207,28,041
"Marshall County, Mississippi",35787,17736,18051,17657,17134,15,24,0,640,317,0,317,35787,34506,1281,0.4503,0.0283,21352,25307,25598,17113,17423,21380,,-666666666,17557,21953,28,093
"Quitman County, Mississippi",7372,3476,3896,2027,5282,0,5,0,40,18,5,13,7372,7265,107,0.4690,0.0212,15353,22323,22550,10263,12695,-666666666,,-666666666,,,28,119
"Bolivar County, Mississippi",32592,15365,17227,10803,20941,41,213,0,363,231,33,198,32592,31891,701,0.5149,0.0254,17713,29241,28347,31752,11849,9854,29322,-666666666,12441,9178,28,011
"Lamar County, Mississippi",61223,29243,31980,46763,12240,80,780,0,340,1020,57,963,61223,59622,1601,0.4588,0.0249,28934,31815,32311,13780,18865,19074,28033,-666666666,15072,23757,28,073
"Lee County, Mississippi",84915,40526,44389,57379,24653,206,720,6,910,1041,219,822,84915,82687,2228,0.4701,0.0176,25467,29747,30084,12800,16888,11788,23671,,12065,8340,28,081
"Pike County, Mississippi",39737,18836,20901,17695,21263,153,239,4,103,280,0,280,39737,39051,686,0.5263,0.0281,17954,24250,24530,12604,12525,,45946,,21962,15664,28,113
"Tallahatchie County, Mississippi",14361,8012,6349,5082,7089,22,206,13,1915,34,30,4,14361,12383,1978,0.5138,0.0396,14943,25701,25931,,11670,,3200,,,,28,135
"Smith County, Mississippi",16063,7847,8216,12182,3706,0,69,30,4,72,0,72,16063,15793,270,0.4772,0.0417,23164,26031,26422,8800,13036,-666666666,94449,,,,28,129
"Stone County, Mississippi",18375,9367,9008,14373,3544,66,0,20,0,372,10,362,18375,18002,373,0.4449,0.0484,21931,24651,24948,13155,12930,16680,-666666666,,-666666666,4729,28,131
"Warren County, Mississippi",47075,22428,24647,22859,23138,105,241,9,160,563,39,524,47075,46052,1023,0.4663,0.0185,23793,32395,32636,19548,15567,64708,31635,,11051,5620,28,149
"Clarke County, Mississippi",15928,7443,8485,10113,5696,10,0,0,44,65,11,54,15928,15862,66,0.4762,0.0296,22422,27700,27729,,13160,,-666666666,-666666666,35291,6489,28,023
"Kemper County, Mississippi",10107,5170,4937,3571,6156,370,0,0,0,10,0,10,10107,9975,132,0.4562,0.0347,15518,21958,22703,,12098,10167,-666666666,-666666666,-666666666,,28,069
"Montgomery County, Mississippi",10198,4769,5429,5398,4428,0,34,0,45,293,2,291,10198,10063,135,0.5035,0.0600,22913,30572,30841,15253,14564,-666666666,,-666666666,18907,11277,28,097
"Oktibbeha County, Mississippi",49481,24863,24618,28538,18344,47,1546,20,170,816,29,787,49481,48663,818,0.5347,0.0188,22136,27741,27951,18587,13659,22547,24320,,20072,12848,28,105
"Pearl River County, Mississippi",55149,27263,27886,46341,7046,87,183,0,427,1065,95,970,55149,53476,1673,0.4342,0.0163,23135,24909,25080,16262,12387,,26523,-666666666,14266,20395,28,109
"Leake County, Mississippi",22870,11533,11337,11754,9608,1289,85,0,17,117,0,117,22870,21835,1035,0.4705,0.0205,17960,22488,24085,6598,13428,12654,10958,-666666666,,,28,079
"Noxubee County, Mississippi",10828,5127,5701,2940,7820,9,4,0,7,48,0,48,10828,10680,148,0.4659,0.0351,17637,25550,26615,4614,14753,,,-666666666,,,28,103
"Neshoba County, Mississippi",29376,13988,15388,17673,6196,4754,136,8,44,565,9,556,29376,28777,599,0.4700,0.0199,19641,23115,23553,9010,14142,15447,14582,,,7959,28,099
"Rankin County, Mississippi",151240,73041,78199,115013,31003,225,1738,41,1380,1840,132,1708,151240,147099,4141,0.4076,0.0109,29874,32637,32820,21486,20480,27677,34622,,19618,18185,28,121
"Tate County, Mississippi",28493,13828,14665,18908,8352,40,52,51,232,858,32,826,28493,27733,760,0.4373,0.0291,23542,27587,27978,14526,15368,89228,13965,,16369,13872,28,137
"Lawrence County, Mississippi",12630,6130,6500,8259,4193,10,16,0,55,97,0,97,12630,12551,79,0.4495,0.0253,21809,24721,24761,5142,16595,21200,,-666666666,,8739,28,077
"Panola County, Mississippi",34243,16549,17694,16645,17101,59,6,11,87,334,0,334,34243,33550,693,0.4598,0.0239,19972,26882,27362,12716,13668,,,,,2609,28,107
"Yalobusha County, Mississippi",12421,6085,6336,7220,5054,44,8,0,70,25,0,25,12421,12223,198,0.4005,0.0283,21140,24364,24363,23069,16210,,,-666666666,,,28,161
"Chickasaw County, Mississippi",17279,8331,8948,9063,7505,21,12,0,255,423,64,359,17279,16464,815,0.4621,0.0218,19556,25292,26065,8511,13574,,,-666666666,8068,9884,28,017
"Copiah County, Mississippi",28721,13704,15017,13047,14895,9,92,0,405,273,118,155,28721,27811,910,0.4556,0.0250,19434,27957,28474,12337,12348,,13982,-666666666,13704,9035,28,029
"George County, Mississippi",23710,12008,11702,21185,1908,227,98,0,149,143,9,134,23710,23058,652,0.4442,0.0395,21105,22345,22723,7300,10531,,18204,-666666666,4318,15430,28,039
"Hinds County, Mississippi",241774,112877,128897,62129,174698,264,1897,53,1235,1498,84,1414,241774,238033,3741,0.4732,0.0105,23114,37866,38482,15283,17981,27210,24569,37892,9693,17837,28,049
"Newton County, Mississippi",21524,10142,11382,13436,6519,1109,110,0,64,286,77,209,21524,21122,402,0.5074,0.0626,21600,26867,27212,9601,13703,9241,15516,-666666666,9083,7213,28,101
"Union County, Mississippi",28356,13942,14414,22687,4172,17,112,49,705,614,19,595,28356,27148,1208,0.4214,0.0181,20088,21491,21719,14356,15019,7047,,,17133,8833,28,145
"Sharkey County, Mississippi",4511,2147,2364,1132,3337,6,28,0,8,0,0,0,4511,4506,5,0.4779,0.0363,17877,33461,33461,,12664,,,-666666666,,-666666666,28,125
"Tippah County, Mississippi",21990,10673,11317,17301,3755,17,82,12,522,301,86,215,21990,20967,1023,0.4444,0.0264,20180,22248,22484,12107,12904,,,,12547,11290,28,139
"Forrest County, Mississippi",75517,35944,39573,44901,27900,132,678,31,178,1697,85,1612,75517,73271,2246,0.4891,0.0250,22042,26942,27416,15408,15361,6823,11406,2406,10058,9302,28,035
"Hancock County, Mississippi",46653,22779,23874,40709,3776,272,332,0,385,1179,102,1077,46653,44861,1792,0.4495,0.0261,26659,28033,28160,22043,17498,16378,26430,-666666666,32689,9031,28,045
"Lafayette County, Mississippi",53459,25974,27485,38345,12726,82,1117,17,550,622,85,537,53459,52048,1411,0.5105,0.0213,26154,29399,29750,19968,17483,,21635,,25885,14576,28,071
"Issaquena County, Mississippi",1328,807,521,521,799,0,0,0,8,0,0,0,1328,1312,16,0.5841,0.1425,18942,21566,21903,,17385,-666666666,-666666666,-666666666,,-666666666,28,055
"Lowndes County, Mississippi",59437,28365,31072,31869,25961,113,539,17,182,756,42,714,59437,58225,1212,0.4665,0.0173,24499,31952,32382,18611,15693,22154,27792,,15826,13183,28,087
"Leflore County, Mississippi",29804,13916,15888,7209,21859,0,183,0,302,251,0,251,29804,29018,786,0.5765,0.0362,16861,33977,35798,17542,10959,-666666666,20168,-666666666,29615,21414,28,083
"Wilkinson County, Mississippi",8990,4816,4174,2517,6402,0,7,0,30,34,0,34,8990,8953,37,0.4697,0.0454,13231,22128,22203,,9830,-666666666,,-666666666,,,28,157
"Harrison County, Mississippi",202626,99750,102876,138089,49879,1122,5721,84,2070,5661,332,5329,202626,191594,11032,0.4581,0.0102,24445,27345,27889,18816,17366,25126,24948,15598,20802,16889,28,047
"Jefferson Davis County, Mississippi",11495,5543,5952,4360,7036,0,20,0,11,68,0,68,11495,11461,34,0.5017,0.0282,19233,25401,25467,,15174,-666666666,,-666666666,,34538,28,065
"Lincoln County, Mississippi",34432,16255,18177,23505,10700,4,160,0,0,63,0,63,34432,34057,375,0.4756,0.0220,21892,25974,26200,13085,13101,,12733,-666666666,-666666666,,28,085
"Scott County, Mississippi",28415,13870,14545,16565,10889,136,84,0,610,131,0,131,28415,25267,3148,0.5323,0.0458,21640,26973,29754,12118,14012,11133,50880,-666666666,15126,3848,28,123
"Winston County, Mississippi",18358,8942,9416,9241,8769,112,6,0,135,95,8,87,18358,18133,225,0.5283,0.0574,24538,32812,32913,8168,16281,17907,,-666666666,,,28,159
"Yazoo County, Mississippi",27974,15543,12431,10583,15929,143,120,0,554,645,122,523,27974,26169,1805,0.5377,0.0510,18866,23177,23830,9138,16998,13753,25210,-666666666,3355,7561,28,163
"Benton County, Mississippi",8253,4122,4131,5058,2956,0,0,0,104,135,21,114,8253,8040,213,0.4742,0.0498,20363,21671,21778,11770,19154,-666666666,-666666666,-666666666,12125,4183,28,009
"Franklin County, Mississippi",7757,3706,4051,4926,2793,0,3,0,2,33,0,33,7757,7706,51,0.4643,0.0280,22769,26316,26461,,16690,-666666666,,-666666666,,,28,037
"Jasper County, Mississippi",16529,8048,8481,7408,8997,1,0,0,57,66,0,66,16529,16465,64,0.4846,0.0298,21929,31420,31420,37408,14399,,-666666666,-666666666,,2232,28,061
"Jones County, Mississippi",68454,33352,35102,47003,19989,159,231,36,288,748,29,719,68454,65461,2993,0.4783,0.0200,22836,27209,28019,13014,13121,15578,42265,,7500,8697,28,067
"Monroe County, Mississippi",35840,17107,18733,24396,11070,9,30,0,14,321,0,321,35840,35402,438,0.4685,0.0200,23158,26348,26515,16068,16711,,16793,-666666666,,4952,28,095
"Sunflower County, Mississippi",26532,13927,12605,6638,19623,113,21,0,51,86,9,77,26532,26075,457,0.5042,0.0206,15464,27082,28129,7096,11576,11796,6952,-666666666,11831,14750,28,133
"Webster County, Mississippi",9828,4788,5040,7805,1895,9,14,0,6,99,6,93,9828,9684,144,0.4588,0.0306,21109,23016,23241,9949,13913,,18536,-666666666,,11065,28,155
"Adams County, Mississippi",31547,16217,15330,12782,17855,75,183,0,225,427,55,372,31547,29771,1776,0.5368,0.0241,17851,25227,27943,3366,13154,6993,5827,-666666666,,9896,28,001
"Clay County, Mississippi",19808,9177,10631,7845,11807,59,26,0,0,71,0,71,19808,19671,137,0.4919,0.0362,21076,30597,30859,,14911,,,-666666666,-666666666,13220,28,025
"Covington County, Mississippi",19091,9252,9839,11656,7215,0,28,17,0,175,0,175,19091,18999,92,0.4355,0.0287,18353,22125,21899,52954,12377,-666666666,,,-666666666,6480,28,031
"Humphreys County, Mississippi",8539,3990,4549,1848,6489,14,6,3,179,0,0,0,8539,8272,267,0.5034,0.0298,16604,32546,33369,17679,11846,,59233,,22003,-666666666,28,053
"Saline County, Missouri",23102,11559,11543,19781,1090,87,204,247,826,867,206,661,23102,20806,2296,0.4354,0.0251,22802,24501,25056,12564,14987,45631,19028,5322,8926,10661,29,195
"Madison County, Missouri",12205,6049,6156,11852,123,34,30,0,0,166,0,166,12205,11914,291,0.4373,0.0338,22119,22455,22485,21268,,21215,45840,-666666666,-666666666,4273,29,123
"Wright County, Missouri",18293,9029,9264,17629,105,68,88,0,187,216,0,216,18293,17969,324,0.4908,0.0305,19909,18955,19088,9770,131513,9104,125239,-666666666,15228,8012,29,229
"Vernon County, Missouri",20691,10088,10603,19771,184,127,138,0,33,438,25,413,20691,20257,434,0.4589,0.0599,24388,24906,25079,13913,9022,20260,21259,-666666666,43600,8232,29,217
"Nodaway County, Missouri",22547,11225,11322,21111,637,47,310,29,107,306,52,254,22547,22173,374,0.4591,0.0238,22151,22710,22861,6369,16069,5289,15987,,4791,10272,29,147
"Chariton County, Missouri",7546,3764,3782,7212,183,7,0,0,0,144,0,144,7546,7508,38,0.4478,0.0288,24470,25122,25135,25668,13849,,-666666666,-666666666,-666666666,5611,29,041
"Grundy County, Missouri",10039,4906,5133,9618,52,130,36,19,34,150,20,130,10039,9804,235,0.4361,0.0391,23249,23786,23857,16086,3746,23485,1267,,9382,5440,29,079
"Morgan County, Missouri",20137,9945,10192,19279,161,100,183,0,143,271,2,269,20137,19691,446,0.4666,0.0385,21265,21750,21871,9698,14361,,9130,-666666666,,16809,29,141
"Wayne County, Missouri",13308,6544,6764,12868,74,51,45,0,1,269,8,261,13308,13078,230,0.4427,0.0336,18759,18922,18981,15210,34354,23880,10929,-666666666,,7055,29,223
"Bollinger County, Missouri",12281,6140,6141,11970,68,100,41,0,0,102,0,102,12281,12145,136,0.4113,0.0247,20949,21019,21087,15096,4559,26291,18046,-666666666,-666666666,19633,29,017
"Cape Girardeau County, Missouri",78324,37932,40392,68709,5894,153,1244,25,199,2100,118,1982,78324,76536,1788,0.4552,0.0222,26546,28132,28141,22333,17054,55308,11246,,23348,8877,29,031
"Shelby County, Missouri",6061,3047,3014,5868,117,5,9,0,14,48,20,28,6061,5945,116,0.4211,0.0235,23501,24053,24253,9973,5108,,21478,-666666666,,3106,29,205
"Webster County, Missouri",38082,19436,18646,36436,437,175,142,71,174,647,90,557,38082,37317,765,0.4132,0.0217,21682,21709,21882,12487,15275,34491,23383,,24846,22202,29,225
"Atchison County, Missouri",5270,2615,2655,5150,20,26,21,0,15,38,0,38,5270,5204,66,0.4172,0.0190,29009,29137,29105,38086,20885,16515,7848,-666666666,57793,24834,29,005
"Bates County, Missouri",16374,8014,8360,15637,238,100,37,8,115,239,24,215,16374,16022,352,0.4537,0.0590,27035,27707,27940,10659,15696,12114,17419,,10400,10550,29,013
"Benton County, Missouri",18989,9354,9635,18259,54,206,13,10,42,405,16,389,18989,18613,376,0.4870,0.0582,23984,24446,24597,8634,16528,14237,,,,11629,29,015
"Carter County, Missouri",6197,3010,3187,5900,3,60,0,0,0,234,5,229,6197,6049,148,0.4526,0.0346,21884,22626,22740,8751,,11468,-666666666,-666666666,-666666666,6032,29,035
"Dade County, Missouri",7590,3884,3706,7236,21,67,11,5,40,210,4,206,7590,7434,156,0.4078,0.0192,21538,21796,21944,15644,,11933,,,24903,17640,29,057
"Linn County, Missouri",12186,5861,6325,11783,70,19,36,5,39,234,17,217,12186,11916,270,0.4190,0.0309,24150,24221,24376,25037,14831,14079,57939,,77636,10357,29,115
"Howell County, Missouri",40102,19640,20462,38602,188,216,178,0,32,886,0,886,40102,39254,848,0.4693,0.0192,20873,20750,20846,15236,6101,32529,52989,-666666666,,20599,29,091
"Johnson County, Missouri",53689,27715,25974,47847,2329,281,936,168,286,1842,65,1777,53689,51429,2260,0.3886,0.0164,24146,24989,25177,20072,18487,17081,19138,16005,28724,13064,29,101
"Laclede County, Missouri",35507,17578,17929,33803,196,273,117,6,106,1006,111,895,35507,34661,846,0.4087,0.0211,21577,21569,21810,16673,19349,26084,13241,,48437,19207,29,105
"Maries County, Missouri",8884,4449,4435,8732,21,73,22,0,0,36,0,36,8884,8651,233,0.4332,0.0290,23729,23958,24102,18698,9448,10996,,-666666666,-666666666,11211,29,125
"Phelps County, Missouri",44789,23541,21248,40575,1206,375,1683,0,117,833,3,830,44789,43684,1105,0.4832,0.0162,24304,24826,24848,20010,10773,24292,27992,-666666666,12156,12750,29,161
"Platte County, Missouri",98824,48720,50104,84678,6636,410,2676,77,887,3460,272,3188,98824,93003,5821,0.4291,0.0157,39427,41482,42347,26111,30306,44774,30577,18694,28341,16153,29,165
"St. Francois County, Missouri",66342,35900,30442,61654,2955,204,342,0,177,1010,154,856,66342,65320,1022,0.4278,0.0164,22575,23157,23065,33847,10759,27587,25399,-666666666,10199,21845,29,187
"Andrew County, Missouri",17403,8720,8683,16646,349,29,50,103,22,204,36,168,17403,16990,413,0.4149,0.0186,28027,28487,28512,21833,18250,37752,22038,,,10407,29,003
"Carroll County, Missouri",8843,4330,4513,8457,200,21,19,0,17,129,0,129,8843,8705,138,0.4603,0.0215,24597,25293,25312,21379,12275,,,-666666666,12424,6806,29,033
"Daviess County, Missouri",8302,4187,4115,8066,85,27,12,6,25,81,3,78,8302,8173,129,0.4196,0.0220,24081,24442,24570,15878,9989,13074,15983,,26784,8810,29,061
"Knox County, Missouri",3951,1989,1962,3812,21,0,18,18,20,62,7,55,3951,3911,40,0.4607,0.0635,22020,22451,22472,6833,15429,-666666666,,,8630,8319,29,103
"Marion County, Missouri",28672,13745,14927,26266,1167,110,201,54,69,805,0,805,28672,28177,495,0.4258,0.0154,23589,24195,24311,15143,20836,12370,34155,,23871,5287,29,127
"Osage County, Missouri",13619,7076,6543,13333,39,91,9,0,51,96,22,74,13619,13511,108,0.3756,0.0214,26037,26329,26225,35916,6023,24522,,-666666666,,4047,29,151
"Ripley County, Missouri",13693,6817,6876,13184,52,64,33,33,30,297,23,274,13693,13509,184,0.4270,0.0281,17502,17675,17875,4883,,15314,32527,,,13074,29,181
"Warren County, Missouri",33908,16714,17194,31694,707,88,213,32,495,679,18,661,33908,32790,1118,0.4258,0.0220,27523,28511,28481,20175,10142,42556,28634,,9592,11400,29,219
"Audrain County, Missouri",25735,11768,13967,22929,1569,103,46,23,129,936,166,770,25735,24968,767,0.4391,0.0334,21819,22929,23274,9680,14444,9751,16187,24574,11491,9958,29,007
"Christian County, Missouri",84275,40995,43280,80364,676,510,497,44,383,1801,105,1696,84275,81859,2416,0.4090,0.0158,27024,27553,27736,16160,10445,21156,24784,,11061,15218,29,043
"Greene County, Missouri",288429,140366,148063,260190,9482,1415,5573,208,2911,8650,513,8137,288429,277999,10430,0.4659,0.0079,26378,27453,27625,18148,14387,31831,22459,17990,13138,13469,29,077
"Harrison County, Missouri",8554,4263,4291,8236,76,14,8,0,85,135,10,125,8554,8369,185,0.4018,0.0163,20986,21484,21627,7252,6089,18179,16313,-666666666,,8433,29,081
"St. Clair County, Missouri",9383,4663,4720,8978,70,69,19,0,5,242,0,242,9383,9264,119,0.4333,0.0226,22672,23048,23153,16367,7471,4564,,-666666666,,19184,29,185
"Adair County, Missouri",25325,12215,13110,23100,870,52,608,63,71,561,100,461,25325,24988,337,0.5131,0.0349,22000,22574,22703,11466,16010,11902,13784,,67394,7377,29,001
"Scotland County, Missouri",4898,2399,2499,4772,79,0,0,0,0,47,0,47,4898,4898,0,0.4938,0.0490,23809,24255,24255,-666666666,1030,-666666666,-666666666,-666666666,-666666666,16796,29,199
"Sullivan County, Missouri",6317,3052,3265,5773,184,43,6,12,222,77,2,75,6317,5167,1150,0.4110,0.0412,21661,21585,22355,18404,29632,10093,,,19504,23816,29,211
"Clark County, Missouri",6800,3447,3353,6598,23,24,28,0,0,127,0,127,6800,6787,13,0.4590,0.0439,28537,29056,29056,,11404,29146,,-666666666,-666666666,10898,29,045
"Jefferson County, Missouri",223302,110887,112415,214439,2034,652,1646,43,539,3949,278,3671,223302,219051,4251,0.3890,0.0088,28844,29120,29221,20687,19436,65249,30940,30593,11449,14177,29,099
"Lewis County, Missouri",10027,5100,4927,9454,330,77,2,11,0,153,15,138,10027,9850,177,0.4233,0.0249,22602,23116,23259,15268,20444,5783,,2736,-666666666,5492,29,111
"New Madrid County, Missouri",17811,8558,9253,14505,2802,68,5,0,28,403,15,388,17811,17492,319,0.4543,0.0205,20638,22388,22530,14256,14187,,,-666666666,15539,5692,29,143
"Perry County, Missouri",19146,9457,9689,18623,56,79,133,0,42,213,0,213,19146,18718,428,0.3754,0.0152,24710,25003,25166,18701,7068,15948,19083,-666666666,,12815,29,157
"Ralls County, Missouri",10217,5178,5039,9875,137,54,52,2,11,86,0,86,10217,10091,126,0.3961,0.0417,26536,26822,26944,16330,23142,21811,25613,,,6415,29,173
"Ray County, Missouri",22825,11357,11468,21883,395,114,38,1,51,343,31,312,22825,22278,547,0.4056,0.0166,27768,28199,28481,14394,13492,26651,75716,,5712,15130,29,177
"St. Louis County, Missouri",998684,473610,525074,682964,240312,1821,41601,290,8054,23642,1134,22508,998684,970381,28303,0.4904,0.0043,39784,46700,47134,27672,21835,27841,47019,33148,20522,17267,29,189
"Stone County, Missouri",31527,15409,16118,30378,50,331,47,28,259,434,0,434,31527,30833,694,0.4607,0.0304,27792,28168,28391,17950,10462,19820,25183,,26159,11222,29,209
"Barry County, Missouri",35493,17823,17670,33210,57,286,404,0,488,1048,0,1048,35493,32231,3262,0.4506,0.0293,21960,22002,22962,12090,6189,15408,35251,-666666666,16872,20528,29,009
"Boone County, Missouri",176515,85827,90688,143130,15504,579,7886,217,1804,7395,354,7041,176515,170565,5950,0.4673,0.0105,29365,31386,31717,18415,19172,13411,30140,18997,21877,14178,29,019
"Cedar County, Missouri",13938,6961,6977,13447,6,5,38,31,31,380,31,349,13938,13638,300,0.4534,0.0426,22434,22864,23094,9284,,,,,,11522,29,039
"Crawford County, Missouri",24280,11969,12311,23477,70,0,34,0,153,546,0,546,24280,23808,472,0.4420,0.0222,21107,21414,21558,13002,8354,-666666666,44547,-666666666,16969,9229,29,055
"Iron County, Missouri",10221,5029,5192,9777,124,74,19,8,0,219,20,199,10221,10044,177,0.4317,0.0242,20696,20919,20835,21651,16639,9193,,,-666666666,13605,29,093
"Livingston County, Missouri",15076,6813,8263,14145,409,81,80,22,59,280,18,262,15076,14811,265,0.4268,0.0211,23083,23883,24166,2484,12596,20449,22986,,3758,4199,29,117
"Moniteau County, Missouri",15958,8413,7545,14779,601,89,28,0,192,269,6,263,15958,15222,736,0.4033,0.0231,22445,23397,23738,15401,4898,35244,,-666666666,20322,2433,29,135
"Oregon County, Missouri",10699,5376,5323,10220,16,156,44,27,41,195,0,195,10699,10515,184,0.4448,0.0263,18103,18112,18196,11087,,7892,,,7156,20367,29,149
"Dunklin County, Missouri",30428,14623,15805,25614,2961,121,131,4,917,680,21,659,30428,28443,1985,0.4807,0.0214,19818,21419,21888,7771,12620,8404,,,4902,15829,29,069
"Pettis County, Missouri",42371,20918,21453,38606,1335,59,193,0,895,1283,193,1090,42371,38696,3675,0.4351,0.0175,22897,23180,23840,13651,13473,36551,47055,-666666666,15485,25123,29,159
"Ste. Genevieve County, Missouri",17871,8979,8892,17277,316,0,102,0,20,156,0,156,17871,17668,203,0.3986,0.0229,28578,28962,28992,26599,11497,-666666666,44143,-666666666,31325,10035,29,186
"Randolph County, Missouri",24945,13102,11843,22485,1471,132,120,15,97,625,52,573,24945,24435,510,0.4243,0.0182,20836,21741,21895,12454,14470,8152,13978,,18330,7979,29,175
"Franklin County, Missouri",102781,51339,51442,98768,698,204,562,38,537,1974,266,1708,102781,101033,1748,0.4284,0.0140,28773,29027,29031,23465,21451,31350,37006,,19234,19017,29,071
"Howard County, Missouri",10113,5042,5071,9277,531,54,18,0,43,190,0,190,10113,9960,153,0.4010,0.0175,23328,24222,24309,13447,14483,16389,58650,-666666666,,6916,29,089
"Jackson County, Missouri",692003,334604,357399,461134,163422,2656,12844,1990,28316,21641,2291,19350,692003,630693,61310,0.4657,0.0053,30237,35285,36369,16427,21221,25599,25497,29179,13463,16187,29,095
"Miller County, Missouri",25049,12314,12735,24104,111,237,108,0,161,328,11,317,25049,24579,470,0.4493,0.0238,23408,24022,24187,9077,5349,12810,1735,-666666666,4628,8459,29,131
"Pulaski County, Missouri",52591,30025,22566,39219,6480,535,1447,160,2042,2708,272,2436,52591,46822,5769,0.3836,0.0216,22018,23024,23000,19633,20577,32369,23476,13550,18628,11138,29,169
"Putnam County, Missouri",4815,2389,2426,4640,13,9,30,0,0,123,0,123,4815,4808,7,0.4490,0.0444,22607,22788,22794,,,,29347,-666666666,-666666666,2967,29,171
"Taney County, Missouri",54720,26504,28216,50445,681,511,474,21,1239,1349,195,1154,54720,51567,3153,0.4165,0.0156,22106,22347,22739,13791,15440,16279,49095,,18189,12697,29,213
"Texas County, Missouri",25671,13397,12274,23880,579,573,121,0,60,458,5,453,25671,25132,539,0.4640,0.0316,19485,20038,20210,10530,4988,15871,42856,-666666666,,9438,29,215
"Buchanan County, Missouri",89076,44691,44385,77914,5019,294,918,208,1466,3257,281,2976,89076,83296,5780,0.4405,0.0133,25419,26270,26743,18868,19127,22890,40683,5247,23737,12724,29,021
"Caldwell County, Missouri",9049,4585,4464,8688,47,60,46,0,31,177,33,144,9049,8855,194,0.4107,0.0270,24238,24604,24561,22065,12717,27165,29202,-666666666,10932,9354,29,025
"Callaway County, Missouri",44840,22874,21966,41180,1932,232,391,225,140,740,67,673,44840,43921,919,0.3938,0.0147,25069,25998,26081,20676,11757,48648,16491,,2074,12044,29,027
"Cass County, Missouri",102678,50364,52314,93925,3713,630,825,37,707,2841,250,2591,102678,98260,4418,0.3982,0.0101,31675,31999,32268,25999,38088,28748,24078,30614,43169,12577,29,037
"Clinton County, Missouri",20475,10266,10209,19489,380,201,49,5,107,244,11,233,20475,20054,421,0.3921,0.0183,28216,28683,28600,29583,25881,17142,,,24619,9561,29,049
"Cooper County, Missouri",17622,9214,8408,15691,1123,50,47,13,113,585,58,527,17622,17285,337,0.4074,0.0137,22895,24397,24497,15734,10668,27178,9481,,16941,8270,29,053
"Dallas County, Missouri",16499,8212,8287,15908,8,176,67,0,33,307,2,305,16499,16165,334,0.4668,0.0542,22096,22349,22670,7545,,15794,34718,-666666666,22718,10290,29,059
"Gentry County, Missouri",6665,3218,3447,6495,46,21,39,4,12,48,0,48,6665,6566,99,0.4144,0.0229,21059,21208,21336,10591,12589,19257,32938,,,4460,29,075
"Hickory County, Missouri",9368,4551,4817,9015,9,155,8,4,41,136,0,136,9368,9217,151,0.4117,0.0189,20646,20958,20809,31517,3522,5441,,,27480,16970,29,085
"Lincoln County, Missouri",55563,27526,28037,52635,1061,153,214,15,431,1054,82,972,55563,54233,1330,0.4031,0.0144,25472,25994,26118,15124,19598,33785,15975,,7324,13800,29,113
"Mississippi County, Missouri",13748,7575,6173,10065,3322,131,7,6,6,211,17,194,13748,13466,282,0.4931,0.0347,18462,21252,21652,4207,10415,15659,,,,13233,29,133
"Monroe County, Missouri",8654,4402,4252,8195,306,18,38,15,0,82,4,78,8654,8512,142,0.4133,0.0380,24625,25248,25501,11751,14381,,11668,,-666666666,13134,29,137
"Newton County, Missouri",58202,28964,29238,52821,571,1334,807,553,247,1869,93,1776,58202,55143,3059,0.4631,0.0259,26996,27944,28618,14909,18172,22742,18540,9425,18699,15867,29,145
"Ozark County, Missouri",9236,4592,4644,8884,3,41,32,0,45,231,0,231,9236,9075,161,0.4518,0.0321,18818,19303,19389,5185,,,,-666666666,7907,7101,29,153
"Pike County, Missouri",18489,10217,8272,16469,1405,66,59,12,127,351,1,350,18489,18074,415,0.4245,0.0320,22302,23370,23532,12074,14387,5400,9471,,21146,10047,29,163
"St. Charles County, Missouri",389985,191641,198344,350757,17172,657,9681,48,2063,9607,630,8977,389985,377456,12529,0.3975,0.0070,37229,38110,38563,24296,31004,35643,36986,36150,20471,20164,29,183
"Custer County, Montana",11845,5955,5890,11123,68,233,34,4,62,321,14,307,11845,11454,391,0.4275,0.0246,30123,30837,30903,22958,6656,11612,17226,,,29388,30,017
"Hill County, Montana",16439,8292,8147,11593,37,3933,75,0,203,598,18,580,16439,15846,593,0.4324,0.0190,23017,27924,28088,8330,22886,10597,22944,-666666666,7135,14983,30,041
"Powder River County, Montana",1619,820,799,1536,0,25,0,0,3,55,13,42,1619,1575,44,0.3945,0.0281,30969,31059,31158,16400,-666666666,36940,-666666666,-666666666,,27411,30,075
"Park County, Montana",16246,8164,8082,15600,50,89,15,9,22,461,13,448,16246,15762,484,0.4446,0.0229,32133,32326,32750,15881,,18961,,,49355,28816,30,067
"Roosevelt County, Montana",11228,5559,5669,4105,35,6411,41,0,21,615,19,596,11228,10814,414,0.4791,0.0182,18813,31076,31826,7315,17263,10864,56071,-666666666,17062,17486,30,085
"Blaine County, Montana",6727,3368,3359,3049,26,3427,5,0,77,143,58,85,6727,6489,238,0.4288,0.0217,18155,23367,23389,11481,,13171,,-666666666,33192,9815,30,005
"Liberty County, Montana",2280,1146,1134,2252,0,0,0,0,16,12,0,12,2280,2231,49,0.5684,0.1051,45587,45788,45903,25598,-666666666,-666666666,-666666666,-666666666,,,30,051
"Richland County, Montana",11360,5740,5620,10618,0,343,0,0,82,317,11,306,11360,10756,604,0.3919,0.0223,31849,32351,32852,21289,-666666666,31082,-666666666,-666666666,,21841,30,083
"Teton County, Montana",6080,2994,3086,5759,11,56,13,0,26,215,4,211,6080,5985,95,0.4289,0.0286,27402,27589,27768,12993,,41588,,-666666666,,21104,30,099
"Toole County, Montana",4976,2824,2152,4505,8,228,132,0,7,96,0,96,4976,4793,183,0.4844,0.0741,26434,27697,27979,18393,,10700,11860,-666666666,,25567,30,101
"Fallon County, Montana",2838,1472,1366,2701,40,37,20,0,0,40,1,39,2838,2777,61,0.4237,0.0346,34329,34199,34523,12010,,324,,-666666666,-666666666,57140,30,025
"Daniels County, Montana",1753,884,869,1723,0,14,11,0,0,5,0,5,1753,1669,84,0.4329,0.0583,34799,35025,34787,39654,-666666666,,,-666666666,-666666666,,30,019
"Judith Basin County, Montana",1951,1058,893,1891,0,36,0,0,0,24,0,24,1951,1907,44,0.4585,0.0347,29827,30290,30582,10648,-666666666,19306,-666666666,-666666666,-666666666,,30,045
"Silver Bow County, Montana",34814,17588,17226,32810,205,891,277,0,161,470,2,468,34814,33217,1597,0.4806,0.0186,26224,27073,27506,16896,11567,9439,17820,-666666666,17156,13200,30,093
"Deer Lodge County, Montana",9100,4835,4265,8452,63,157,61,8,35,324,9,315,9100,8794,306,0.4577,0.0323,25742,26622,27230,6736,23356,7469,51116,,10166,9497,30,023
"Jefferson County, Montana",11778,5979,5799,11154,26,128,8,0,54,408,23,385,11778,11493,285,0.4061,0.0183,32133,32787,33021,18869,,14683,,-666666666,5594,21318,30,043
"McCone County, Montana",1630,828,802,1588,0,32,6,0,0,4,4,0,1630,1571,59,0.4000,0.0447,27365,27253,28073,5066,-666666666,17619,,-666666666,-666666666,,30,055
"Wheatland County, Montana",2149,1079,1070,2038,0,59,10,0,0,42,0,42,2149,2092,57,0.4120,0.0432,21442,21602,21769,24991,-666666666,25241,,-666666666,-666666666,,30,107
"Rosebud County, Montana",9250,4608,4642,5435,10,3464,99,0,89,153,24,129,9250,8793,457,0.4289,0.0230,23471,30162,31319,17659,,12314,3391,-666666666,50742,32718,30,087
"Carter County, Montana",1318,649,669,1285,0,7,0,0,0,26,0,26,1318,1315,3,0.5126,0.0422,32001,32447,32519,,-666666666,,-666666666,-666666666,-666666666,9646,30,011
"Dawson County, Montana",9191,4877,4314,8709,114,196,18,0,51,103,1,102,9191,8906,285,0.4189,0.0368,32501,33687,34011,20504,6844,10120,,-666666666,18916,14608,30,021
"Broadwater County, Montana",5834,2975,2859,5606,3,72,0,0,19,134,21,113,5834,5673,161,0.4320,0.0627,32362,32660,33157,19635,,16747,-666666666,-666666666,,19542,30,007
"Lake County, Montana",29774,14744,15030,20007,81,7254,111,67,86,2168,148,2020,29774,28460,1314,0.4680,0.0197,24912,29570,30031,14036,19421,15812,23147,23800,17047,13019,30,047
"Pondera County, Montana",6044,3003,3041,4959,26,910,5,0,34,110,0,110,6044,5925,119,0.4544,0.0331,24392,27135,27282,4183,8527,12419,28520,-666666666,,10093,30,073
"Yellowstone County, Montana",157816,77773,80043,143165,993,6942,1008,211,987,4510,405,4105,157816,149145,8671,0.4586,0.0121,33007,34463,35271,17637,18991,17999,29741,16662,19179,17522,30,111
"Ravalli County, Montana",41902,20822,21080,40242,34,386,234,0,71,935,33,902,41902,40462,1440,0.4613,0.0249,27766,28158,28492,17215,,16111,18601,-666666666,32975,18390,30,081
"Valley County, Montana",7532,3730,3802,6512,6,643,30,17,31,293,0,293,7532,7333,199,0.4090,0.0235,28899,31048,31210,19269,,13282,,,,16653,30,105
"Fergus County, Montana",11273,5682,5591,10724,18,81,117,72,148,113,6,107,11273,11015,258,0.4311,0.0354,29237,29496,29326,35937,,18575,15489,,27507,45297,30,027
"Mineral County, Montana",4211,2135,2076,3926,3,107,61,0,7,107,0,107,4211,4130,81,0.4565,0.0627,23744,24236,24293,19985,,13763,,-666666666,,16952,30,061
"Petroleum County, Montana",432,229,203,424,0,0,8,0,0,0,0,0,432,432,0,0.4212,0.0591,32565,32553,32553,-666666666,-666666666,-666666666,,-666666666,-666666666,-666666666,30,069
"Sanders County, Montana",11521,5935,5586,10630,19,410,59,1,23,379,43,336,11521,11194,327,0.4663,0.0330,23822,24401,24502,17342,,16492,13878,,,18995,30,089
"Flathead County, Montana",98082,48823,49259,92695,357,1553,624,45,727,2081,183,1898,98082,95430,2652,0.4546,0.0166,30068,30643,30885,19284,25821,21806,21353,7876,22146,17235,30,029
"Wibaux County, Montana",1175,561,614,1167,0,4,4,0,0,0,0,0,1175,1126,49,0.3573,0.0388,23137,23009,23132,20196,-666666666,,,-666666666,-666666666,-666666666,30,109
"Meagher County, Montana",1968,966,1002,1860,0,31,0,0,50,27,0,27,1968,1915,53,0.4024,0.0310,23972,24296,24294,,-666666666,40858,-666666666,-666666666,,,30,059
"Carbon County, Montana",10546,5317,5229,10204,41,148,21,0,24,108,4,104,10546,10287,259,0.4125,0.0189,32553,32751,33170,17413,36666,31900,38214,-666666666,,17427,30,009
"Phillips County, Montana",4124,2101,2023,3519,0,425,18,0,14,148,32,116,4124,4022,102,0.4175,0.0320,23533,25119,25344,7183,-666666666,16876,,-666666666,,8526,30,071
"Adams County, Nebraska",31583,15947,15636,29464,212,165,420,9,687,626,81,545,31583,28442,3141,0.4607,0.0226,28783,29777,30953,16488,9234,16075,16765,,14390,15990,31,001
"Lancaster County, Nebraska",310094,155699,154395,267938,12499,1772,13217,215,3989,10464,1318,9146,310094,288814,21280,0.4418,0.0061,30929,32874,33725,17269,17202,18760,23993,121267,16562,11955,31,109
"Boone County, Nebraska",5313,2641,2672,5229,22,5,6,5,6,40,1,39,5313,5201,112,0.4191,0.0250,30680,30913,31250,14583,49268,,,,13150,,31,011
"Rock County, Nebraska",1350,674,676,1324,10,0,0,0,8,8,0,8,1350,1333,17,0.4360,0.0343,34441,34870,35053,,,-666666666,-666666666,-666666666,,,31,149
"Banner County, Nebraska",696,346,350,679,0,0,0,0,3,14,0,14,696,654,42,0.5146,0.0678,34670,34667,36260,10169,-666666666,-666666666,-666666666,-666666666,,35486,31,007
"Sherman County, Nebraska",3042,1527,1515,2980,0,1,19,1,19,22,0,22,3042,2976,66,0.3968,0.0419,27380,27619,27687,23065,-666666666,,6542,,22421,18518,31,163
"Richardson County, Nebraska",8009,3974,4035,7538,17,171,17,0,16,250,0,250,8009,7852,157,0.4305,0.0286,28965,29278,29345,24706,58541,23712,,-666666666,15381,23582,31,147
"Howard County, Nebraska",6405,3227,3178,6179,12,2,13,2,101,96,0,96,6405,6240,165,0.3737,0.0195,26651,27019,27120,17776,6658,,42131,,18286,12936,31,093
"Holt County, Nebraska",10245,5142,5103,9961,12,80,51,3,51,87,53,34,10245,9781,464,0.4124,0.0279,29975,30215,30913,12864,,11410,60145,,33004,2983,31,089
"Furnas County, Nebraska",4786,2349,2437,4619,7,16,19,3,44,78,4,74,4786,4596,190,0.4205,0.0253,27031,27366,27676,15902,,,,,13891,17555,31,065
"Gosper County, Nebraska",2015,1000,1015,1974,9,1,11,0,2,18,0,18,2015,1969,46,0.4128,0.0501,34731,34894,35459,9667,,,,-666666666,,,31,073
"Saline County, Nebraska",14288,7257,7031,12617,150,38,449,17,646,371,118,253,14288,10771,3517,0.3916,0.0238,22943,24377,27217,13393,15201,26416,10656,,14669,7279,31,151
"Sarpy County, Nebraska",178351,89176,89175,156868,6944,694,4520,183,2943,6199,474,5725,178351,162231,16120,0.3841,0.0075,34928,36238,37444,20314,33302,25093,28478,18551,17956,17932,31,153
"Thurston County, Nebraska",7140,3545,3595,2801,19,4139,51,0,5,125,33,92,7140,6742,398,0.4761,0.0338,20396,35301,37445,8725,10368,10680,9767,-666666666,,14393,31,173
"Washington County, Nebraska",20219,9911,10308,19598,233,7,62,8,40,271,29,242,20219,19635,584,0.4039,0.0189,34178,34646,34888,23567,20803,,28495,,26455,15231,31,177
"Boyd County, Nebraska",2042,1028,1014,1951,9,24,17,0,5,36,0,36,2042,2027,15,0.4468,0.0382,27951,28093,28237,,,20271,,-666666666,,26933,31,015
"Cherry County, Nebraska",5790,2847,2943,5291,1,193,19,9,0,277,1,276,5790,5608,182,0.4118,0.0411,27605,28765,29411,10604,,10075,,,-666666666,19257,31,031
"Dodge County, Nebraska",36683,18126,18557,34548,336,348,158,60,499,734,50,684,36683,32164,4519,0.4282,0.0224,27494,28522,30509,11144,9741,10598,14991,5815,12447,9946,31,053
"Fillmore County, Nebraska",5574,2782,2792,5406,31,37,17,0,31,52,0,52,5574,5354,220,0.4430,0.0335,32631,33197,33923,10601,10997,8441,58476,-666666666,6077,11354,31,059
"Garden County, Nebraska",1860,937,923,1829,4,8,0,0,7,12,0,12,1860,1779,81,0.5065,0.0973,33572,33948,33847,34716,,,-666666666,-666666666,,,31,069
"Hooker County, Nebraska",691,324,367,682,6,0,0,0,3,0,0,0,691,670,21,0.4188,0.0634,25791,26107,25906,29514,,-666666666,-666666666,-666666666,,-666666666,31,091
"Morrill County, Nebraska",4841,2445,2396,4609,41,21,12,0,65,93,28,65,4841,4089,752,0.4246,0.0371,26461,26766,29297,13090,,52214,,-666666666,22942,17390,31,123
"Nemaha County, Nebraska",7004,3465,3539,6734,105,36,52,1,20,56,10,46,7004,6816,188,0.4225,0.0223,27945,28392,28697,13281,13692,1564,39729,,11065,13214,31,127
"Seward County, Nebraska",17127,8726,8401,16484,82,31,97,0,145,288,39,249,17127,16670,457,0.3992,0.0137,30694,30989,31190,28524,18112,28194,9560,-666666666,28885,25702,31,159
"Thomas County, Nebraska",645,321,324,630,0,3,0,0,2,10,0,10,645,642,3,0.4075,0.0432,28701,28683,28729,,-666666666,,-666666666,-666666666,,38720,31,171
"Dakota County, Nebraska",20317,10219,10098,13995,954,592,669,22,3588,497,54,443,20317,12493,7824,0.4173,0.0280,24365,26601,30160,18737,16053,19006,12044,,20459,28100,31,043
"Webster County, Nebraska",3571,1769,1802,3401,9,0,0,10,21,130,14,116,3571,3395,176,0.4630,0.0301,26970,27754,28310,14419,,-666666666,-666666666,1320,,12269,31,181
"Antelope County, Nebraska",6372,3204,3168,6216,48,9,10,0,54,35,0,35,6372,6169,203,0.4315,0.0270,26406,26791,27081,12075,12685,,,-666666666,6048,3394,31,003
"Butler County, Nebraska",8067,4056,4011,7799,36,16,53,0,68,95,6,89,8067,7806,261,0.3874,0.0188,28776,29102,29451,12481,,39606,33164,-666666666,18271,16138,31,023
"Clay County, Nebraska",6232,3165,3067,6026,4,18,10,0,54,120,29,91,6232,5673,559,0.3962,0.0252,27297,27751,29065,12467,,,,-666666666,21648,8523,31,035
"Custer County, Nebraska",10830,5366,5464,10488,25,9,80,0,78,150,8,142,10830,10502,328,0.5024,0.0636,33294,33671,34116,11885,,,17735,-666666666,12169,33090,31,041
"Gage County, Nebraska",21595,10826,10769,20847,160,152,125,23,117,171,23,148,21595,21078,517,0.4123,0.0136,28438,28701,28863,19553,35698,25650,15614,,15820,9087,31,067
"Hamilton County, Nebraska",9178,4564,4614,8836,48,57,6,0,137,94,13,81,9178,8880,298,0.3800,0.0188,32086,32753,33004,13347,,11700,,-666666666,14074,25622,31,081
"Kearney County, Nebraska",6552,3240,3312,6321,8,25,21,0,38,139,83,56,6552,6153,399,0.4245,0.0365,30355,31096,31752,14866,,11168,4833,-666666666,25242,6661,31,099
"Keith County, Nebraska",8099,4141,3958,7798,70,87,56,16,30,42,14,28,8099,7532,567,0.4243,0.0213,28410,28922,29770,16034,27140,7800,10695,,19400,11331,31,101
"Madison County, Nebraska",35164,17490,17674,32216,521,533,527,0,899,468,65,403,35164,29951,5213,0.4362,0.0226,27528,28329,30212,15349,12892,13506,43217,-666666666,16171,8774,31,119
"Perkins County, Nebraska",2907,1499,1408,2876,8,1,0,0,7,15,0,15,2907,2790,117,0.4365,0.0525,33749,33854,34661,13280,,,-666666666,-666666666,,5073,31,135
"Saunders County, Nebraska",21024,10628,10396,20468,64,59,71,0,52,310,4,306,21024,20568,456,0.3904,0.0220,32344,32808,33129,15794,11877,23590,37348,-666666666,9621,10273,31,155
"Wayne County, Nebraska",9367,4716,4651,8905,166,53,48,0,83,112,4,108,9367,8826,541,0.4235,0.0331,27192,28029,28724,15623,5570,14704,15654,-666666666,17304,10877,31,179
"Keya Paha County, Nebraska",792,416,376,780,0,0,0,0,1,11,4,7,792,784,8,0.4274,0.0346,31406,31641,31641,,-666666666,-666666666,-666666666,-666666666,,,31,103
"Knox County, Nebraska",8460,4150,4310,7345,23,836,27,11,81,137,10,127,8460,8237,223,0.4171,0.0180,27372,29435,29588,15080,13270,12862,12770,,25707,13455,31,107
"Lincoln County, Nebraska",35433,17497,17936,33735,484,126,118,12,221,737,91,646,35433,32476,2957,0.4370,0.0224,30073,30417,31667,16493,15522,53277,28940,,30315,20264,31,111
"Pierce County, Nebraska",7157,3566,3591,6977,17,8,30,6,4,115,7,108,7157,7033,124,0.4048,0.0200,29509,29459,29638,36376,,21200,4553,,,38861,31,139
"Sioux County, Nebraska",1266,643,623,1164,6,3,3,0,0,90,0,90,1266,1260,6,0.4020,0.0289,26951,28280,28406,,,,,-666666666,-666666666,,31,165
"Cass County, Nebraska",25702,12929,12773,24747,153,30,73,55,166,478,57,421,25702,24891,811,0.3927,0.0141,33178,33564,33813,26076,14042,37013,30175,26342,24716,23219,31,025
"Dixon County, Nebraska",5746,2884,2862,5417,16,25,4,0,200,84,0,84,5746,4984,762,0.4033,0.0213,26757,27429,28860,15610,13850,16060,,-666666666,19498,6989,31,051
"Dundy County, Nebraska",2023,1013,1010,2007,4,2,0,0,0,10,0,10,2023,1706,317,0.4248,0.0327,25790,25522,28399,10185,,,-666666666,-666666666,-666666666,85140,31,057
"Greeley County, Nebraska",2410,1207,1203,2350,12,4,10,0,20,14,0,14,2410,2360,50,0.4090,0.0243,26159,26260,26524,15552,,,17390,-666666666,38520,25179,31,077
"Hall County, Nebraska",61343,30830,30513,53784,1533,358,691,219,3787,971,237,734,61343,44639,16704,0.4407,0.0197,27421,28405,32135,15682,32061,18956,39824,17421,15079,10241,31,079
"Otoe County, Nebraska",15896,7742,8154,15046,61,87,42,0,253,407,82,325,15896,14660,1236,0.4194,0.0255,29229,30114,30968,16245,22082,11476,,-666666666,16827,9794,31,131
"Red Willow County, Nebraska",10806,5401,5405,10398,80,19,21,0,69,219,0,219,10806,10264,542,0.4174,0.0239,25456,26057,26659,12502,4193,,30605,-666666666,8719,10679,31,145
"Dawes County, Nebraska",8896,4571,4325,7938,172,410,51,0,38,287,0,287,8896,8447,449,0.4053,0.0359,26021,27345,26188,42707,15752,17207,5661,-666666666,,15098,31,045
"Cheyenne County, Nebraska",9852,4903,4949,9404,10,60,126,2,41,209,11,198,9852,9186,666,0.4309,0.0208,32321,33225,34105,17519,18730,16605,20425,,9254,8680,31,033
"Dawson County, Nebraska",23804,12241,11563,21056,1468,187,80,19,778,216,6,210,23804,15921,7883,0.4144,0.0261,25590,26969,31862,16156,17188,22694,10818,,11664,8406,31,047
"Valley County, Nebraska",4224,2073,2151,4148,20,16,0,0,3,37,0,37,4224,4092,132,0.4459,0.0410,28587,28790,29136,17860,,,-666666666,-666666666,,14795,31,175
"McPherson County, Nebraska",454,241,213,435,0,0,0,0,4,15,0,15,454,445,9,0.4108,0.0648,26384,27167,27223,,-666666666,-666666666,-666666666,-666666666,,,31,117
"Nance County, Nebraska",3554,1769,1785,3520,16,14,2,0,2,0,0,0,3554,3459,95,0.4803,0.0657,29711,29831,29806,30259,,,,-666666666,,-666666666,31,125
"Stanton County, Nebraska",5992,3002,2990,5811,85,0,28,0,25,43,0,43,5992,5674,318,0.4110,0.0685,31686,32034,32919,16676,22962,-666666666,34346,-666666666,,,31,167
"Harlan County, Nebraska",3438,1781,1657,3283,28,19,12,1,46,49,26,23,3438,3303,135,0.4092,0.0307,27421,27190,27372,17991,98493,26305,32358,,23387,5859,31,083
"Blaine County, Nebraska",480,246,234,480,0,0,0,0,0,0,0,0,480,480,0,0.3731,0.0515,26767,26767,26767,-666666666,-666666666,-666666666,-666666666,-666666666,-666666666,-666666666,31,009
"Buffalo County, Nebraska",49030,24593,24437,45183,563,70,696,7,1630,881,72,809,49030,44704,4326,0.4498,0.0229,30184,31197,32131,15472,14864,15083,33096,,18106,9432,31,019
"Deuel County, Nebraska",1894,892,1002,1790,4,29,13,0,30,28,0,28,1894,1746,148,0.4050,0.0330,27397,28030,29196,10132,,19279,23254,-666666666,,27654,31,049
"Hitchcock County, Nebraska",2843,1414,1429,2832,3,2,0,0,1,5,2,3,2843,2812,31,0.4533,0.0550,26917,26985,27170,8371,,,-666666666,-666666666,,13080,31,087
"Platte County, Nebraska",33063,16860,16203,31534,160,123,254,3,638,351,95,256,33063,26980,6083,0.4135,0.0222,29847,30274,33340,15928,30270,20953,26597,,19438,15206,31,141
"Thayer County, Nebraska",5098,2545,2553,4948,23,17,0,0,17,93,10,83,5098,4979,119,0.4002,0.0201,28793,29259,29465,16003,9326,8935,-666666666,-666666666,13624,15240,31,169
"Box Butte County, Nebraska",11089,5472,5617,10176,42,427,33,0,94,317,78,239,11089,9718,1371,0.3908,0.0282,28835,30044,31461,21402,27479,14702,,-666666666,24987,13050,31,013
"Churchill County, Nevada",24010,12138,11872,20192,588,1074,663,50,531,912,102,810,24010,20750,3260,0.4112,0.0193,26606,28376,29992,16045,18088,20009,20080,15486,10698,15288,32,001
"Douglas County, Nevada",47828,24102,23726,42695,312,1016,686,153,1577,1389,83,1306,47828,41847,5981,0.4382,0.0172,36390,38180,39885,19366,12160,18193,38919,22786,16740,22682,32,005
"Pershing County, Nevada",6611,4286,2325,5369,292,269,92,30,315,244,24,220,6611,5014,1597,0.4214,0.0328,19330,22403,25097,9242,4276,9714,10686,,5903,1389,32,027
"Esmeralda County, Nevada",981,406,575,931,11,7,0,0,31,1,0,1,981,795,186,0.3543,0.0347,24713,24600,27594,12966,,,-666666666,-666666666,29726,,32,009
"Humboldt County, Nevada",16904,8779,8125,14803,70,926,84,0,745,276,38,238,16904,12383,4521,0.3659,0.0187,30516,31913,35356,22223,29467,13887,32620,-666666666,23977,28655,32,013
"Mineral County, Nevada",4448,2205,2243,2975,111,1005,129,0,54,174,63,111,4448,3911,537,0.4289,0.0314,22897,27125,27850,19331,9969,13838,11331,-666666666,23331,19618,32,021
"White Pine County, Nevada",9737,5704,4033,8335,518,540,111,15,103,115,15,100,9737,8215,1522,0.3983,0.0280,26412,27837,29681,17686,5837,22357,64377,3193,16327,10259,32,033
"Elko County, Nevada",52252,27199,25053,45135,289,3362,593,119,2094,660,144,516,52252,39585,12667,0.3866,0.0155,33091,35058,38409,22972,17094,18547,26959,5588,21074,28269,32,007
"Lincoln County, Nevada",5174,2673,2501,4614,192,12,62,0,251,43,1,42,5174,4732,442,0.3680,0.0358,25304,26568,27424,6628,3679,,,-666666666,10288,25470,32,017
"Nye County, Nevada",43705,22243,21462,36290,1053,651,728,166,3334,1483,110,1373,43705,37419,6286,0.4194,0.0202,25092,26217,26730,18610,23526,21419,14941,22894,16801,24177,32,023
"Storey County, Nevada",3941,1963,1978,3519,32,75,38,0,14,263,0,263,3941,3738,203,0.4175,0.0465,35887,37839,38843,19067,17544,43821,36950,-666666666,,11258,32,029
"Washoe County, Nevada",450486,226751,223735,355208,10330,7048,23612,2802,31573,19913,3338,16575,450486,341564,108922,0.4581,0.0058,33546,36501,40887,18262,25066,23821,31062,20272,17979,18162,32,031
"Clark County, Nevada",2141574,1069779,1071795,1299138,245827,16590,205824,15846,246907,111442,19190,92252,2141574,1479493,662081,0.4614,0.0034,29256,33740,39226,18378,22133,20981,31163,22157,17024,18502,32,003
"Carson City, Nevada",54467,27912,26555,43725,954,1366,1471,37,5405,1509,132,1377,54467,41536,12931,0.4543,0.0177,29767,31757,34452,17983,13791,24483,37011,40830,16127,28514,32,510
"Lyon County, Nevada",53155,26757,26398,45271,537,1556,593,84,3099,2015,191,1824,53155,44312,8843,0.3962,0.0134,26855,28050,29245,19450,31448,14974,24026,38655,23497,13453,32,019
"Cheshire County, New Hampshire",76263,37221,39042,72655,587,144,1054,9,211,1603,333,1270,76263,74909,1354,0.4563,0.0172,34136,34793,34950,15873,14542,14856,36642,,17008,14059,33,005
"Merrimack County, New Hampshire",149452,73538,75914,140759,1957,253,3103,19,559,2802,145,2657,149452,146348,3104,0.4285,0.0089,36148,36991,37221,22066,18392,13368,30277,,22118,17103,33,013
"Grafton County, New Hampshire",89811,44161,45650,83035,1116,357,3336,50,205,1712,94,1618,89811,87722,2089,0.4773,0.0135,36619,37718,37974,20034,16879,20914,26828,32720,16345,21081,33,009
"Rockingham County, New Hampshire",305129,151201,153928,289348,2295,175,5971,0,1714,5626,573,5053,305129,296416,8713,0.4199,0.0060,45242,45755,46089,29944,44149,57528,43563,-666666666,33496,24237,33,015
"Belknap County, New Hampshire",60640,29736,30904,58506,415,231,484,15,88,901,48,853,60640,59650,990,0.4292,0.0131,35382,35783,35969,24989,16707,25833,39535,,,20541,33,001
"Sullivan County, New Hampshire",43125,21411,21714,41564,359,221,329,0,36,616,14,602,43125,42481,644,0.4179,0.0144,31668,31836,32018,15346,27460,27188,49475,-666666666,15908,15798,33,019
"Hillsborough County, New Hampshire",411087,204293,206794,368550,11530,488,16744,200,3299,10276,1011,9265,411087,384244,26843,0.4299,0.0060,39478,40431,41430,22455,23119,36474,41685,29030,31171,23080,33,011
"Strafford County, New Hampshire",128237,62703,65534,119002,1111,67,4556,26,345,3130,289,2841,128237,125234,3003,0.4320,0.0115,34161,34838,35008,24456,22205,25972,31990,,15470,18163,33,017
"Coos County, New Hampshire",32038,16874,15164,30086,920,112,199,27,135,559,108,451,32038,31100,938,0.4356,0.0139,26535,27603,27911,10751,5706,8879,26421,,7933,12652,33,007
"Carroll County, New Hampshire",47840,23845,23995,46509,226,42,348,13,37,665,42,623,47840,47162,678,0.4503,0.0146,36033,36284,36296,33978,5806,18074,57972,,5897,20821,33,003
"Monmouth County, New Jersey",623387,303154,320233,513711,43959,1000,33772,271,17875,12799,2052,10747,623387,556859,66528,0.4729,0.0047,48959,52188,54340,26188,28182,30528,53979,24293,20042,19837,34,025
"Sussex County, New Jersey",142298,70730,71568,132221,3262,50,2943,27,1612,2183,266,1917,142298,131189,11109,0.4098,0.0095,42639,43316,43994,32354,34449,52896,49014,,25202,18029,34,037
"Cumberland County, New Jersey",153400,78687,74713,103099,29573,1136,2182,14,10815,6581,1314,5267,153400,107146,46254,0.4512,0.0117,23946,27251,32508,14660,17872,19711,25650,,13127,17361,34,011
"Essex County, New Jersey",793555,381576,411979,334450,316192,1997,41500,240,79630,19546,4908,14638,793555,613314,180241,0.5529,0.0045,37141,52915,63149,21871,23676,22173,53345,84977,18793,26349,34,013
"Ocean County, New Jersey",591939,285371,306568,539689,18185,337,11407,275,12518,9528,1412,8116,591939,537975,53964,0.4506,0.0055,34784,35440,36299,22247,31508,14990,41920,1897,18591,18305,34,029
"Gloucester County, New Jersey",290852,141229,149623,237686,29956,183,8949,89,5743,8246,1945,6301,290852,273560,17292,0.4148,0.0064,37888,39952,40249,26631,29930,56614,36887,33574,22094,19015,34,015
"Salem County, New Jersey",63336,30982,32354,51120,8353,182,666,0,1083,1932,243,1689,63336,57861,5475,0.4469,0.0243,32526,35920,37558,15143,19606,21018,25688,-666666666,17006,10727,34,033
"Passaic County, New Jersey",504041,245463,258578,313306,57437,1831,26351,171,89838,15107,4115,10992,504041,297941,206100,0.4732,0.0053,30800,36491,43897,19202,22099,20905,35755,11321,17250,19190,34,031
"Camden County, New Jersey",507367,245068,262299,320830,97896,1172,29045,230,43095,15099,3041,12058,507367,424310,83057,0.4693,0.0062,34280,40325,42375,17453,24635,13264,37124,17480,16208,16360,34,007
"Bergen County, New Jersey",929999,450784,479215,663672,55497,1695,150137,336,35708,22954,4845,18109,929999,749470,180529,0.4776,0.0047,48426,51880,56623,31099,36661,30966,46415,59100,25614,26767,34,003
"Warren County, New Jersey",106293,51936,54357,94352,4707,156,2849,15,2046,2168,187,1981,106293,96882,9411,0.4182,0.0084,38132,39472,40402,23875,33989,26231,34311,27593,16248,15404,34,041
"Hudson County, New Jersey",668631,332268,336363,368360,83215,2110,100564,600,91021,22761,7369,15392,668631,379882,288749,0.5049,0.0058,38147,42705,59868,22323,26658,24425,50568,16732,19935,26178,34,017
"Burlington County, New Jersey",446367,219534,226833,322158,74431,345,21620,255,10058,17500,1774,15726,446367,411341,35026,0.4344,0.0072,41517,45168,46100,26722,31259,28510,47770,20458,24935,20290,34,005
"Morris County, New Jersey",494383,242484,251899,403998,16605,684,50403,109,12759,9825,1454,8371,494383,429618,64765,0.4579,0.0053,55826,58604,62178,30806,40034,38044,52937,65375,24406,25056,34,027
"Rio Arriba County, New Mexico",39307,19250,20057,21382,237,6418,188,5,10172,905,503,402,39307,11261,28046,,,,,,,,,,,,,35,039
"San Miguel County, New Mexico",28034,14108,13926,15503,376,370,375,59,10315,1036,496,540,28034,6277,21757,0.5035,0.0290,20285,23262,27315,19164,8556,14892,16933,,17244,12541,35,047
"Torrance County, New Mexico",15595,8358,7237,14278,273,166,57,0,307,514,83,431,15595,8916,6679,0.4542,0.0279,20072,20525,23572,16293,11729,7209,21789,-666666666,14578,19159,35,057
"Otero County, New Mexico",65745,33886,31859,51539,2358,4385,941,152,4121,2249,451,1798,65745,40746,24999,0.4579,0.0266,22477,24800,29533,15411,17264,12177,22341,10217,11801,15218,35,035
"Cibola County, New Mexico",26978,13648,13330,12624,305,11318,93,6,1856,776,171,605,26978,16659,10319,0.4496,0.0183,18514,23248,26817,18743,61464,13070,9717,,17033,8502,35,006
"Guadalupe County, New Mexico",4382,2507,1875,3605,59,71,0,0,511,136,24,112,4382,948,3434,0.4680,0.0405,17930,19032,19199,17923,4254,20492,-666666666,-666666666,13743,9043,35,019
"Catron County, New Mexico",3539,1930,1609,3504,0,2,6,0,16,11,0,11,3539,2904,635,0.3511,0.0479,20767,20740,22607,12350,-666666666,,,-666666666,24388,,35,003
"Grant County, New Mexico",28061,13869,14192,26268,197,610,79,6,342,559,218,341,28061,13934,14127,0.4905,0.0392,24913,25935,33759,18229,5964,7113,41422,,17718,5285,35,017
"Luna County, New Mexico",24264,12020,12244,22208,336,250,168,9,877,416,236,180,24264,8100,16164,0.4835,0.0220,16496,16686,24250,12869,23890,8717,19971,,12172,12400,35,029
"McKinley County, New Mexico",72849,35158,37691,10948,488,55891,746,30,2676,2070,281,1789,72849,62415,10434,0.5172,0.0164,15278,31606,35925,18832,24281,11760,26630,30920,22079,8656,35,031
"Taos County, New Mexico",32888,16076,16812,28029,152,2375,77,1,1648,606,185,421,32888,14150,18738,0.4874,0.0167,23642,24424,33951,18440,59149,15478,23586,,24578,8004,35,055
"Colfax County, New Mexico",12353,6309,6044,10673,67,245,42,0,912,414,120,294,12353,6248,6105,0.4482,0.0201,22293,23160,27513,17849,8037,12235,52821,-666666666,19148,12045,35,007
"Eddy County, New Mexico",57437,28989,28448,52273,891,869,225,0,2324,855,203,652,57437,29638,27799,0.4269,0.0174,28957,29562,36917,21288,31412,24579,33976,-666666666,20240,16235,35,015
"Mora County, New Mexico",4563,2230,2333,2684,1,3,0,0,1839,36,36,0,4563,862,3701,0.4806,0.0466,17689,18399,22436,16971,,,-666666666,-666666666,16872,,35,033
"Quay County, New Mexico",8373,3881,4492,7551,128,157,90,19,316,112,33,79,8373,4592,3781,0.4598,0.0239,18637,19301,23107,14643,10894,13715,21239,,10534,13546,35,037
"Lincoln County, New Mexico",19482,9228,10254,18236,179,327,91,0,178,471,37,434,19482,13120,6362,0.4789,0.0354,26534,27283,32903,15998,16435,15401,32195,-666666666,22989,9366,35,027
"Lea County, New Mexico",70126,36137,33989,62145,2707,628,155,27,3042,1422,323,1099,70126,29532,40594,0.4402,0.0174,24879,25435,35796,18770,16300,28911,31961,,25349,13705,35,025
"Santa Fe County, New Mexico",148917,72344,76573,124370,1496,4736,1885,175,12132,4123,1611,2512,148917,72513,76404,0.4843,0.0086,37080,39294,53495,23668,39386,19973,51969,35663,20801,30271,35,049
"Sierra County, New Mexico",11135,5516,5619,10005,65,376,70,0,310,309,79,230,11135,7766,3369,0.5345,0.0656,25389,23991,25769,25581,44032,7533,27696,-666666666,97082,16041,35,051
"Socorro County, New Mexico",17000,8799,8201,13312,63,1915,507,0,527,676,121,555,17000,8555,8445,0.4782,0.0293,17464,19293,28341,12331,20054,9141,19789,-666666666,17598,2939,35,053
"Do�a Ana County, New Mexico",215338,105774,109564,189377,4087,2441,2276,61,13246,3850,1011,2839,215338,68853,146485,0.4929,0.0113,21300,21501,34245,15486,35164,22088,26831,17654,15297,13621,35,013
"Schoharie County, New York",31364,15620,15744,30007,541,49,280,13,128,346,36,310,31364,30392,972,0.4227,0.0134,28712,29305,29530,19061,11217,5759,27614,,14483,14275,36,095
"Onondaga County, New York",464242,223995,240247,370976,52888,2389,17130,116,4765,15978,1329,14649,464242,441984,22258,0.4633,0.0063,32678,36209,36828,17559,17610,28859,25156,20092,16564,14101,36,067
"Clinton County, New York",80794,41499,39295,73391,3475,208,1183,26,1474,1037,110,927,80794,78484,2310,0.4216,0.0110,26772,28520,28665,9360,5625,16099,16904,29373,8418,13347,36,019
"Seneca County, New York",34612,18096,16516,31669,1707,135,242,0,234,625,28,597,34612,33454,1158,0.4318,0.0203,27366,29021,29516,9320,6923,13833,23269,-666666666,11463,9847,36,099
"Putnam County, New York",99070,49296,49774,86904,2881,205,2019,24,4834,2203,434,1769,99070,84875,14195,0.4245,0.0161,45905,47380,49453,27732,52314,30018,51045,,24254,24093,36,079
"Franklin County, New York",50692,27816,22876,41778,2965,3618,255,94,1099,883,213,670,50692,48933,1759,0.4492,0.0154,25491,27685,27771,15990,3834,19670,70366,26949,18594,13731,36,033
"Ontario County, New York",109472,53704,55768,101467,2770,487,1455,37,1480,1776,331,1445,109472,104414,5058,0.4531,0.0142,35121,36491,37134,14483,17911,18628,24240,,16946,12327,36,069
"Queens County, New York",2298513,1114654,1183859,896722,421038,9977,580709,1100,309236,79731,30729,49002,2298513,1654950,643563,0.4515,0.0028,30289,36963,43609,22778,28705,21640,27161,37232,20788,24223,36,081
"Steuben County, New York",96927,48397,48530,92017,1553,102,1484,15,374,1382,81,1301,96927,95356,1571,0.4516,0.0113,28600,28516,28627,18240,20986,12711,61124,25620,13733,13052,36,101
"Hamilton County, New York",4575,2347,2228,4420,37,16,1,1,14,86,0,86,4575,4504,71,0.3933,0.0238,25918,26314,26554,9325,9511,,,,14779,18962,36,041
"Washington County, New York",61828,32002,29826,57974,2025,197,347,0,376,909,92,817,61828,60186,1642,0.4166,0.0155,27156,28252,28501,8787,4143,21976,38315,-666666666,9981,12531,36,115
"Chautauqua County, New York",129656,63960,65696,119857,3326,425,694,68,2586,2700,217,2483,129656,120071,9585,0.4470,0.0097,24825,25881,26667,11568,11728,16747,22457,35226,12518,7464,36,013
"Kings County, New York",2600747,1231912,1368835,1130251,847116,8427,306829,1047,230448,76629,16090,60539,2600747,2101468,499279,0.5273,0.0030,31984,41767,45182,20800,24955,26270,27375,25910,17639,27696,36,047
"New York County, New York",1632480,772144,860336,917402,241850,6995,196347,867,193569,75450,18768,56682,1632480,1208797,423683,0.5971,0.0039,72832,100143,112313,26745,27612,25761,68197,37091,20513,36772,36,061
"Tioga County, New York",49045,24264,24781,47371,322,91,346,18,103,794,48,746,49045,48118,927,0.4292,0.0150,31330,31682,31792,22361,14570,39023,28225,,23514,18792,36,107
"Cayuga County, New York",77868,39982,37886,71522,3361,235,399,0,552,1799,208,1591,77868,75636,2232,0.4267,0.0116,29022,30704,31017,11259,7327,15786,28664,-666666666,11737,9818,36,011
"Orleans County, New York",41175,20539,20636,36583,2541,151,326,21,802,751,58,693,41175,39214,1961,0.4141,0.0206,25261,26596,27031,10457,14759,19282,28075,,8239,14388,36,073
"Saratoga County, New York",227377,112468,114909,211245,3960,472,6478,37,1236,3949,333,3616,227377,220318,7059,0.4198,0.0092,41709,42058,42352,27637,30005,34150,50484,,29970,25008,36,091
"Rockland County, New York",323686,158667,165019,228967,39715,544,19216,33,26239,8972,2687,6285,323686,267303,56383,0.4608,0.0066,38076,40746,42149,24519,33004,47899,47784,63015,20612,21965,36,087
"Columbia County, New York",60919,30495,30424,54318,2688,33,1127,0,1011,1742,151,1591,60919,58092,2827,0.4645,0.0156,35581,37517,37929,18694,18778,55200,33014,-666666666,15400,14139,36,021
"Lewis County, New York",26719,13451,13268,25829,206,55,145,23,186,275,54,221,26719,26263,456,0.4126,0.0122,26169,26601,26662,15889,20824,15460,8368,,16401,9565,36,049
"Niagara County, New York",211704,103127,108577,185192,15145,2203,2277,75,1590,5222,439,4783,211704,205650,6054,0.4411,0.0078,29824,31786,32098,14328,17134,17993,21012,24147,16367,10074,36,063
"Westchester County, New York",968815,468898,499917,630592,142443,4059,57410,262,104252,29797,8890,20907,968815,733572,235243,0.5405,0.0032,54572,66196,73425,25941,32054,27221,60763,43654,21259,24678,36,119
"Delaware County, New York",45502,22943,22559,43108,839,70,363,8,393,721,77,644,45502,43760,1742,0.4337,0.0123,26629,27287,27488,15753,9683,19749,26322,,7398,17465,36,025
"Essex County, New York",37751,19622,18129,35186,1185,78,134,8,460,700,150,550,37751,36618,1133,0.4302,0.0163,30273,31543,31759,8876,5939,17914,26546,32250,28005,11184,36,031
"Montgomery County, New York",49426,24265,25161,43412,1007,71,420,0,3059,1457,411,1046,49426,42660,6766,0.4576,0.0158,25427,26836,27505,16622,15376,10649,14376,-666666666,17955,9996,36,057
"Nassau County, New York",1356564,659405,697159,930446,158708,3583,125767,351,96581,41128,11239,29889,1356564,1130983,225581,0.4570,0.0031,49211,56095,58979,27304,34305,26461,47169,26157,21598,24284,36,059
"Richmond County, New York",474101,229424,244677,352259,48591,1080,41427,197,18757,11790,2363,9427,474101,387125,86976,0.4566,0.0060,34987,38029,40790,23064,23781,29274,34002,16305,20657,17362,36,085
"Schuyler County, New York",17992,8979,9013,17353,224,31,107,0,32,245,17,228,17992,17679,313,0.4014,0.0188,26484,26818,26934,15710,14180,14977,11618,-666666666,,24867,36,097
"Tompkins County, New York",102962,50823,52139,82924,4272,224,10386,31,1300,3825,239,3586,102962,97806,5156,0.4887,0.0119,31464,34354,34976,16655,14626,24254,24374,,9754,14745,36,109
"Chenango County, New York",48348,24227,24121,46395,472,166,206,10,233,866,99,767,48348,47310,1038,0.4279,0.0143,26717,26629,26621,36292,55446,30317,28532,,15990,16938,36,017
"Cortland County, New York",48123,23550,24573,45625,712,111,387,9,227,1052,21,1031,48123,46845,1278,0.4354,0.0210,26979,27329,27537,18305,24858,73763,19322,,21670,12510,36,023
"Jefferson County, New York",114448,59931,54517,98570,6894,533,1884,245,1708,4614,588,4026,114448,105963,8485,0.4181,0.0108,25884,26919,27430,15528,20129,23987,27537,28065,16331,15347,36,045
"Oneida County, New York",230782,115089,115693,197739,14398,491,9184,63,3443,5464,730,4734,230782,217890,12892,0.4590,0.0111,28548,30454,31002,14176,18063,23086,20392,16795,10395,12956,36,065
"Suffolk County, New York",1487901,732269,755632,1200553,116880,3967,57527,451,73643,34880,7924,26956,1487901,1206586,281315,0.4423,0.0035,42204,45747,49177,24743,27845,25684,40046,35515,20310,20107,36,103
"Wyoming County, New York",40565,21734,18831,37162,1837,228,155,0,454,729,62,667,40565,39245,1320,0.4015,0.0225,27150,28771,29008,14862,5961,22675,14866,-666666666,16431,8600,36,121
"Chemung County, New York",85740,42556,43184,75443,5262,294,1333,10,556,2842,236,2606,85740,83145,2595,0.4486,0.0143,28115,29632,29865,13179,12168,9431,53520,,14627,10117,36,015
"Oswego County, New York",119104,59648,59456,113885,1325,190,882,16,604,2202,120,2082,119104,116109,2995,0.4335,0.0106,27217,27765,27971,15078,13275,26239,28796,,7890,12149,36,075
"Otsego County, New York",60244,29127,31117,56254,1245,92,829,5,624,1195,247,948,60244,58069,2175,0.4433,0.0132,27680,28142,28339,16852,23211,22450,24685,,12124,21227,36,077
"Wayne County, New York",90856,44971,45885,84701,2631,144,606,78,786,1910,255,1655,90856,86978,3878,0.4189,0.0133,29028,29890,30316,17096,17606,25792,30705,10155,20485,10542,36,117
"Albany County, New York",307426,148910,158516,232402,38407,516,19928,133,4527,11513,1130,10383,307426,289501,17925,0.4592,0.0062,36454,40887,41496,20529,19828,24226,33409,16736,18581,15525,36,001
"Broome County, New York",194402,95608,98794,167041,11177,392,8238,89,1791,5674,511,5163,194402,186428,7974,0.4591,0.0092,27744,29653,29952,15034,14768,16028,22729,22160,14786,9369,36,007
"Erie County, New York",919866,444998,474868,716987,123475,4558,31800,309,20247,22490,4132,18358,919866,870453,49413,0.4668,0.0041,32347,35956,36362,16952,19760,16724,27204,19785,14304,13239,36,029
"Madison County, New York",71359,35252,36107,67574,1251,464,630,73,284,1083,151,932,71359,69812,1547,0.4212,0.0114,28925,29538,29672,19249,18331,24254,17199,,17757,16563,36,053
"Sullivan County, New York",75211,38595,36616,60702,6297,191,1198,0,3762,3061,232,2829,75211,63375,11836,0.4633,0.0149,29292,32278,33832,17311,15331,14132,27675,-666666666,15303,17591,36,105
"Mitchell County, North Carolina",15040,7400,7640,14502,53,64,45,0,145,231,0,231,15040,14247,793,0.4256,0.0375,23907,24518,25094,11115,2119,11586,,-666666666,11866,6149,37,121
"Genesee County, New York",58112,29022,29090,53404,1304,510,477,0,997,1420,47,1373,58112,56263,1849,0.4073,0.0114,29465,30421,30648,14048,20739,27981,37555,-666666666,15730,8961,36,037
"Orange County, New York",378227,189484,188743,279802,40849,1308,10034,229,32663,13342,4029,9313,378227,302522,75705,0.4380,0.0066,33472,36118,37462,23606,28394,26918,41885,21299,21514,17331,36,071
"Greene County, North Carolina",21008,11593,9415,12276,7502,104,20,0,524,582,54,528,21008,17892,3116,0.4337,0.0247,18339,20378,23542,7385,16716,6181,,-666666666,7311,8655,37,079
"Chowan County, North Carolina",14205,6653,7552,8606,4839,62,73,3,386,236,22,214,14205,13690,515,0.4474,0.0252,24084,28384,28589,9983,18732,46500,,,6288,2448,37,041
"Caldwell County, North Carolina",81779,40354,41425,72907,3990,317,461,41,2875,1188,241,947,81779,77464,4315,0.4483,0.0153,22945,24236,24424,10643,13012,15973,23507,,10008,10576,37,027
"Catawba County, North Carolina",156729,76703,80026,123876,12772,430,6611,0,9607,3433,204,3229,156729,141919,14810,0.4536,0.0107,26950,30160,30819,11829,17455,18102,17676,-666666666,10125,12518,37,035
"Craven County, North Carolina",103082,52246,50836,72467,22362,799,2848,99,1955,2552,89,2463,103082,95678,7404,0.4503,0.0152,28007,32469,33421,17354,17791,14584,18769,29124,17512,13328,37,049
"Edgecombe County, North Carolina",53332,24856,28476,20527,30549,96,55,57,1044,1004,173,831,53332,50974,2358,0.4720,0.0237,20055,25328,26171,10239,17250,19639,74836,,10392,4694,37,065
"Harnett County, North Carolina",130361,64574,65787,87990,27164,1173,1407,266,7005,5356,734,4622,130361,114165,16196,0.4177,0.0086,23011,25982,26677,15560,18518,20694,23852,8429,13538,10384,37,085
"Henderson County, North Carolina",113625,54724,58901,103130,3761,323,1526,151,2808,1926,209,1717,113625,102202,11423,0.4350,0.0093,29860,31047,32495,15072,22597,17859,21122,8851,14167,13951,37,089
"Hyde County, North Carolina",5393,2832,2561,3578,1636,6,0,0,136,37,0,37,5393,4857,536,0.3983,0.0589,18433,22923,24876,10599,8967,,-666666666,-666666666,19979,,37,095
"Mecklenburg County, North Carolina",1054314,506721,547593,574455,330161,3779,60906,566,54331,30116,2577,27539,1054314,916909,137405,0.4881,0.0043,37298,47906,52208,17410,24602,25718,35351,18844,14634,20758,37,119
"Northampton County, North Carolina",20186,9845,10341,8069,11408,120,45,0,91,453,27,426,20186,19759,427,0.4500,0.0231,20538,26584,27290,7205,16712,11895,7884,-666666666,8571,15166,37,131
"Rowan County, North Carolina",139605,69165,70440,107988,22399,372,1236,30,4723,2857,152,2705,139605,127619,11986,0.4510,0.0111,25117,27428,28080,15367,18315,14820,26724,39253,11380,14299,37,159
"Vance County, North Carolina",44482,20823,23659,19416,22279,744,288,28,814,913,269,644,44482,41113,3369,0.5215,0.0523,23211,25884,27149,12290,21110,7433,14403,,14431,9242,37,181
"Currituck County, North Carolina",25796,12822,12974,23258,1473,132,94,6,252,581,36,545,25796,24815,981,0.3867,0.0210,30017,29949,30252,20749,34979,18368,25786,,24044,26293,37,053
"Union County, North Carolina",226694,111658,115036,184834,25918,690,6151,96,3891,5114,432,4682,226694,201649,25045,0.4558,0.0100,34379,35832,38109,17072,26630,32229,42773,23395,15172,26159,37,179
"Forsyth County, North Carolina",371573,176337,195236,245930,97010,1141,8403,327,9979,8783,1038,7745,371573,324660,46913,0.4985,0.0079,29921,35186,38733,12451,19990,16426,30163,15954,12631,13855,37,067
"Nash County, North Carolina",94003,45125,48878,49720,36821,608,896,40,3322,2596,470,2126,94003,87595,6408,0.4735,0.0149,26980,33128,34100,12264,21128,23278,40693,44415,11738,7630,37,127
"Bladen County, North Carolina",33778,16054,17724,19300,11827,842,35,0,1399,375,100,275,33778,31255,2523,0.4969,0.0412,20803,26304,26913,12361,12556,25115,,-666666666,13891,13839,37,017
"Dare County, North Carolina",35741,17614,18127,33092,779,107,228,0,585,950,100,850,35741,33174,2567,0.4299,0.0197,33550,34347,35628,12895,26586,20984,42160,-666666666,19787,19321,37,055
"Warren County, North Carolina",20033,9985,10048,8025,10162,1153,90,10,181,412,26,386,20033,19280,753,0.4874,0.0298,22461,29578,30201,15852,17398,20801,13291,,20241,16485,37,185
"Wilson County, North Carolina",81336,38362,42974,41594,32094,514,644,1,4520,1969,243,1726,81336,73026,8310,0.4681,0.0171,24273,31854,33394,11609,17495,8848,32132,,10904,6763,37,195
"Bertie County, North Carolina",19644,9895,9749,6841,11998,232,125,1,148,299,37,262,19644,19236,408,0.5027,0.0343,20430,30910,31186,10230,15064,14239,16261,,8676,7934,37,015
"Gates County, North Carolina",11563,5627,5936,7319,3891,108,55,0,10,180,0,180,11563,11522,41,0.3970,0.0297,25334,28355,28414,18459,20550,27114,11011,-666666666,,8907,37,073
"Graham County, North Carolina",8557,4210,4347,7514,13,898,0,1,43,88,0,88,8557,8428,129,0.4418,0.0329,19323,20038,20193,7670,9969,15285,-666666666,,,,37,075
"Martin County, North Carolina",23054,10805,12249,12561,9681,111,142,84,214,261,28,233,23054,22159,895,0.4835,0.0311,23269,27270,28147,10643,18749,14681,25106,,10351,9819,37,117
"Madison County, North Carolina",21405,10502,10903,20470,363,120,119,0,92,241,62,179,21405,20891,514,0.4719,0.0295,25326,25838,25936,15007,7298,22075,11430,-666666666,6426,24746,37,115
"Pamlico County, North Carolina",12742,6563,6179,9699,2324,29,75,0,157,458,68,390,12742,12265,477,0.4642,0.0283,27026,29471,29600,16260,21124,16914,20420,-666666666,11182,12343,37,137
"Perquimans County, North Carolina",13459,6493,6966,9903,3298,54,39,11,58,96,5,91,13459,13113,346,0.4390,0.0250,25809,29463,29607,17203,15531,40352,,,4300,17510,37,143
"Polk County, North Carolina",20458,9682,10776,18497,1062,16,77,4,606,196,0,196,20458,19274,1184,0.4498,0.0248,30344,32265,33136,14545,14496,,16956,,8420,11068,37,149
"Randolph County, North Carolina",142958,70428,72530,120675,8953,662,1663,92,8103,2810,312,2498,142958,126889,16069,0.4439,0.0219,24127,25346,26224,15898,17573,20271,13512,34496,20100,11102,37,151
"Rockingham County, North Carolina",91270,43989,47281,69070,16858,425,583,59,2487,1788,112,1676,91270,85774,5496,0.4480,0.0157,23604,26116,26361,15031,17444,22274,16222,,9178,7618,37,157
"Stokes County, North Carolina",45905,22483,23422,42680,1963,188,173,13,273,615,132,483,45905,44591,1314,0.4293,0.0289,25091,25549,25814,10252,20549,30118,19906,,3925,17477,37,169
"Washington County, North Carolina",12156,5726,6430,5670,5755,42,21,0,253,415,121,294,12156,11515,641,0.4626,0.0485,21043,24410,24826,10841,19311,15000,,-666666666,8431,7904,37,187
"Camden County, North Carolina",10447,5263,5184,8614,1462,20,186,0,24,141,0,141,10447,10151,296,0.3680,0.0292,26951,28099,28342,15190,24135,,13081,-666666666,21917,9007,37,029
"Clay County, North Carolina",10813,5125,5688,10464,226,36,20,16,9,42,0,42,10813,10473,340,0.4871,0.0473,26590,26863,27315,12928,22262,,,,,,37,043
"Cumberland County, North Carolina",332106,165152,166954,167727,122504,4626,8350,931,8603,19365,1397,17968,332106,294280,37826,0.4470,0.0078,24301,28014,29227,18171,21508,15410,26543,22085,18440,13679,37,051
"Gaston County, North Carolina",216585,104371,112214,166636,34616,758,3358,147,5752,5318,302,5016,216585,201943,14642,0.4599,0.0110,26069,27924,28663,13670,21288,20097,31377,11134,11738,12488,37,071
"Guilford County, North Carolina",523582,248019,275563,292060,176785,2507,25680,287,13409,12854,1470,11384,523582,482758,40824,0.4847,0.0069,29708,37419,39473,14721,20042,17024,26162,17638,14439,13192,37,081
"Jackson County, North Carolina",42256,20838,21418,35367,986,3480,296,0,779,1348,168,1180,42256,39880,2376,0.4473,0.0178,24073,25845,26464,9992,9997,18994,8921,-666666666,14216,10013,37,099
"Moore County, North Carolina",95629,46002,49627,79016,12120,823,1313,100,781,1476,130,1346,95629,89415,6214,0.4681,0.0141,33432,36329,37788,14858,18884,19895,35967,,14769,14030,37,125
"Robeson County, North Carolina",133442,64365,69077,38137,32092,52630,831,20,6748,2984,351,2633,133442,121876,11566,0.4891,0.0125,17881,23601,25183,9242,15127,16933,23238,,8571,10467,37,155
"Stanly County, North Carolina",61114,30445,30669,51312,6834,220,1173,9,514,1052,66,986,61114,58608,2506,0.4181,0.0103,24671,26309,26843,12027,14938,15584,19005,,14522,21187,37,167
"Wake County, North Carolina",1046558,508866,537692,688209,212597,3675,69931,434,39465,32247,3557,28690,1046558,941197,105361,0.4446,0.0047,39102,45193,47500,18104,25771,29295,41801,39352,16050,20483,37,183
"Yancey County, North Carolina",17667,8648,9019,16986,129,93,43,6,145,265,18,247,17667,16768,899,0.4431,0.0266,23264,23663,24304,7550,29695,19752,8595,,,8794,37,199
"Chatham County, North Carolina",69791,33477,36314,56190,8073,159,1083,30,2272,1984,256,1728,69791,61165,8626,0.4899,0.0150,39299,42975,46305,14925,23032,10106,88091,,10861,10104,37,037
"McDowell County, North Carolina",45109,22833,22276,41076,1625,173,337,14,1260,624,12,612,45109,42409,2700,0.4415,0.0247,22725,23511,23789,13514,13316,10868,48803,,10289,10338,37,111
"Johnston County, North Carolina",191172,93865,97307,148193,29837,1346,1150,62,5576,5008,927,4081,191172,165437,25735,0.4148,0.0112,25847,27909,29935,12488,21078,25551,24842,,10994,10251,37,101
"Jones County, North Carolina",9695,4828,4867,6363,3028,42,19,0,101,142,0,142,9695,9250,445,0.4662,0.0353,21539,24474,25343,12857,16355,12679,,-666666666,22779,4865,37,103
"Person County, North Carolina",39305,18989,20316,26797,10497,194,168,16,720,913,147,766,39305,37646,1659,0.4414,0.0211,25922,28569,28969,12426,21124,47740,24407,,6639,14646,37,145
"Brunswick County, North Carolina",126860,61281,65579,106198,13096,791,779,36,3246,2714,173,2541,126860,120832,6028,0.4461,0.0099,31204,33830,34172,15956,18851,26948,30755,16964,13779,10447,37,019
"Ashe County, North Carolina",26786,13168,13618,25468,199,97,120,19,470,413,162,251,26786,25450,1336,0.4470,0.0289,24039,24599,24974,12063,19216,13228,13666,,15555,8001,37,009
"Beaufort County, North Carolina",47243,22709,24534,33751,12051,110,38,0,298,995,207,788,47243,43634,3609,0.4875,0.0197,26233,30314,31909,11243,16720,5567,,-666666666,14370,8578,37,013
"Lenoir County, North Carolina",57227,27391,29836,31475,22536,171,266,18,717,2044,26,2018,57227,52863,4364,0.4653,0.0241,22361,26896,28700,10094,17684,24379,16886,,8904,9430,37,107
"Rutherford County, North Carolina",66532,32258,34274,57410,6455,338,293,13,834,1189,38,1151,66532,63715,2817,0.4601,0.0158,22493,23970,24265,16499,14043,18887,12352,,18744,3368,37,161
"Lincoln County, North Carolina",81441,40372,41069,72619,4067,190,556,34,2177,1798,314,1484,81441,75686,5755,0.4575,0.0131,29089,30356,31008,15770,19439,32243,39464,43076,14010,14206,37,109
"Onslow County, North Carolina",193912,107681,86231,144450,27479,1062,4045,402,3967,12507,1519,10988,193912,169818,24094,0.4034,0.0147,23783,24589,25101,20856,23604,25021,22656,63230,19160,15321,37,133
"Orange County, North Carolina",142938,68187,74751,106535,16557,784,11106,8,3707,4241,433,3808,142938,130924,12014,0.5194,0.0161,40650,45888,47980,16691,23284,19669,36222,,13452,15943,37,135
"Sampson County, North Carolina",63561,31231,32330,40962,16030,1208,374,0,3097,1890,331,1559,63561,51264,12297,0.4817,0.0247,21950,25710,29799,10043,16132,18895,23280,-666666666,10954,9526,37,163
"Yadkin County, North Carolina",37665,18666,18999,34511,1421,165,39,26,962,541,109,432,37665,33545,4120,0.4292,0.0184,23566,24349,25290,14148,19064,11285,,,12290,10011,37,197
"Avery County, North Carolina",17501,9488,8013,16011,782,237,149,0,95,227,48,179,17501,16605,896,0.4715,0.0260,20253,21491,21931,11884,3784,11368,10785,-666666666,18629,5837,37,011
"Burke County, North Carolina",89712,44798,44914,75948,5794,510,3256,139,2526,1539,67,1472,89712,84370,5342,0.4623,0.0175,23466,25201,25658,10232,15747,8714,18899,16882,7989,7445,37,023
"Caswell County, North Carolina",22746,11393,11353,14378,7503,51,151,47,377,239,14,225,22746,21879,867,0.4336,0.0267,22982,25436,25982,9682,19294,14002,38397,16253,10812,3853,37,033
"Davie County, North Carolina",41991,20374,21617,37492,2305,156,292,0,844,902,29,873,41991,39195,2796,0.4494,0.0273,29613,30982,31904,14939,18323,12723,20802,-666666666,17326,18817,37,059
"Duplin County, North Carolina",59062,28780,30282,41673,14450,208,164,46,1551,970,3,967,59062,46153,12909,0.4408,0.0162,19455,21708,26055,9566,14536,26411,9623,,8410,14046,37,061
"Durham County, North Carolina",306457,146535,159922,157366,113511,808,15063,117,10980,8612,1059,7553,306457,265268,41189,0.4750,0.0076,34063,42318,47945,15948,24972,29999,38927,30354,16059,17919,37,063
"Lee County, North Carolina",60125,29225,30900,44122,11902,485,644,23,1737,1212,209,1003,60125,48569,11556,0.4405,0.0164,23842,26246,30083,12162,17413,12866,31244,,15650,11812,37,105
"New Hanover County, North Carolina",224231,107274,116957,181701,31440,473,3010,185,2524,4898,238,4660,224231,212072,12159,0.4917,0.0084,32629,35611,36543,16826,18588,19554,39118,5976,18589,17641,37,129
"Wayne County, North Carolina",124002,60640,63362,77498,37855,333,1597,46,2854,3819,388,3431,124002,109682,14320,0.4707,0.0197,24124,28083,30724,11251,18373,29919,29105,26383,10323,8510,37,191
"Scotland County, North Carolina",35262,17398,17864,15650,13764,4039,274,17,653,865,49,816,35262,34232,1030,0.4639,0.0137,18242,23935,24054,17796,13377,15556,16054,,15036,8679,37,165
"Halifax County, North Carolina",51737,24959,26778,20741,27353,1980,395,67,188,1013,194,819,51737,50297,1440,0.4969,0.0217,21016,26030,26453,13598,16898,21045,64334,9175,23061,13023,37,083
"Alamance County, North Carolina",160576,76259,84317,112786,30742,462,2509,64,9933,4080,638,3442,160576,140671,19905,0.4600,0.0119,26215,29699,31077,13276,20393,25330,23146,27584,11355,11922,37,001
"Burke County, North Dakota",2213,1183,1030,2097,14,21,0,0,48,33,0,33,2213,2144,69,0.4247,0.0307,35806,36936,37142,17542,,3481,-666666666,-666666666,17965,,38,013
"Mountrail County, North Dakota",10152,5489,4663,6674,118,2810,46,0,195,309,14,295,10152,9388,764,0.4752,0.0312,37602,45810,47467,20941,18442,22336,20917,-666666666,31642,12709,38,061
"Williams County, North Dakota",34061,18751,15310,28315,1243,1010,220,17,1536,1720,327,1393,34061,31755,2306,0.4397,0.0316,43824,47582,47720,24226,30175,26211,38032,,20625,23802,38,105
"Billings County, North Dakota",946,556,390,873,11,5,0,0,20,37,37,0,946,889,57,0.4494,0.0550,45523,47913,47913,,,,-666666666,-666666666,,,38,007
"Kidder County, North Dakota",2460,1301,1159,2392,10,6,5,0,36,11,0,11,2460,2352,108,0.4679,0.0484,32364,31220,31789,47658,,,,-666666666,117211,,38,043
"Cavalier County, North Dakota",3824,1959,1865,3638,4,48,0,0,45,89,0,89,3824,3779,45,0.4774,0.0511,43125,44646,44655,17822,,16650,-666666666,-666666666,17820,9327,38,019
"Grant County, North Dakota",2380,1205,1175,2333,1,19,7,1,0,19,3,16,2380,2368,12,0.5165,0.0542,36287,36412,36508,13292,,40474,,,-666666666,15679,38,037
"Pembina County, North Dakota",7016,3649,3367,6579,20,195,25,0,52,145,1,144,7016,6772,244,0.4405,0.0292,36251,37307,37851,23465,,16330,74560,-666666666,39196,11795,38,067
"Steele County, North Dakota",1910,1001,909,1899,11,0,0,0,0,0,0,0,1910,1880,30,0.4160,0.0462,39403,39168,39669,,,-666666666,-666666666,-666666666,-666666666,-666666666,38,091
"Hettinger County, North Dakota",2576,1250,1326,2375,9,82,0,5,41,64,6,58,2576,2493,83,0.4832,0.0408,32474,34338,34360,22069,,13263,-666666666,8520,,5020,38,041
"LaMoure County, North Dakota",4100,2148,1952,3976,22,8,0,0,30,64,0,64,4100,4041,59,0.4697,0.0358,36584,36948,37074,19990,,,-666666666,-666666666,20237,26181,38,045
"Morton County, North Dakota",30544,15753,14791,28112,139,1232,138,0,347,576,21,555,30544,29584,960,0.4587,0.0338,39300,40360,40595,31751,29254,19553,13785,-666666666,27154,45682,38,059
"Cass County, North Dakota",174202,88346,85856,152505,8922,1631,5330,45,1121,4648,173,4475,174202,169697,4505,0.4708,0.0147,36655,38913,39243,16267,14630,19755,33133,,16797,19847,38,017
"Dunn County, North Dakota",4387,2298,2089,3701,68,436,38,9,60,75,0,75,4387,4268,119,0.5215,0.0458,44492,48327,48497,18884,15841,23985,31729,,35743,17595,38,025
"Emmons County, North Dakota",3352,1704,1648,3222,0,3,34,0,5,88,15,73,3352,3326,26,0.4556,0.0384,29417,29997,30030,33819,-666666666,,14582,-666666666,,15901,38,029
"McIntosh County, North Dakota",2654,1323,1331,2556,24,20,27,0,0,27,0,27,2654,2613,41,0.4493,0.0408,32389,32203,32316,25300,,30875,77089,-666666666,-666666666,10285,38,051
"Nelson County, North Dakota",2920,1485,1435,2844,2,6,1,0,41,26,6,20,2920,2845,75,0.4554,0.0306,33360,33658,33742,21728,,,,-666666666,18080,30446,38,063
"Richland County, North Dakota",16288,8528,7760,15179,119,313,43,0,180,454,42,412,16288,15804,484,0.4119,0.0243,30820,31380,31781,10455,19185,29114,10370,-666666666,14729,24641,38,077
"Rolette County, North Dakota",14603,7218,7385,2720,91,11390,23,0,39,340,23,317,14603,14510,93,0.5039,0.0314,19295,34258,34505,11886,3957,15886,13865,-666666666,9746,19359,38,079
"Walsh County, North Dakota",10802,5543,5259,10107,47,206,79,0,224,139,5,134,10802,9575,1227,0.4336,0.0157,31366,32618,34093,18656,3045,9759,20127,-666666666,19104,8081,38,099
"Adams County, North Dakota",2351,1115,1236,2188,50,28,78,0,0,7,0,7,2351,2310,41,0.4604,0.0350,33652,35253,35598,16522,12302,6075,15212,-666666666,-666666666,,38,001
"Bottineau County, North Dakota",6589,3457,3132,6138,62,232,15,0,39,103,20,83,6589,6441,148,0.4463,0.0290,35039,36158,36556,13307,16689,22181,,-666666666,28528,13655,38,009
"Barnes County, North Dakota",10836,5430,5406,10237,261,139,54,21,13,111,19,92,10836,10623,213,0.4480,0.0250,33868,34496,34800,15785,31572,8824,,3043,2077,16743,38,003
"Eddy County, North Dakota",2313,1085,1228,2038,0,176,0,0,0,99,0,99,2313,2313,0,0.5029,0.0469,34565,35770,35770,-666666666,-666666666,21738,-666666666,-666666666,-666666666,32549,38,027
"Grand Forks County, North Dakota",70400,36536,33864,60932,2822,1756,1891,110,1211,1678,13,1665,70400,67513,2887,0.4814,0.0188,31052,32925,33082,23405,16489,12519,31471,15494,21062,14691,38,035
"McKenzie County, North Dakota",12536,6822,5714,10404,70,1497,83,0,182,300,16,284,12536,11567,969,0.4616,0.0354,36798,41121,42708,17211,25896,15931,,-666666666,27385,7050,38,053
"Mercer County, North Dakota",8570,4406,4164,8087,76,245,39,0,108,15,0,15,8570,8321,249,0.3883,0.0318,38298,39065,39281,21700,,23489,49144,-666666666,15300,20773,38,057
"McLean County, North Dakota",9608,4958,4650,8683,64,690,10,2,38,121,9,112,9608,9379,229,0.4121,0.0232,35367,36462,36307,28545,28042,25357,,,14708,27273,38,055
"Pierce County, North Dakota",4210,2115,2095,3987,32,130,33,0,3,25,0,25,4210,4173,37,0.4546,0.0379,28008,28277,28173,36078,20091,18118,54730,-666666666,,12812,38,069
"Ransom County, North Dakota",5361,2677,2684,5153,38,12,42,0,19,97,0,97,5361,5264,97,0.4330,0.0464,34691,34868,35236,8787,,,30962,-666666666,,32708,38,073
"Sioux County, North Dakota",4413,2209,2204,576,6,3694,0,2,30,105,25,80,4413,4226,187,0.5365,0.0555,16706,35132,34733,16898,,13957,-666666666,,35270,7635,38,085
"Bowman County, North Dakota",3195,1590,1605,3079,1,37,0,0,44,34,0,34,3195,3022,173,0.4310,0.0431,36221,36823,37424,18363,,25327,-666666666,-666666666,,,38,011
"Golden Valley County, North Dakota",1882,892,990,1825,0,26,0,0,0,31,0,31,1882,1822,60,0.4474,0.0537,32590,33139,33550,18007,-666666666,24046,-666666666,-666666666,-666666666,,38,033
"Logan County, North Dakota",1927,1000,927,1902,1,5,2,0,2,15,0,15,1927,1903,24,0.4371,0.0361,33396,33176,33132,36592,,,,-666666666,,71927,38,047
"Towner County, North Dakota",2246,1197,1049,2054,0,82,12,0,3,95,4,91,2246,2190,56,0.4878,0.0548,36217,38469,38617,30111,-666666666,20444,,-666666666,,6795,38,095
"Stutsman County, North Dakota",21064,10875,10189,19613,263,293,125,13,163,594,101,493,21064,20557,507,0.4359,0.0256,32001,32753,32936,17309,14789,15298,23304,,42168,22770,38,093
"Divide County, North Dakota",2369,1174,1195,2192,26,33,60,0,0,58,2,56,2369,2312,57,0.5125,0.0330,45190,47700,48117,,,13473,,-666666666,-666666666,12750,38,023
"Foster County, North Dakota",3290,1616,1674,3184,7,42,1,0,0,56,0,56,3290,3239,51,0.3950,0.0251,33737,34254,34676,2994,,21664,,-666666666,-666666666,16396,38,031
"Sargent County, North Dakota",3883,2052,1831,3700,92,32,7,0,0,52,3,49,3883,3767,116,0.3781,0.0198,37039,37098,37621,18736,48447,24816,5443,-666666666,-666666666,24440,38,081
"Slope County, North Dakota",704,353,351,659,39,0,0,0,0,6,0,6,704,704,0,0.3953,0.0370,37340,37555,37555,-666666666,,-666666666,-666666666,-666666666,-666666666,18817,38,087
"Stark County, North Dakota",30876,15864,15012,28308,689,397,428,7,230,817,57,760,30876,29238,1638,0.4461,0.0236,37897,39819,40396,20463,30155,8939,10870,,6812,15018,38,089
"Gallia County, Ohio",30195,14802,15393,28502,716,116,211,33,37,580,25,555,30195,29796,399,0.4454,0.0180,22588,22911,22958,19407,18157,3411,33279,,,12003,39,053
"Huron County, Ohio",58457,28770,29687,55328,847,94,122,3,957,1106,81,1025,58457,54693,3764,0.4122,0.0147,25375,25989,26459,16083,15305,26893,18912,,14283,12598,39,077
"Athens County, Ohio",65936,32846,33090,59769,1889,333,1781,64,292,1808,50,1758,65936,64685,1251,0.5096,0.0160,20745,21319,21460,10219,16679,9072,19785,,17033,9937,39,009
"Adams County, Ohio",27878,13950,13928,27098,109,87,41,0,49,494,11,483,27878,27600,278,0.4933,0.0236,21543,21773,21848,14136,44894,13428,,-666666666,18808,6053,39,001
"Medina County, Ohio",177257,87695,89562,168911,2580,233,2208,17,807,2501,114,2387,177257,173703,3554,0.4089,0.0085,35979,36482,36622,22872,26397,25902,37402,,14167,18420,39,103
"Union County, Ohio",55654,26847,28807,50824,1481,152,2013,49,239,896,114,782,55654,54739,915,0.4045,0.0145,34691,34217,34287,28509,27660,62159,57001,,19515,18295,39,159
"Champaign County, Ohio",38864,19366,19498,36732,711,114,225,12,129,941,15,926,38864,38268,596,0.3797,0.0174,26515,27050,27205,20941,19447,13916,22771,,44214,10564,39,021
"Paulding County, Ohio",18872,9413,9459,17929,145,39,61,22,323,353,51,302,18872,17991,881,0.4027,0.0334,25918,26426,26680,17797,26927,28941,34095,,12937,10272,39,125
"Greene County, Ohio",165811,81592,84219,142463,11873,199,4939,17,891,5429,153,5276,165811,161189,4622,0.4444,0.0093,34682,36312,36285,30575,21909,23480,40460,,17855,17884,39,057
"Franklin County, Ohio",1275333,622353,652980,853540,283279,2473,65029,491,20285,50236,3289,46947,1275333,1206289,69044,0.4658,0.0038,32552,38224,39216,17779,19911,21726,30577,13099,17867,16678,39,049
"Marion County, Ohio",65344,34700,30644,58698,3775,122,393,21,428,1907,123,1784,65344,63645,1699,0.4336,0.0168,22878,23959,24150,7760,13391,10120,43875,,4895,9158,39,101
"Morgan County, Ohio",14702,7349,7353,13598,686,9,29,0,6,374,10,364,14702,14653,49,0.4449,0.0372,22454,22828,22832,18388,15724,,37666,-666666666,,19985,39,115
"Wayne County, Ohio",116208,57690,58518,109985,1705,340,1106,12,998,2062,130,1932,116208,113906,2302,0.4231,0.0127,26822,27190,27252,17878,20323,14767,37026,,17000,13960,39,169
"Wyandot County, Ohio",22107,10923,11184,21442,42,0,266,0,183,174,9,165,22107,21477,630,0.4119,0.0194,27037,27308,27597,14585,22621,-666666666,22375,-666666666,21352,7850,39,175
"Butler County, Ohio",378294,185536,192758,320477,30336,953,11658,318,4286,10266,516,9750,378294,360807,17487,0.4424,0.0050,30777,31994,32473,17537,25790,20921,32879,12780,13902,13625,39,017
"Harrison County, Ohio",15307,7566,7741,14632,343,12,74,0,77,169,3,166,15307,15154,153,0.4122,0.0166,24108,24313,24277,29382,22959,,,-666666666,30364,4519,39,067
"Knox County, Ohio",61215,29959,31256,59066,669,127,241,12,74,1026,41,985,61215,60320,895,0.4026,0.0127,25589,25941,26015,17565,21580,6768,20441,,28981,11499,39,083
"Richland County, Ohio",121324,61593,59731,105287,9555,217,965,33,466,4801,320,4481,121324,119084,2240,0.4300,0.0130,24545,26250,26463,8818,11947,16266,46100,,7338,10113,39,139
"Vinton County, Ohio",13111,6584,6527,12744,61,18,20,0,0,268,6,262,13111,13035,76,0.4146,0.0261,20823,21067,21104,14879,3448,,,-666666666,-666666666,12248,39,163
"Hancock County, Ohio",75690,37306,38384,69969,1150,43,1459,0,1030,2039,407,1632,75690,71686,4004,0.4320,0.0137,30794,31448,31826,19978,28027,23472,31075,-666666666,28646,10965,39,063
"Fairfield County, Ohio",152910,76254,76656,134357,10889,154,2294,63,931,4222,190,4032,152910,149668,3242,0.4244,0.0112,31136,32207,32308,21981,27172,19745,25632,,18598,13753,39,045
"Defiance County, Ohio",38279,19019,19260,34821,728,144,152,15,1191,1228,562,666,38279,34515,3764,0.4009,0.0198,28491,29349,29646,21304,19942,25985,62893,,25197,8476,39,039
"Henry County, Ohio",27316,13440,13876,25760,221,71,99,0,560,605,238,367,27316,25244,2072,0.3783,0.0211,28328,29190,29552,17885,13982,28721,23594,-666666666,15652,9320,39,069
"Jefferson County, Ohio",66886,32489,34397,61119,3683,82,329,0,139,1534,84,1450,66886,65954,932,0.4718,0.0202,25658,26451,26626,8221,20097,16460,16229,-666666666,9912,11371,39,081
"Putnam County, Ohio",33969,16960,17009,32137,120,13,65,12,1197,425,144,281,33969,31903,2066,0.3865,0.0150,30064,30824,31274,15626,22068,12731,28626,,17412,12093,39,137
"Clinton County, Ohio",41896,20769,21127,39523,855,46,190,11,160,1111,63,1048,41896,41241,655,0.4484,0.0296,26861,26259,26425,21199,68430,17530,25393,,29995,16113,39,027
"Fayette County, Ohio",28645,13960,14685,26876,583,7,261,9,225,684,87,597,28645,28040,605,0.4324,0.0163,24931,25627,25694,16110,21944,,14160,,11653,8730,39,047
"Pickaway County, Ohio",57420,30202,27218,53638,2027,140,272,0,208,1135,38,1097,57420,56639,781,0.4030,0.0175,26515,27679,27726,13191,7975,29702,11564,-666666666,10352,10794,39,129
"Logan County, Ohio",45307,22336,22971,42913,761,70,389,3,111,1060,24,1036,45307,44626,681,0.4200,0.0170,27840,28203,28297,21110,29556,21964,31525,,18693,11618,39,091
"Summit County, Ohio",541810,262858,278952,426912,78052,1183,17901,71,2235,15456,853,14603,541810,530642,11168,0.4687,0.0054,32055,35259,35465,21687,20300,40399,24891,17190,17652,12719,39,153
"Sandusky County, Ohio",59299,29394,29905,53723,1754,158,200,9,1826,1629,264,1365,59299,53477,5822,0.4149,0.0138,26256,27603,28195,17923,15358,19698,20197,,16458,6012,39,143
"Shelby County, Ohio",48797,24657,24140,45915,1298,172,472,0,150,790,102,688,48797,48048,749,0.4059,0.0208,29008,29508,29609,18828,14640,21230,34363,-666666666,7286,26182,39,149
"Cottonwood County, Minnesota",11372,5662,5710,10209,85,37,398,26,450,167,0,167,11372,10528,844,0.4051,0.0221,27209,29178,29819,9168,12971,17276,13647,,7322,4576,27,033
"Scott County, Minnesota",143372,71406,71966,120909,5840,1082,8804,117,3176,3444,191,3253,143372,136097,7275,0.3965,0.0088,39952,42140,42777,18779,20658,82667,34065,19136,15585,20648,27,139
"Dodge County, Minnesota",20582,10334,10248,19671,49,90,167,2,315,288,26,262,20582,19551,1031,0.3795,0.0169,32795,33571,34330,14429,16680,25248,17667,,20021,7744,27,039
"Wabasha County, Minnesota",21500,10779,10721,20687,124,55,92,0,242,300,21,279,21500,20887,613,0.4109,0.0150,33664,34318,34593,14381,16567,19142,24655,-666666666,12133,18434,27,157
"Pipestone County, Minnesota",9185,4441,4744,8512,129,155,85,0,163,141,12,129,9185,8581,604,0.4641,0.0293,29716,31097,32111,8855,9844,6815,29833,-666666666,10473,11836,27,117
"Crow Wing County, Minnesota",63855,31966,31889,61333,479,610,262,0,80,1091,68,1023,63855,62932,923,0.4527,0.0149,30900,31372,31523,18700,14340,25523,26106,-666666666,48753,14451,27,035
"Norman County, Minnesota",6559,3324,3235,6112,35,166,41,0,74,131,5,126,6559,6230,329,0.4143,0.0165,28351,28986,29423,14751,3251,16307,60529,-666666666,7399,22475,27,107
"Wright County, Minnesota",132745,66913,65832,125561,1857,449,1496,15,1125,2242,159,2083,132745,128938,3807,0.3863,0.0128,34325,34959,35303,17185,28524,33823,27008,,16928,17099,27,171
"Nicollet County, Minnesota",33783,16937,16846,31260,1064,10,592,0,221,636,81,555,33783,32280,1503,0.4200,0.0227,31225,32382,32982,16071,8909,,27585,-666666666,11656,22249,27,103
"Douglas County, Minnesota",37203,18607,18596,36070,177,114,111,0,214,517,52,465,37203,36609,594,0.4411,0.0263,34547,34873,35088,19086,56311,16498,17190,-666666666,27565,14915,27,041
"Grant County, Minnesota",5938,3020,2918,5764,10,24,1,0,24,115,6,109,5938,5804,134,0.4472,0.0290,31940,32323,32453,25857,,7988,,-666666666,,17886,27,051
"Kittson County, Minnesota",4337,2199,2138,4237,38,16,15,0,6,25,2,23,4337,4246,91,0.4007,0.0271,29946,30420,30671,19279,4555,,11327,-666666666,,13636,27,069
"Le Sueur County, Minnesota",27983,14106,13877,26897,235,54,138,3,334,322,17,305,27983,26340,1643,0.3955,0.0110,32120,32539,33599,13470,7761,20278,38654,,23040,23689,27,079
"Mahnomen County, Minnesota",5506,2728,2778,2599,28,2223,21,15,15,605,26,579,5506,5277,229,0.4381,0.0175,20953,29069,29687,5228,14071,12817,41167,13340,9013,16086,27,087
"Chisago County, Minnesota",54727,28333,26394,52149,699,254,552,16,153,904,25,879,54727,53581,1146,0.3572,0.0105,33927,34627,34877,19286,11740,22458,27335,,16913,21171,27,025
"Redwood County, Minnesota",15331,7719,7612,13538,119,751,439,0,266,218,19,199,15331,14821,510,0.4171,0.0138,28011,29635,29835,11847,12912,17134,14678,-666666666,16158,14161,27,127
"Yellow Medicine County, Minnesota",9868,5056,4812,9097,62,350,62,0,92,205,14,191,9868,9420,448,0.4162,0.0151,29379,30255,30683,13873,16024,19858,18744,-666666666,24025,16401,27,173
"Todd County, Minnesota",24440,12563,11877,23131,150,113,117,12,459,458,55,403,24440,23041,1399,0.4108,0.0099,25848,26486,26981,13282,6680,23876,18670,,17411,11377,27,153
"Beltrami County, Minnesota",46117,22906,23211,33707,524,9547,373,27,50,1889,53,1836,46117,45053,1064,0.4512,0.0203,24781,28888,29020,12311,11905,12558,50934,14530,8602,12244,27,007
"Blue Earth County, Minnesota",66322,33323,32999,60419,2299,226,1508,24,261,1585,115,1470,66322,64017,2305,0.4430,0.0114,28824,30044,30407,17415,13425,24732,23926,13754,15861,12241,27,013
"Houston County, Minnesota",18663,9349,9314,18120,185,42,131,3,37,145,11,134,18663,18461,202,0.3941,0.0141,31453,31952,32183,16281,14103,24129,5446,,57714,10415,27,055
"Lac qui Parle County, Minnesota",6773,3377,3396,6538,57,14,56,0,57,51,7,44,6773,6624,149,0.4542,0.0193,31686,32381,32600,13623,14575,23743,13632,-666666666,11656,6047,27,073
"Lake of the Woods County, Minnesota",3809,2037,1772,3546,1,11,32,0,0,219,54,165,3809,3745,64,0.3610,0.0251,26526,27009,27015,19041,,,,-666666666,-666666666,15388,27,077
"Otter Tail County, Minnesota",57992,29263,28729,55217,802,296,349,9,457,862,16,846,57992,56047,1945,0.4283,0.0088,30846,31521,31940,16493,16495,24797,16532,10244,17688,16037,27,111
"Waseca County, Minnesota",18809,9000,9809,17540,382,176,105,4,237,365,59,306,18809,17700,1109,0.4175,0.0187,28067,28644,29430,21126,10895,14766,15871,,62691,5809,27,161
"St. Louis County, Minnesota",200080,100487,99593,184602,2984,3705,2100,96,706,5887,205,5682,200080,196796,3284,0.4465,0.0067,30321,31505,31676,14907,17018,19218,22009,33786,15756,11601,27,137
"Anoka County, Minnesota",347431,173811,173620,292678,20497,2289,14987,97,5541,11342,1206,10136,347431,332101,15330,0.3903,0.0073,35806,38466,38882,19149,20199,26187,29537,131287,15827,14534,27,003
"Stearns County, Minnesota",156819,78931,77888,139218,9087,434,3367,9,2016,2688,261,2427,156819,151651,5168,0.4302,0.0079,29815,31720,32075,14886,11637,29762,23258,,14063,12738,27,145
"Lincoln County, Minnesota",5707,2855,2852,5579,15,58,9,0,14,32,2,30,5707,5598,109,0.4316,0.0209,28504,28808,29018,10677,14787,21328,,-666666666,,12425,27,081
"Marshall County, Minnesota",9392,4761,4631,9121,36,28,31,2,43,131,11,120,9392,8977,415,0.3922,0.0150,29670,30046,30752,13758,16064,25464,34135,,19172,10804,27,089
"Mille Lacs County, Minnesota",25728,12866,12862,23278,109,1293,206,13,85,744,5,739,25728,25124,604,0.4191,0.0178,26679,27835,28051,13866,7706,16774,8883,,40931,13794,27,095
"Washington County, Minnesota",253317,125332,127985,217742,11056,1025,13974,87,1735,7698,1079,6619,253317,243069,10248,0.4176,0.0076,43789,46417,47045,25412,22104,29878,35755,32041,27069,20913,27,163
"Carlton County, Minnesota",35540,18565,16975,31723,629,1940,180,0,39,1029,56,973,35540,34915,625,0.4071,0.0138,28117,29712,29949,10408,8827,18777,16625,-666666666,21882,10602,27,017
"Kanabec County, Minnesota",16004,8133,7871,15412,56,136,86,2,20,292,11,281,16004,15756,248,0.4019,0.0161,27331,27679,27920,9858,15071,23551,22820,,5925,15962,27,065
"Koochiching County, Minnesota",12644,6327,6317,11820,61,456,59,0,8,240,5,235,12644,12603,41,0.4583,0.0348,29051,30186,30197,19895,2723,12848,14588,-666666666,,15140,27,071
"Red Lake County, Minnesota",4008,2034,1974,3799,12,53,3,0,30,111,12,99,4008,3859,149,0.4097,0.0250,29731,30534,31055,14844,,21251,,-666666666,34857,7923,27,125
"Morrison County, Minnesota",32949,16639,16310,31874,176,73,154,0,220,452,58,394,32949,32402,547,0.4342,0.0237,28792,29307,29445,14932,4255,31979,12314,-666666666,14910,13899,27,097
"Rice County, Minnesota",65765,33580,32185,57204,3523,248,1388,73,2107,1222,146,1076,65765,60543,5222,0.4275,0.0103,29767,32475,33315,13674,9348,6582,18523,16948,12579,9764,27,131
"Steele County, Minnesota",36676,18171,18505,33297,1112,116,532,31,1184,404,43,361,36676,33870,2806,0.4055,0.0147,30822,32660,33302,16880,10687,3571,8932,16003,16137,15564,27,147
"Aitkin County, Minnesota",15834,8053,7781,15011,89,345,57,14,35,283,15,268,15834,15620,214,0.4275,0.0117,27646,28223,28348,13208,11879,16369,35819,,7549,15551,27,001
"Faribault County, Minnesota",13896,6949,6947,13539,25,32,39,0,59,202,0,202,13896,12968,928,0.4317,0.0230,29748,28912,30115,21038,16504,24397,15333,-666666666,22888,93043,27,043
"Murray County, Minnesota",8353,4170,4183,8066,49,19,104,0,33,82,14,68,8353,8033,320,0.4055,0.0156,31768,31811,32497,12850,23243,53500,39552,-666666666,18339,23122,27,101
"Kandiyohi County, Minnesota",42658,21430,21228,37786,2056,178,387,0,1553,698,122,576,42658,37581,5077,0.4338,0.0142,30217,32522,34220,14264,10544,14543,15407,-666666666,13822,12103,27,067
"Lake County, Minnesota",10569,5428,5141,10213,78,61,3,43,41,130,2,128,10569,10407,162,0.3855,0.0190,33602,33962,33915,38534,22524,18666,,,44105,24981,27,075
"Rock County, Minnesota",9413,4625,4788,9054,107,68,97,0,43,44,0,44,9413,9131,282,0.4288,0.0290,30544,30998,30661,36535,25536,28253,17169,-666666666,8842,3511,27,133
"Sibley County, Minnesota",14912,7570,7342,14301,127,49,100,5,207,123,25,98,14912,13586,1326,0.4063,0.0144,30977,31709,33177,13342,10419,34412,21183,,12789,5145,27,143
"Traverse County, Minnesota",3337,1644,1693,3078,22,149,10,0,9,69,3,66,3337,3246,91,0.4292,0.0219,30553,31667,32237,11852,12259,21411,,-666666666,,7587,27,155
"Becker County, Minnesota",33773,16783,16990,29630,186,2510,206,8,93,1140,50,1090,33773,33099,674,0.4331,0.0140,29710,31420,31752,11194,11063,17588,27079,31338,9615,17120,27,005
"Hennepin County, Minnesota",1235478,610530,624948,897497,161230,8819,87536,451,35370,44575,3841,40734,1235478,1150214,85264,0.4872,0.0038,43976,51655,53187,18638,18156,18307,37910,20553,17370,21098,27,053
"Brown County, Minnesota",25211,12653,12558,24139,186,61,141,0,492,192,7,185,25211,24135,1076,0.4103,0.0237,30373,31055,31336,14355,14134,24718,33014,-666666666,10335,11572,27,015
"Chippewa County, Minnesota",12010,5959,6051,10915,82,222,111,137,437,106,7,99,12010,11185,825,0.4185,0.0210,30168,31787,32241,16854,16313,21853,14194,9860,12197,8673,27,023
"Clearwater County, Minnesota",8812,4504,4308,7576,34,748,39,2,15,398,30,368,8812,8631,181,0.4636,0.0205,26173,28077,28238,15370,36400,12450,37467,,48627,12966,27,029
"Hubbard County, Minnesota",20862,10550,10312,19560,154,456,124,0,132,436,35,401,20862,20433,429,0.4191,0.0098,29312,30149,30176,18129,8378,15455,29834,-666666666,13780,18201,27,057
"Isanti County, Minnesota",38974,19720,19254,37154,190,160,506,6,186,772,18,754,38974,38223,751,0.3890,0.0157,32008,32694,32912,16479,16247,17454,24356,,17025,14751,27,059
"Martin County, Minnesota",19964,10068,9896,19208,64,25,75,13,254,325,7,318,19964,19113,851,0.4358,0.0177,31091,31487,32051,19202,2938,19420,22352,,31735,16744,27,091
"Mower County, Minnesota",39602,20045,19557,34984,1425,67,1230,156,862,878,238,640,39602,35131,4471,0.4485,0.0141,29116,30930,32850,14548,15622,9266,16479,,20398,10339,27,099
"Pine County, Minnesota",29129,15648,13481,26637,660,717,167,23,127,798,36,762,29129,28293,836,0.4385,0.0139,25302,26224,26529,12171,13698,16826,15843,,17002,15586,27,115
"Olmsted County, Minnesota",153065,74836,78229,128902,9064,477,8908,70,1575,4069,292,3777,153065,145663,7402,0.4520,0.0077,39667,42360,43263,21709,14834,22100,40264,,19585,18626,27,109
"Wadena County, Minnesota",13646,6727,6919,13063,147,108,57,0,69,202,1,201,13646,13389,257,0.4230,0.0239,24864,25418,25607,11901,10203,16789,28884,-666666666,13088,6911,27,159
"Benton County, Minnesota",39779,19894,19885,36689,1322,32,438,0,221,1077,29,1048,39779,38876,903,0.4192,0.0142,28566,29480,29795,16069,12735,106694,20435,-666666666,28837,17786,27,009
"Freeborn County, Minnesota",30526,15217,15309,28440,408,128,671,16,404,459,108,351,30526,27588,2938,0.4189,0.0201,28459,29524,30981,12751,9427,14896,14460,,13930,15485,27,047
"McLeod County, Minnesota",35825,17922,17903,34005,200,68,224,0,855,473,30,443,35825,33662,2163,0.4113,0.0235,31723,32624,33404,11539,19015,30431,27512,-666666666,8347,16739,27,085
"Pope County, Minnesota",10980,5562,5418,10624,41,23,58,0,80,154,1,153,10980,10831,149,0.4212,0.0209,32943,33532,33634,14009,24383,19352,23807,-666666666,11219,11340,27,121
"Stevens County, Minnesota",9784,4910,4874,9039,133,123,215,34,81,159,19,140,9784,9230,554,0.4930,0.0398,31694,32270,32960,15141,66859,10387,20935,,6126,18684,27,149
"Swift County, Minnesota",9411,4726,4685,8935,230,2,30,39,139,36,0,36,9411,8958,453,0.4576,0.0180,30208,31164,31737,14743,10287,,11533,,14530,21275,27,151
"Holmes County, Mississippi",18075,8635,9440,2854,15140,9,8,0,46,18,7,11,18075,18029,46,0.5592,0.0307,13924,26507,26696,7135,11559,,,-666666666,,34117,28,051
"Amite County, Mississippi",12468,6007,6461,7156,5239,3,38,0,0,32,0,32,12468,12468,0,0.4923,0.0327,20380,24746,24746,-666666666,13234,,,-666666666,-666666666,6413,28,005
"Calhoun County, Mississippi",14571,6991,7580,9542,3962,0,33,24,746,264,19,245,14571,13713,858,0.4339,0.0191,19099,21813,21985,8526,15559,-666666666,,,8677,2372,28,013
"Tishomingo County, Mississippi",19478,9491,9987,18456,557,33,10,0,258,164,24,140,19478,18864,614,0.4352,0.0247,20037,20496,20707,8762,13225,,,-666666666,11123,6857,28,141
"Wayne County, Mississippi",20422,10072,10350,11748,8401,64,14,0,48,147,0,147,20422,20368,54,0.4919,0.0356,22611,29622,29622,19417,12995,28239,,-666666666,,10190,28,153
"Austin County, Texas",29565,14684,14881,23810,2626,48,89,0,2431,561,48,513,29565,21746,7819,0.4278,0.0203,30858,34502,38430,18465,16258,,17293,-666666666,13933,21802,48,015
"Kenedy County, Texas",595,286,309,573,0,0,1,0,21,0,0,0,595,73,522,0.3614,0.0711,15820,15544,21825,14910,-666666666,-666666666,,-666666666,,-666666666,48,261
"Nueces County, Texas",360486,178020,182466,324198,13620,1638,7370,242,7587,5831,2060,3771,360486,132024,228462,0.4657,0.0089,27649,27858,40323,21612,23626,24753,33837,36589,25203,21245,48,355
"Colorado County, Texas",21022,10538,10484,15479,2665,35,7,0,2489,347,128,219,21022,14822,6200,0.4656,0.0287,27861,30465,34201,17626,24026,,35357,-666666666,16765,20961,48,089
"San Patricio County, Texas",67046,33721,33325,61920,1124,177,693,43,1407,1682,314,1368,67046,28563,38483,0.4412,0.0147,25281,25945,34891,19243,17080,17589,16833,16758,20831,14559,48,409
"Rains County, Texas",11473,5868,5605,10372,322,69,8,0,449,253,29,224,11473,10454,1019,0.4363,0.0327,26165,26962,27851,15334,29478,5907,,-666666666,20302,5657,48,379
"Randall County, Texas",132475,65083,67392,118502,3903,570,2162,73,2932,4333,943,3390,132475,104797,27678,0.4285,0.0116,33814,35019,38026,21680,21451,27129,43351,15347,21103,17028,48,381
"Real County, Texas",3389,1426,1963,3355,5,0,2,0,26,1,0,1,3389,2717,672,0.4749,0.0490,21109,21121,23437,11743,,-666666666,,-666666666,20027,,48,385
"San Saba County, Texas",5962,3073,2889,5106,143,0,3,0,443,267,15,252,5962,4172,1790,0.4750,0.0467,24307,26898,30325,14390,2678,-666666666,,-666666666,10439,8309,48,411
"Schleicher County, Texas",3061,1542,1519,1871,13,0,0,0,1176,1,0,1,3061,1458,1603,0.4027,0.0397,25128,27759,29557,21222,,-666666666,-666666666,-666666666,21056,,48,413
"Sterling County, Texas",1141,622,519,1037,3,0,0,0,85,16,0,16,1141,625,516,0.3364,0.0445,28997,28534,29746,27489,,-666666666,-666666666,-666666666,30839,53700,48,431
"Zavala County, Texas",12131,6208,5923,11359,60,0,4,0,578,130,6,124,12131,759,11372,0.4233,0.0282,13350,12883,15252,13275,11290,-666666666,,-666666666,23812,9049,48,507
"Calhoun County, Texas",21807,11062,10745,18896,561,19,1032,17,339,943,74,869,21807,11243,10564,0.4195,0.0263,26596,27028,32773,21428,15568,20732,30237,,26143,21104,48,057
"Carson County, Texas",6032,2820,3212,5713,78,79,31,0,57,74,14,60,6032,5432,600,0.4151,0.0268,32917,34113,35226,23306,5888,13724,5419,-666666666,26649,5959,48,065
"Foard County, Texas",1408,712,696,1212,25,0,0,0,93,78,78,0,1408,1120,288,0.4230,0.0675,25636,26261,26768,22403,,-666666666,-666666666,-666666666,32883,11251,48,155
"Freestone County, Texas",19709,10163,9546,15965,3128,14,133,0,191,278,69,209,19709,16725,2984,0.4573,0.0223,24083,26672,29967,10559,13709,14057,24271,-666666666,6977,4333,48,161
"Goliad County, Texas",7531,3734,3797,5917,386,0,43,0,1164,21,0,21,7531,4832,2699,0.4612,0.0293,29918,33360,36726,20563,18111,-666666666,8819,-666666666,16802,47319,48,175
"Hamilton County, Texas",8269,4070,4199,7845,42,62,24,0,151,145,43,102,8269,7250,1019,0.4932,0.0556,28074,27017,28578,14503,8238,9560,,-666666666,16911,15963,48,193
"Hardeman County, Texas",3952,1938,2014,3411,280,41,0,0,124,96,0,96,3952,3101,851,0.4449,0.0334,22938,24045,26923,14021,13569,36878,-666666666,-666666666,19498,9418,48,197
"Mitchell County, Texas",8558,5383,3175,6754,941,82,30,0,490,261,146,115,8558,5177,3381,0.4294,0.0472,20896,24522,28125,16541,7562,19672,,-666666666,3224,11089,48,335
"Briscoe County, Texas",1546,831,715,1319,38,0,0,17,26,146,27,119,1546,1001,545,0.4326,0.0319,24286,26456,32126,13680,9305,-666666666,-666666666,24818,13869,10374,48,045
"Lavaca County, Texas",19941,9684,10257,15654,1290,49,71,5,2294,578,338,240,19941,16247,3694,0.4768,0.0218,31670,36130,36670,18561,14704,9416,13582,,17012,11255,48,285
"Terry County, Texas",12615,6515,6100,11230,640,41,0,0,457,247,97,150,12615,5756,6859,0.4289,0.0285,20127,21118,28831,14495,11495,4934,-666666666,-666666666,12455,14195,48,445
"Jeff Davis County, Texas",2234,1114,1120,2116,18,9,51,0,24,16,0,16,2234,1507,727,0.3696,0.0416,26053,26837,32365,15316,,,3508,-666666666,10142,,48,243
"Webb County, Texas",272053,132906,139147,259619,1168,471,1361,33,7882,1519,654,865,272053,12256,259797,0.4880,0.0106,17326,17123,32807,16560,26682,18358,48114,,18580,10405,48,479
"Jim Hogg County, Texas",5282,2550,2732,5222,4,2,0,0,26,28,9,19,5282,392,4890,0.4975,0.0437,17798,17760,12573,18155,,,-666666666,-666666666,,29679,48,247
"Montgomery County, Texas",554445,274604,279841,479421,26178,2057,15765,346,15897,14781,2037,12744,554445,423298,131147,0.4800,0.0086,39618,40815,46751,20252,34276,35379,52143,17688,20314,18740,48,339
"Dallam County, Texas",7243,3795,3448,6638,63,87,107,0,123,225,109,116,7243,3983,3260,0.4924,0.0762,26844,27655,33819,19569,56810,16136,7358,-666666666,26411,8155,48,111
"Armstrong County, Texas",1916,960,956,1830,7,29,0,0,37,13,1,12,1916,1785,131,0.3662,0.0356,31075,31488,31710,26602,19429,25948,-666666666,-666666666,25435,,48,011
"Castro County, Texas",7787,3905,3882,7079,70,17,92,1,265,263,30,233,7787,2784,5003,0.4088,0.0375,20915,21839,28448,17235,30204,22006,11901,,9767,7769,48,069
"Kleberg County, Texas",31425,16052,15373,27560,1025,72,695,0,1296,777,91,686,31425,8576,22849,0.4958,0.0334,21986,22586,31769,19649,24370,54406,15133,-666666666,16869,9218,48,273
"Willacy County, Texas",21754,11681,10073,20888,146,133,0,0,498,89,32,57,21754,2584,19170,0.5015,0.0269,14207,14218,29257,12285,15336,16502,-666666666,-666666666,11858,19433,48,489
"Crosby County, Texas",5861,2921,2940,5233,240,0,14,0,280,94,51,43,5861,2600,3261,0.4598,0.0356,19155,19769,27334,13884,12511,-666666666,,-666666666,16024,14136,48,107
"Fisher County, Texas",3883,1879,2004,3467,114,35,23,5,97,142,14,128,3883,2698,1185,0.4761,0.0572,28355,29368,32554,21875,17646,14263,21226,,26807,18625,48,151
"Duval County, Texas",11355,5758,5597,9884,191,32,0,0,1222,26,18,8,11355,1220,10135,0.4629,0.0294,17864,18039,16635,18200,6576,,-666666666,-666666666,18056,34273,48,131
"Blanco County, Texas",11279,5781,5498,10171,58,116,165,39,353,377,86,291,11279,9106,2173,0.4468,0.0369,34925,36555,39544,18006,33266,8243,33493,,20382,15093,48,031
"Jasper County, Texas",35504,17501,18003,27662,5849,109,172,51,1094,567,69,498,35504,33144,2360,0.4662,0.0307,25004,27032,27532,15546,16907,23471,67187,,15424,9618,48,241
"Kinney County, Texas",3675,2290,1385,3555,3,7,0,0,109,1,1,0,3675,1378,2297,0.4537,0.0358,20323,20805,25278,17351,,,-666666666,-666666666,4439,,48,271
"Deaf Smith County, Texas",18899,9507,9392,16893,194,92,103,16,977,624,88,536,18899,5240,13659,0.3953,0.0235,21515,21969,32996,17663,7950,35193,28369,,21149,10420,48,117
"Galveston County, Texas",327089,161269,165820,255662,41265,1481,10725,213,7701,10042,1387,8655,327089,247683,79406,0.4729,0.0083,35448,38330,43662,22436,23537,30388,38246,19539,21050,20148,48,167
"La Salle County, Texas",7409,4408,3001,5763,102,0,12,0,1242,290,117,173,7409,1305,6104,0.5494,0.1002,25129,27470,46414,21694,2825,-666666666,,-666666666,16330,25166,48,283
"Roberts County, Texas",885,401,484,844,0,0,8,0,5,28,0,28,885,762,123,0.3800,0.0440,31632,32309,36751,5744,-666666666,-666666666,,-666666666,,21682,48,393
"Tyler County, Texas",21496,11738,9758,18060,2450,12,60,0,527,387,10,377,21496,19875,1621,0.4244,0.0213,20439,22237,23049,14803,6714,4067,12493,-666666666,26291,17213,48,457
"Wheeler County, Texas",5482,2844,2638,4820,160,20,5,17,293,167,3,164,5482,4034,1448,0.4362,0.0265,26844,28561,31936,15625,11388,16465,,,14000,18600,48,483
"Bowie County, Texas",93858,47275,46583,64640,23061,877,1012,44,1692,2532,319,2213,93858,86760,7098,0.4912,0.0201,25355,28985,30067,12162,17093,18474,53129,,9080,10511,48,037
"Brewster County, Texas",9216,4558,4658,8504,21,179,154,0,201,157,45,112,9216,5117,4099,0.4530,0.0320,27227,27699,34297,20143,22581,19360,19197,-666666666,37400,6089,48,043
"Kent County, Texas",749,327,422,663,8,14,0,0,58,6,0,6,749,627,122,0.4826,0.0477,29503,30308,31755,20535,,21436,-666666666,-666666666,27295,,48,263
"Smith County, Texas",225015,108730,116285,172884,39321,778,3875,299,4018,3840,688,3152,225015,181638,43377,0.4683,0.0098,27141,29621,34028,14128,18368,25136,32095,11189,18386,11085,48,423
"Crockett County, Texas",3633,1771,1862,1520,32,0,0,0,2056,25,0,25,3633,1327,2306,0.4195,0.0592,24852,32837,34618,19339,,-666666666,-666666666,-666666666,19219,,48,105
"Hardin County, Texas",56379,27342,29037,51670,3205,110,326,0,168,900,175,725,56379,53237,3142,0.4646,0.0232,29108,30218,30807,20725,14709,7915,14410,-666666666,35181,23443,48,199
"Howard County, Texas",36667,20732,15935,30180,2287,437,299,18,2279,1167,496,671,36667,21273,15394,0.4798,0.0262,23784,25486,34201,12663,15733,15380,21514,,15828,15177,48,227
"Leon County, Texas",17098,8602,8496,15184,1229,89,136,52,262,146,13,133,17098,14641,2457,0.5351,0.0665,32130,34107,36467,18141,17571,10602,18797,,8397,20488,48,289
"Montague County, Texas",19409,9403,10006,18398,120,32,0,0,206,653,47,606,19409,17298,2111,0.4474,0.0289,28457,29549,30831,15026,2353,57669,-666666666,-666666666,10878,6600,48,337
"Panola County, Texas",23440,11498,11942,18983,4023,29,57,0,167,181,15,166,23440,21427,2013,0.4579,0.0266,26403,28402,29874,14417,18056,,5651,-666666666,15875,18322,48,365
"Millard County, Utah",12733,6545,6188,11219,5,150,118,13,1002,226,21,205,12733,11071,1662,0.4287,0.0507,25847,27556,28152,15526,,18924,16919,,14065,4005,49,027
"Washington County, Utah",160537,79500,81037,145948,1130,2392,1219,1351,5236,3261,499,2762,160537,144102,16435,0.4384,0.0192,26601,27580,28555,15163,11638,15047,34341,15203,16625,14296,49,053
"Kane County, Utah",7350,3693,3657,6847,29,105,53,10,116,190,22,168,7350,7008,342,0.4306,0.0313,25746,26327,26512,11218,,40244,,,1601,19493,49,025
"Grand County, Utah",9616,4779,4837,8933,51,297,186,62,0,87,0,87,9616,8616,1000,0.3707,0.0334,24593,25446,26543,16736,,19320,,,-666666666,,49,019
"Rich County, Utah",2350,1152,1198,2282,0,0,0,0,68,0,0,0,2350,2094,256,0.4257,0.0428,21465,21957,24513,1925,-666666666,-666666666,-666666666,-666666666,4953,-666666666,49,033
"Wasatch County, Utah",30523,15544,14979,28962,95,34,383,5,359,685,49,636,30523,26441,4082,0.4260,0.0258,32805,33638,35908,15779,23845,,23253,,14452,15232,49,051
"Box Elder County, Utah",53001,26887,26114,49365,303,647,420,34,1332,900,226,674,53001,48089,4912,0.3801,0.0150,23998,24413,25254,13390,13714,18134,29053,48435,17641,15054,49,003
"Iron County, Utah",49691,24834,24857,45242,264,1173,323,27,1500,1162,50,1112,49691,45426,4265,0.4389,0.0195,20861,21855,22128,13190,8560,10976,23904,,7578,11655,49,021
"Sevier County, Utah",21118,10815,10303,19932,149,379,12,16,510,120,22,98,21118,20042,1076,0.4135,0.0222,22349,22942,23247,11348,6933,17568,38250,,11075,2745,49,041
"Weber County, Utah",247731,124402,123329,220647,2700,1712,2725,711,10680,8556,915,7641,247731,202697,45034,0.4007,0.0094,26492,27361,29113,17180,25021,21761,29329,17920,18357,15465,49,057
"Duchesne County, Utah",20219,10312,9907,18129,91,802,109,52,684,352,5,347,20219,18558,1661,0.3906,0.0179,23945,24847,25173,15906,26846,15120,27646,9250,13459,18223,49,013
"San Juan County, Utah",15281,7670,7611,7377,36,7315,62,40,55,396,26,370,15281,14418,863,0.4741,0.0325,18128,25079,26225,14810,17950,11423,,16550,30647,12849,49,037
"Salt Lake County, Utah",1120805,562543,558262,887562,20539,8616,45043,16723,105656,36666,7706,28960,1120805,917665,203140,0.4360,0.0046,31648,34871,36431,17240,21120,17403,31397,18754,15484,15635,49,035
"Uintah County, Utah",36323,18496,17827,31960,201,2731,128,31,498,774,144,630,36323,33257,3066,0.4379,0.0307,25610,25441,26307,14493,8084,33517,17217,,19710,14557,49,047
"Daggett County, Utah",612,359,253,585,1,8,0,0,7,11,0,11,612,592,20,0.3435,0.0733,27698,28729,29001,4125,,,-666666666,-666666666,,,49,009
"Davis County, Utah",340621,171584,169037,306564,4530,1453,6117,2118,8231,11608,2302,9306,340621,308446,32175,0.3813,0.0067,29703,30534,31297,18984,25675,21787,31258,26583,20144,16842,49,011
"Wayne County, Utah",2694,1397,1297,2585,9,8,13,34,18,27,5,22,2694,2535,159,0.3923,0.0258,22920,22917,23243,19277,,,39992,11709,,,49,055
"Carbon County, Utah",20356,10055,10301,18784,133,172,84,13,488,682,277,405,20356,17654,2702,0.4155,0.0177,23473,23994,24819,17298,23307,24162,9285,,24012,9189,49,007
"Emery County, Utah",10248,5234,5014,9987,17,75,66,2,4,97,0,97,10248,9606,642,0.3720,0.0166,22505,22849,23711,10246,,27487,,,,1508,49,015
"Morgan County, Utah",11391,5824,5567,10999,77,9,113,18,73,102,0,102,11391,11076,315,0.3921,0.0293,31936,32424,32762,14689,,,33028,,5558,9591,49,029
"Cache County, Utah",122336,61354,60982,110323,961,563,2496,478,4511,3004,370,2634,122336,109303,13033,0.4263,0.0125,22666,23587,24482,13013,16003,13231,16247,12217,14855,11481,49,005
"Garfield County, Utah",5017,2594,2423,4700,12,164,5,22,44,70,12,58,5017,4720,297,0.4210,0.0399,24055,24468,24565,20109,,19730,,,11998,10590,49,017
"Juab County, Utah",10948,5590,5358,10264,18,125,18,10,266,247,36,211,10948,10434,514,0.3654,0.0242,22498,23139,23277,10646,,30470,,,9175,10160,49,023
"Rutland County, Vermont",59273,29079,30194,57234,522,283,581,0,112,541,41,500,59273,58428,845,0.4320,0.0130,30109,30328,30477,18098,19888,27434,33283,-666666666,10929,18709,50,021
"Orleans County, Vermont",26911,13525,13386,25946,120,144,64,0,75,562,10,552,26911,26524,387,0.4409,0.0124,26657,27012,27074,21460,14306,16957,15530,-666666666,32117,15920,50,019
"Grand Isle County, Vermont",6965,3476,3489,6584,55,33,34,0,14,245,0,245,6965,6832,133,0.4630,0.0314,40464,40867,41042,30813,84869,50003,22068,-666666666,,22989,50,013
"Orange County, Vermont",28937,14357,14580,27982,188,111,71,16,84,485,4,481,28937,28545,392,0.4021,0.0108,30836,31089,31241,18598,27831,22629,22465,,11506,24465,50,017
"Chittenden County, Vermont",162052,79547,82505,146601,4103,432,6747,45,886,3238,157,3081,162052,158367,3685,0.4496,0.0076,37507,39155,39346,25973,16192,28343,26877,81898,19548,17578,50,007
"Lamoille County, Vermont",25268,12591,12677,24196,262,196,158,0,46,410,2,408,25268,24824,444,0.4762,0.0403,33247,33240,33299,23538,24127,19142,122108,-666666666,38911,11329,50,015
"Windsor County, Vermont",55427,27052,28375,53094,405,62,465,48,247,1106,0,1106,55427,54559,868,0.4616,0.0168,35152,35503,35638,23791,32449,18132,30885,255708,20831,15698,50,027
"Caledonia County, Vermont",30425,15218,15207,29241,335,69,201,0,30,549,13,536,30425,29944,481,0.4420,0.0273,28085,28547,28584,20211,15998,20739,12081,-666666666,10713,18596,50,005
"Tazewell County, Virginia",42080,20841,21239,39841,1367,110,272,44,70,376,3,373,42080,41671,409,0.4526,0.0253,23366,23784,23810,17884,10701,58719,22678,,,15708,51,185
"Windham County, Vermont",43150,20937,22213,40874,509,71,483,33,115,1065,60,1005,43150,42168,982,0.4537,0.0145,31563,32353,32464,20309,10371,10830,17138,14642,11830,21949,50,025
"Addison County, Vermont",36939,18272,18667,34783,482,124,714,0,210,626,32,594,36939,36090,849,0.4128,0.0097,33120,33876,34131,15480,19348,13869,25833,-666666666,10269,21505,50,001
"Washington County, Vermont",58477,28816,29661,56069,493,199,462,27,88,1139,14,1125,58477,57366,1111,0.4368,0.0112,34033,34600,34849,19380,20820,13845,28936,29744,15430,18972,50,023
"Falls Church city, Virginia",14067,7017,7050,11276,670,23,1421,0,221,456,68,388,14067,12566,1501,0.4527,0.0289,69775,78108,81997,39179,47505,,41803,-666666666,23570,9519,51,610
"Manassas Park city, Virginia",16423,8568,7855,10450,2500,47,1779,4,1063,580,123,457,16423,10064,6359,0.3530,0.0265,31420,32753,41472,21458,34491,33960,28473,,22294,19856,51,685
"Poquoson city, Virginia",12039,5856,6183,11355,141,27,236,0,22,258,11,247,12039,11728,311,0.3813,0.0229,40277,40291,40605,30397,63128,,46452,-666666666,,22028,51,735
"Sussex County, Virginia",11486,6831,4655,4537,6488,31,50,4,87,289,4,285,11486,11153,333,0.4286,0.0244,18363,24843,24862,14186,14494,,14160,,9472,7785,51,183
"Waynesboro city, Virginia",21926,10660,11266,17833,3100,90,207,41,164,491,10,481,21926,20252,1674,0.4446,0.0363,25421,27776,28684,13372,17191,23522,8159,,7372,7614,51,820
"Roanoke city, Virginia",99621,47775,51846,62282,28607,186,3070,28,1896,3552,335,3217,99621,93517,6104,0.4774,0.0144,26119,30384,31191,15134,17721,38512,34355,,16287,16502,51,770
"Salem city, Virginia",25519,11902,13617,22268,1792,34,470,20,91,844,72,772,25519,24692,827,0.4401,0.0354,31274,33017,33036,20753,23324,1868,28164,,2108,8267,51,775
"Norfolk city, Virginia",245592,128293,117299,115443,102117,1006,9063,161,7254,10548,1157,9391,245592,226233,19359,0.4957,0.0109,28508,37818,38782,22382,19121,25590,29159,27058,20172,22954,51,710
"Charlotte County, Virginia",12095,5981,6114,8323,3506,10,45,0,109,102,1,101,12095,11852,243,0.4455,0.0318,20585,22344,22556,7312,17119,,34287,-666666666,,4841,51,037
"Fairfax County, Virginia",1143529,566646,576883,708761,111026,2507,217066,838,50267,53064,6203,46861,1143529,957978,185551,0.4256,0.0033,54725,63643,70602,27746,40999,41335,46921,39996,21685,28416,51,059
"Greensville County, Virginia",11659,7336,4323,4417,6965,11,7,0,42,217,26,191,11659,11392,267,0.4100,0.0339,17500,23906,24512,2598,13871,,,-666666666,3283,7142,51,081
"James City County, Virginia",74153,35884,38269,59610,9759,138,1783,15,382,2466,142,2324,74153,70015,4138,0.4527,0.0168,43815,47788,48423,34697,26245,40276,49651,,28262,15548,51,095
"Russell County, Virginia",27408,13371,14037,26676,358,18,0,0,1,355,42,313,27408,27218,190,0.4588,0.0284,21754,21984,22007,15069,13312,,-666666666,-666666666,,13060,51,167
"Smyth County, Virginia",31059,15301,15758,29708,742,11,141,36,59,362,45,317,31059,30431,628,0.4593,0.0264,22297,22759,22930,13513,11492,,17018,,15642,8591,51,173
"Lexington city, Virginia",7110,3910,3200,6166,456,0,264,0,0,224,28,196,7110,6748,362,0.5135,0.0472,17762,19017,19690,6572,9993,-666666666,11719,-666666666,-666666666,6139,51,678
"Campbell County, Virginia",55170,26736,28434,45008,7904,76,456,7,389,1330,43,1287,55170,53872,1298,0.4397,0.0215,27842,29244,29476,20633,23543,7934,12554,,26346,12887,51,031
"Henry County, Virginia",51588,24866,26722,37119,11480,49,373,0,1386,1181,250,931,51588,48848,2740,0.4527,0.0231,21501,22045,22072,13444,22396,,12037,-666666666,9591,13327,51,089
"King George County, Virginia",25890,12996,12894,20125,4231,89,322,0,101,1022,111,911,25890,24608,1282,0.3741,0.0178,37316,39491,40190,30336,29513,56463,48271,-666666666,42560,21134,51,099
"Lancaster County, Virginia",10804,5108,5696,7366,3320,0,60,0,0,58,0,58,10804,10757,47,0.4972,0.0281,37196,45546,45637,31289,19592,-666666666,14462,-666666666,-666666666,7888,51,103
"Lee County, Virginia",24134,12608,11526,22551,1033,107,82,0,153,208,76,132,24134,23679,455,0.4896,0.0310,18750,19007,19052,10200,7061,4113,185850,-666666666,,,51,105
"Mathews County, Virginia",8796,4292,4504,7592,906,21,25,3,0,249,0,249,8796,8717,79,0.4538,0.0371,39119,42311,42451,22501,18338,,,,-666666666,22415,51,115
"Middlesex County, Virginia",10700,5182,5518,8321,1653,51,17,16,357,285,20,265,10700,10621,79,0.4553,0.0314,29707,32958,32940,78810,17712,52322,,,18819,15382,51,119
"Prince George County, Virginia",37894,20612,17282,22185,12204,234,675,147,705,1744,266,1478,37894,34915,2979,0.3963,0.0190,28873,31881,32312,20858,26733,15179,20962,12882,16721,16743,51,149
"Rockingham County, Virginia",79444,38910,40534,74456,2018,257,582,57,704,1370,150,1220,79444,74061,5383,0.4300,0.0176,30138,30671,31440,20631,20028,12642,22661,33070,19979,27605,51,165
"Scott County, Virginia",22009,11089,10920,21566,162,57,92,0,18,114,0,114,22009,21716,293,0.4436,0.0149,21157,21389,21531,10207,5159,12321,19953,-666666666,,7557,51,169
"Surry County, Virginia",6600,3203,3397,3487,2983,2,10,0,14,104,0,104,6600,6550,50,0.4030,0.0368,28688,33131,32875,58914,23731,,,-666666666,26000,25461,51,181
"Appomattox County, Virginia",15577,7563,8014,12125,3088,12,24,0,34,294,15,279,15577,15349,228,0.4242,0.0259,26890,29695,29844,29709,16744,,3679,-666666666,94588,11879,51,011
"Franklin County, Virginia",56233,27532,28701,49967,4398,140,210,0,605,913,0,913,56233,54685,1548,0.4591,0.0238,28866,30221,30540,14544,19429,20379,36066,-666666666,9819,12438,51,067
"King and Queen County, Virginia",7052,3538,3514,4826,1800,22,0,0,8,396,0,396,7052,6829,223,0.4129,0.0439,27306,29406,29732,20919,26151,31086,-666666666,-666666666,,6744,51,097
"Montgomery County, Virginia",97997,50738,47259,84168,4462,368,6512,37,917,1533,150,1383,97997,94887,3110,0.5009,0.0156,28920,29981,30209,23522,22742,19442,24081,10292,14162,20807,51,121
"New Kent County, Virginia",21103,10603,10500,17201,2396,204,224,0,167,911,11,900,21103,20438,665,0.3760,0.0275,36458,37657,37953,27849,33991,47947,26796,-666666666,21465,22858,51,127
"Cumberland County, Virginia",9786,4830,4956,6207,3149,77,93,0,0,260,0,260,9786,9759,27,0.4399,0.0352,25177,28937,28968,,19705,,28828,-666666666,-666666666,7084,51,049
"Goochland County, Virginia",22482,11129,11353,17970,3605,27,292,0,113,475,5,470,22482,21871,611,0.4796,0.0277,47806,53788,54414,28673,22757,12537,51170,-666666666,12865,19839,51,075
"Halifax County, Virginia",34779,16638,18141,21061,12148,93,268,0,245,964,61,903,34779,34076,703,0.4342,0.0187,22716,26348,26403,18311,17635,,30156,-666666666,18708,6375,51,083
"Madison County, Virginia",13139,6350,6789,11268,910,0,110,0,200,651,31,620,13139,12787,352,0.4618,0.0375,30351,31811,32006,19410,25820,-666666666,7790,-666666666,23681,17270,51,113
"Prince William County, Virginia",456749,227951,228798,263741,94758,1645,37169,615,31999,26822,3574,23248,456749,351699,105050,0.3809,0.0056,39262,43799,50091,23325,40099,26845,32834,28618,20781,23656,51,153
"Southampton County, Virginia",17939,9345,8594,11135,5937,69,38,0,58,702,4,698,17939,17662,277,0.3965,0.0179,25643,29480,29799,15913,19584,18152,,-666666666,26934,17971,51,175
"Highland County, Virginia",2214,1043,1171,2203,0,3,0,0,0,8,0,8,2214,2214,0,0.4375,0.0458,30967,30957,30957,-666666666,-666666666,,-666666666,-666666666,-666666666,27713,51,091
"Brunswick County, Virginia",16665,8892,7773,6962,9121,26,99,0,149,308,10,298,16665,16301,364,0.4395,0.0329,20657,28610,29181,7913,14989,,2646,-666666666,9585,18168,51,025
"Caroline County, Virginia",30184,15138,15046,19874,8428,47,268,0,572,995,54,941,30184,28803,1381,0.4088,0.0498,31536,31582,31719,25074,33004,97000,11454,-666666666,30994,20796,51,033
"Gloucester County, Virginia",37161,18328,18833,32660,3071,81,308,0,33,1008,100,908,37161,35874,1287,0.3969,0.0168,33295,33551,33924,22971,32242,,33734,-666666666,,26575,51,073
"Northampton County, Virginia",11957,5699,6258,7435,4022,4,105,13,49,329,0,329,11957,10920,1037,0.4694,0.0265,26467,31417,34458,11277,17910,,31062,,15396,13853,51,131
"Patrick County, Virginia",17859,8896,8963,16475,1024,63,71,0,101,125,0,125,17859,17332,527,0.4463,0.0216,23016,23416,23810,9325,18311,13652,19613,-666666666,26927,12342,51,141
"Powhatan County, Virginia",28574,15249,13325,24720,3106,85,90,35,104,434,106,328,28574,27966,608,0.3710,0.0185,35641,38510,38830,24588,14829,20011,46696,,17446,29072,51,145
"Rockbridge County, Virginia",22509,11185,11324,21069,735,75,150,0,30,450,150,300,22509,22102,407,0.4802,0.0283,31594,32257,32523,6157,25280,31301,36235,-666666666,4520,11153,51,163
"Shenandoah County, Virginia",43045,21044,22001,40424,841,38,367,0,369,1006,78,928,43045,40026,3019,0.4158,0.0175,28064,28446,29362,15053,33801,49787,25475,-666666666,12111,13914,51,171
"Fauquier County, Virginia",69115,34283,34832,60069,5054,254,1001,27,467,2243,197,2046,69115,63617,5498,0.4185,0.0138,44724,47084,48891,22836,33862,24007,31094,61611,16574,20076,51,061
"Charles City County, Virginia",6995,3441,3554,3016,3279,453,31,0,22,194,10,184,6995,6866,129,0.5459,0.0735,37059,45312,45591,33380,32116,29078,9632,-666666666,16918,17597,51,036
"Culpeper County, Virginia",50450,25249,25201,38439,6983,213,713,68,1935,2099,113,1986,50450,45270,5180,0.4076,0.0144,30812,34098,35587,17183,22523,24016,30265,,17632,10732,51,047
"Dinwiddie County, Virginia",28308,14010,14298,18269,9061,3,210,24,273,468,0,468,28308,27352,956,0.4328,0.0353,27106,29280,29900,14507,23869,,26472,,15247,8662,51,053
"Greene County, Virginia",19410,9450,9960,16882,1125,45,293,0,383,682,5,677,19410,18269,1141,0.4179,0.0542,32565,33180,34334,19227,28849,,33928,-666666666,35603,20258,51,079
"Hanover County, Virginia",104449,51222,53227,90409,9546,198,1650,144,389,2113,33,2080,104449,101391,3058,0.3935,0.0112,39604,40682,41129,25234,35815,30477,34540,4378,34228,18811,51,085
"Lunenburg County, Virginia",12278,6261,6017,7652,3783,14,397,0,186,246,22,224,12278,11729,549,0.3901,0.0235,18677,20624,21032,9586,14453,,30073,-666666666,7016,14533,51,111
"Orange County, Virginia",35612,17418,18194,29176,4441,114,347,0,403,1131,59,1072,35612,33917,1695,0.3912,0.0198,31362,33122,33859,18939,26297,,26186,-666666666,26188,12329,51,137
"Harrisonburg city, Virginia",53391,25580,27811,43279,3958,14,2119,0,914,3107,431,2676,53391,43067,10324,0.4816,0.0284,21793,22488,24638,15524,19970,,16621,-666666666,21704,18090,51,660
"Emporia city, Virginia",5381,2408,2973,1384,3749,3,15,0,10,220,0,220,5381,5085,296,0.4793,0.0376,18694,24098,25252,13826,17461,,,-666666666,,6973,51,595
"Wythe County, Virginia",28940,14112,14828,27439,928,52,105,0,79,337,1,336,28940,28593,347,0.4666,0.0363,26513,27051,27203,13145,20345,7942,17066,-666666666,,7370,51,197
"Chesapeake city, Virginia",237820,116188,121632,145954,71092,428,7790,216,3758,8582,537,8045,237820,223700,14120,0.4073,0.0095,33844,37151,37782,24572,28513,37874,43152,18582,21990,18699,51,550
"Albemarle County, Virginia",106355,50856,55499,86739,10375,209,5626,30,1131,2245,100,2145,106355,100187,6168,0.4809,0.0128,42085,45118,46297,23974,29424,18758,34124,,18442,17868,51,003
"Bedford County, Virginia",77908,38306,39602,69767,5300,39,1088,17,303,1394,120,1274,77908,76262,1646,0.4322,0.0143,31796,33112,33300,21564,21459,,26880,,10615,12472,51,019
"Botetourt County, Virginia",33222,16388,16834,31087,994,97,273,0,293,478,52,426,33222,32675,547,0.4156,0.0136,33983,34876,34784,27076,31309,22368,12834,-666666666,14027,8117,51,023
"Wise County, Virginia",39025,20490,18535,35998,2227,44,165,15,50,526,74,452,39025,38544,481,0.4850,0.0274,21828,22480,22580,8543,11249,28086,65409,,18638,8737,51,195
"Bristol city, Virginia",16843,8004,8839,14804,1191,0,9,0,242,597,0,597,16843,16741,102,0.4711,0.0272,22900,24369,24528,,15423,-666666666,,-666666666,,6971,51,520
"Portsmouth city, Virginia",95311,45919,49392,38276,50188,467,1251,131,1393,3605,251,3354,95311,91205,4106,0.4242,0.0118,25179,32098,32584,21351,20620,35966,29749,14879,21664,13923,51,740
"Williamsburg city, Virginia",14788,6727,8061,11022,2077,77,964,0,63,585,10,575,14788,13744,1044,0.5181,0.0313,29203,33657,35816,10637,22898,4539,5387,-666666666,8195,12430,51,830
"Alleghany County, Virginia",15286,7520,7766,14065,823,0,11,7,91,289,49,240,15286,15068,218,0.4468,0.0230,26918,28303,28226,21347,11552,-666666666,,,14559,6335,51,005
"Carroll County, Virginia",29738,14963,14775,28960,150,111,31,0,59,427,16,411,29738,28742,996,0.4586,0.0392,24868,25244,25534,13132,2402,18707,,-666666666,,11028,51,035
"Washington County, Virginia",54406,26851,27555,52316,778,47,293,12,314,646,44,602,54406,53589,817,0.4426,0.0155,26085,26230,26334,11127,14191,17638,48576,,13519,23913,51,191
"Northumberland County, Virginia",12223,5967,6256,8594,3363,28,30,0,0,208,0,208,12223,12132,91,0.4462,0.0249,34006,38817,38866,26863,22658,,112507,-666666666,-666666666,10663,51,133
"Page County, Virginia",23749,11675,12074,22676,364,26,101,0,182,400,40,360,23749,23285,464,0.4274,0.0370,25021,25529,25721,11908,20019,,15128,-666666666,6957,12648,51,139
"Warren County, Virginia",39449,19666,19783,35447,1492,112,417,0,466,1515,143,1372,39449,37733,1716,0.3979,0.0138,31007,32169,32466,22243,26995,,24656,-666666666,16202,15189,51,187
"Alexandria city, Virginia",156505,75346,81159,97091,34246,276,9553,68,7137,8134,1555,6579,156505,130258,26247,0.4443,0.0074,59239,72844,81358,28327,34716,43386,55875,38663,23382,36213,51,510
"Fredericksburg city, Virginia",28469,13064,15405,17834,6307,56,665,46,1651,1910,280,1630,28469,25407,3062,0.4600,0.0214,34722,40318,40479,20584,29412,83355,27397,,13644,19995,51,630
"Hampton city, Virginia",135583,65275,70308,56166,68038,725,3490,203,2394,4567,330,4237,135583,127984,7599,0.4313,0.0114,28384,33670,33996,23870,25138,26270,25693,45619,19818,17855,51,650
"Arlington County, Virginia",231803,115819,115984,165609,20777,870,23992,260,11833,8462,1266,7196,231803,195623,36180,0.4355,0.0067,69051,78958,84447,38256,38827,40942,56170,23602,24547,52394,51,013
"Hopewell city, Virginia",22408,10375,12033,11418,9469,24,323,0,598,576,170,406,22408,20703,1705,0.4461,0.0209,22038,25789,26525,17745,18276,,10666,-666666666,24212,13423,51,670
"Buchanan County, Virginia",22138,11155,10983,21083,641,45,186,0,84,99,12,87,22138,22042,96,0.4645,0.0205,18865,18964,18977,16953,4275,65982,36595,-666666666,35367,23552,51,027
"Frederick County, Virginia",85153,42405,42748,77488,3464,223,1146,69,640,2123,229,1894,85153,78150,7003,0.3926,0.0120,33961,34785,36224,17818,30356,16278,38246,40723,24603,11899,51,069
"Stafford County, Virginia",144012,72540,71472,97930,24870,414,4880,93,8017,7808,738,7070,144012,126230,17782,0.3702,0.0080,40850,43757,44394,28598,41674,58856,36685,38011,22933,21835,51,179
"York County, Virginia",67587,33231,34356,51011,8794,163,3771,224,675,2949,325,2624,67587,63414,4173,0.3756,0.0123,39071,41346,42242,25888,34487,24953,38609,25005,31968,17454,51,199
"Richmond city, Virginia",223787,106222,117565,101498,106914,937,4789,40,2207,7402,502,6900,223787,208837,14950,0.5381,0.0085,31635,46552,50324,16170,18904,23572,29141,31405,19808,17133,51,760
"Nelson County, Virginia",14812,7198,7614,12479,1909,47,54,0,193,130,0,130,14812,14205,607,0.4833,0.0426,36002,38519,39191,17326,23091,,,-666666666,15995,,51,125
"Pittsylvania County, Virginia",61676,30241,31435,46210,12391,40,251,13,953,1818,75,1743,61676,60085,1591,0.4338,0.0201,24443,26389,26579,11019,20130,51380,22939,,12282,10450,51,143
"Norton city, Virginia",3990,1792,2198,3597,185,3,134,0,0,71,0,71,3990,3947,43,0.5088,0.0516,20917,21511,21405,,15063,,23869,-666666666,-666666666,,51,720
"Fluvanna County, Virginia",26282,12005,14277,21206,3536,45,371,30,145,949,5,944,26282,25402,880,0.4611,0.0962,39900,38206,38366,159305,28235,1313,329314,,11440,14683,51,065
"Amelia County, Virginia",12854,6652,6202,9738,2737,31,0,0,0,348,0,348,12854,12471,383,0.4218,0.0309,29114,31404,32120,16267,22438,,-666666666,-666666666,-666666666,19882,51,007
"Winchester city, Virginia",27789,13573,14216,22353,2787,89,502,17,735,1306,36,1270,27789,22947,4842,0.4493,0.0224,29727,31809,35583,13472,21882,32281,65743,,10116,7701,51,840
"Accomack County, Virginia",32742,15861,16881,22372,9574,176,74,0,230,316,17,299,32742,29808,2934,0.4382,0.0189,24355,27590,29647,12415,16740,24782,33091,-666666666,12097,32706,51,001
"Floyd County, Virginia",15666,7824,7842,14996,301,70,30,0,73,196,0,196,15666,15202,464,0.4157,0.0244,26134,26379,26698,14282,18779,49809,,-666666666,,12282,51,063
"Grayson County, Virginia",15811,7995,7816,14618,732,39,51,0,86,285,5,280,15811,15297,514,0.4588,0.0344,20930,21719,22046,10525,8402,,34180,-666666666,12715,14057,51,077
"Nottoway County, Virginia",15500,8403,7097,8807,6314,15,46,40,175,103,0,103,15500,14843,657,0.5133,0.0948,23109,24486,24886,11208,21941,,1570,,10166,1399,51,135
"Harrison County, West Virginia",68209,33301,34908,65149,1151,39,409,30,49,1382,36,1346,68209,67110,1099,0.4541,0.0125,27869,28159,28307,15584,24518,,48861,,7051,12442,54,033
"Ohio County, West Virginia",42547,20465,22082,39597,1708,90,318,0,120,714,54,660,42547,42078,469,0.4904,0.0196,30258,31285,31343,22078,13862,5483,32730,-666666666,52985,10745,54,069
"Calhoun County, West Virginia",7396,3642,3754,7339,2,11,0,0,1,43,3,40,7396,7244,152,0.4423,0.0312,19911,19919,20205,5852,,,-666666666,-666666666,,20188,54,013
"Morgan County, West Virginia",17624,8763,8861,17070,126,105,17,0,48,258,0,258,17624,17356,268,0.4182,0.0579,27642,27866,28124,9229,42559,16150,38735,-666666666,,14609,54,065
"Raleigh County, West Virginia",76232,38188,38044,67185,5814,290,708,10,587,1638,66,1572,76232,75005,1227,0.4604,0.0209,24170,24789,24865,16583,17333,17589,61354,,17840,10567,54,081
"Braxton County, West Virginia",14282,7125,7157,13978,55,0,0,29,5,215,0,215,14282,14129,153,0.4313,0.0247,21596,21723,21858,6980,3504,-666666666,-666666666,,,18133,54,007
"Barbour County, West Virginia",16730,8143,8587,16057,207,59,96,0,29,282,0,282,16730,16645,85,0.4777,0.0303,22237,22780,22846,5261,4840,,7785,-666666666,,8655,54,001
"McDowell County, West Virginia",19217,9837,9380,17084,1616,24,0,0,178,315,25,290,19217,18966,251,0.4610,0.0272,14489,15167,15186,5522,11330,,-666666666,-666666666,5514,,54,047
"Wayne County, West Virginia",40708,19835,20873,39803,222,60,112,0,112,399,4,395,40708,40443,265,0.4914,0.0184,21240,21429,21354,25455,9104,,32277,-666666666,4254,5940,54,099
"Wyoming County, West Virginia",21711,10695,11016,21136,210,3,37,0,24,301,0,301,21711,21667,44,0.4401,0.0230,20831,21099,21116,,9655,,,-666666666,,9217,54,109
"Jackson County, West Virginia",29018,14417,14601,28303,23,246,93,0,18,335,0,335,29018,28876,142,0.4572,0.0220,24661,24684,24769,7821,,42718,38375,-666666666,,5630,54,035
"Mercer County, West Virginia",60486,28728,31758,55138,3779,146,392,15,28,988,19,969,60486,59796,690,0.4417,0.0160,21821,22368,22458,10964,15988,27256,30868,,13818,9617,54,055
"Upshur County, West Virginia",24605,12200,12405,23855,453,37,54,0,30,176,9,167,24605,24283,322,0.4470,0.0217,21701,22010,22114,14005,12069,,8767,-666666666,,10801,54,097
"Webster County, West Virginia",8518,4199,4319,8492,3,0,0,4,6,13,0,13,8518,8512,6,0.4747,0.0454,20507,20473,20473,,,-666666666,-666666666,,,,54,101
"Berkeley County, West Virginia",113495,56013,57482,98773,8721,58,1162,0,1372,3409,182,3227,113495,108700,4795,0.3940,0.0111,28736,29589,29783,22108,23994,28062,31458,-666666666,19101,19130,54,003
"Fayette County, West Virginia",44126,22099,22027,41219,2232,104,30,18,59,464,46,418,44126,43633,493,0.4340,0.0179,21466,21666,21802,11282,17634,20942,5830,,25942,23278,54,019
"Grant County, West Virginia",11641,5813,5828,11312,191,0,0,0,38,100,0,100,11641,11549,92,0.4251,0.0280,22828,22604,22584,25782,39028,-666666666,-666666666,-666666666,,16682,54,023
"Hampshire County, West Virginia",23363,11980,11383,22680,343,80,63,0,9,188,0,188,23363,23035,328,0.4275,0.0231,23011,23228,23360,16401,15741,,,-666666666,,12776,54,027
"Summers County, West Virginia",13018,5994,7024,12131,564,27,0,0,10,286,12,274,13018,12795,223,0.4273,0.0227,20784,21390,21350,21810,14048,,-666666666,-666666666,,8720,54,089
"Brooke County, West Virginia",22772,11171,11601,21947,398,1,74,40,37,275,0,275,22772,22573,199,0.3897,0.0153,25537,26078,26172,10257,15135,,6841,,10614,5518,54,009
"Doddridge County, West Virginia",8536,4692,3844,8207,115,22,26,0,5,161,7,154,8536,8473,63,0.4176,0.0346,22598,22942,23088,2341,7515,,,-666666666,,14717,54,017
"Mineral County, West Virginia",27278,13649,13629,25886,954,3,111,0,71,253,0,253,27278,27035,243,0.4083,0.0185,23546,23684,23845,5930,15042,,113077,-666666666,12204,5728,54,057
"Greenbrier County, West Virginia",35347,17203,18144,33214,862,15,231,0,168,857,25,832,35347,34681,666,0.4660,0.0305,23936,24437,24483,19137,25058,,9168,-666666666,5026,10890,54,025
"Hardy County, West Virginia",13842,7112,6730,12658,762,77,225,0,11,109,30,79,13842,13624,218,0.4327,0.0523,26596,26215,26424,10095,35221,,30028,-666666666,,3313,54,031
"Marion County, West Virginia",56497,27819,28678,52943,2049,199,360,0,294,652,61,591,56497,55781,716,0.4427,0.0127,25909,26683,26698,23864,17032,6890,11629,-666666666,8419,12482,54,049
"Mingo County, West Virginia",24741,12024,12717,23714,655,16,22,0,134,200,0,200,24741,24741,0,0.4703,0.0230,19025,19368,19368,-666666666,14983,,,-666666666,4072,2539,54,059
"Hancock County, West Virginia",29680,14376,15304,28233,557,79,149,8,0,654,32,622,29680,29231,449,0.4256,0.0158,25637,26061,26192,15653,28135,,29258,,-666666666,6882,54,029
"Lewis County, West Virginia",16276,8202,8074,15875,43,38,50,0,19,251,127,124,16276,16083,193,0.4542,0.0241,22575,22889,23092,4125,5060,,,-666666666,,6722,54,041
"Nicholas County, West Virginia",25324,12420,12904,24588,201,98,77,0,82,278,0,278,25324,25186,138,0.4480,0.0219,21941,22144,22152,26622,15013,,,-666666666,19061,13446,54,067
"Pocahontas County, West Virginia",8531,4377,4154,8424,37,0,0,0,20,50,0,50,8531,8486,45,0.4556,0.0464,24109,24276,24270,24038,14819,-666666666,-666666666,-666666666,21290,,54,075
"Tyler County, West Virginia",8909,4437,4472,8727,30,15,48,0,13,76,0,76,8909,8885,24,0.4669,0.0548,24422,24680,24706,21358,,,16817,-666666666,,,54,095
"Randolph County, West Virginia",29065,14861,14204,28066,568,110,165,0,74,82,8,74,29065,28799,266,0.5013,0.0359,24162,24484,24543,17239,11278,26234,12071,-666666666,,26499,54,083
"Taylor County, West Virginia",16951,8580,8371,16371,164,0,151,0,83,182,0,182,16951,16782,169,0.4295,0.0258,24258,24676,24757,13344,11970,-666666666,15332,-666666666,,14775,54,091
"Wirt County, West Virginia",5797,2922,2875,5694,83,0,0,0,7,13,0,13,5797,5733,64,0.3960,0.0344,21314,21663,21746,14394,,-666666666,-666666666,-666666666,,,54,105
"Clay County, West Virginia",8785,4388,4397,8721,1,12,0,22,0,29,0,29,8785,8778,7,0.4336,0.0275,16780,16710,16711,,,,-666666666,,-666666666,,54,015
"Gilmer County, West Virginia",8205,4733,3472,6792,900,29,84,0,142,258,24,234,8205,7877,328,0.4384,0.0249,17313,19441,19763,6328,5277,,20108,-666666666,8414,8102,54,021
"Monongalia County, West Virginia",105252,54501,50751,94219,3795,137,3774,0,667,2660,157,2503,105252,103070,2182,0.5261,0.0125,30641,31734,31876,21534,22635,22372,26950,-666666666,18222,12149,54,061
"Monroe County, West Virginia",13467,6683,6784,13062,122,73,0,0,0,210,34,176,13467,13346,121,0.4386,0.0213,23412,23741,23728,25204,25205,10240,-666666666,-666666666,-666666666,6444,54,063
"Wetzel County, West Virginia",15614,7586,8028,15206,158,0,65,0,47,138,0,138,15614,15560,54,0.4387,0.0234,22789,23043,23072,14987,,-666666666,,-666666666,,8507,54,103
"Cabell County, West Virginia",95318,46739,48579,86443,4803,171,1302,53,538,2008,205,1803,95318,93991,1327,0.5052,0.0134,24506,25447,25477,17412,13987,17891,34483,13077,5186,8743,54,011
"Kanawha County, West Virginia",185710,89483,96227,164367,13461,322,2111,0,345,5104,108,4996,185710,183685,2025,0.4797,0.0103,28405,29337,29345,23620,19212,9875,60731,-666666666,14630,11351,54,039
"Pendleton County, West Virginia",7056,3622,3434,6745,239,0,8,0,27,37,0,37,7056,6992,64,0.4620,0.0433,24739,25050,25244,,19738,-666666666,,-666666666,,7451,54,071
"Preston County, West Virginia",33837,17408,16429,31298,1599,210,88,6,230,406,122,284,33837,32995,842,0.4230,0.0168,23337,24662,24978,5522,5848,14090,8851,,3800,9022,54,077
"Kitsap County, Washington",262475,134094,128381,213159,6530,2708,12691,2150,5413,19824,1457,18367,262475,242693,19782,0.4258,0.0074,35826,38378,39098,23613,26144,23436,32375,30483,23155,19519,53,035
"King County, Washington",2163257,1082940,1080317,1404974,136054,13743,370908,16779,84956,135843,12474,123369,2163257,1956522,206735,0.4663,0.0029,49298,56263,58176,24909,27730,25834,48026,23120,19518,26565,53,033
"Pend Oreille County, Washington",13219,6694,6525,11881,30,499,136,36,291,346,20,326,13219,12736,483,0.4302,0.0204,26739,27431,27541,18935,,24803,26275,18983,15357,17531,53,051
"San Juan County, Washington",16473,7956,8517,15164,150,146,231,38,343,401,67,334,16473,15449,1024,0.4969,0.0149,42307,43737,44590,18422,34456,25530,28597,18576,15665,30178,53,055
"Whitman County, Washington",48593,24749,23844,40133,1075,232,4105,91,819,2138,227,1911,48593,45588,3005,0.5015,0.0163,22585,23654,24271,12189,20774,14228,20185,9444,20353,10349,53,075
"Yakima County, Washington",249325,124900,124425,194796,2685,10482,2267,181,30578,8336,1883,6453,249325,127381,121944,0.4450,0.0145,22459,24039,32065,14181,17422,17092,41084,19857,15704,13698,53,077
"Cowlitz County, Washington",105112,51937,53175,93938,844,1561,1293,306,1716,5454,583,4871,105112,95864,9248,0.4401,0.0125,27264,28358,29320,13378,21459,16420,32216,22986,16251,14945,53,015
"Ferry County, Washington",7576,3884,3692,5755,11,1020,79,15,69,627,10,617,7576,7229,347,0.4510,0.0230,23640,25923,25832,19516,17491,18735,9035,13027,12500,14097,53,019
"Lewis County, Washington",76947,38509,38438,69747,452,550,914,148,1269,3867,627,3240,76947,69255,7692,0.4252,0.0153,25813,26222,27319,13623,16031,26217,55969,31493,13745,16150,53,041
"Grays Harbor County, Washington",71967,36981,34986,63343,733,3191,1134,205,421,2940,135,2805,71967,64875,7092,0.4451,0.0178,25374,26165,27486,13891,10625,17167,37742,22143,15466,17807,53,027
"Island County, Washington",81636,40781,40855,69186,2592,858,3768,298,1090,3844,333,3511,81636,75524,6112,0.4244,0.0137,35364,37057,38060,21687,24342,26150,29846,30916,25224,23015,53,029
"Wahkiakum County, Washington",4189,2000,2189,3856,54,51,65,1,81,81,43,38,4189,3925,264,0.4103,0.0420,29452,31178,31873,16056,,32812,,,2952,7969,53,069
"Franklin County, Washington",90660,47145,43515,63977,2151,940,2090,175,17351,3976,1282,2694,90660,42753,47907,0.4046,0.0164,23373,26334,33768,15379,18745,17016,33489,27031,14863,11397,53,021
"Grant County, Washington",94860,48099,46761,66805,654,1128,983,59,21055,4176,1810,2366,94860,55689,39171,0.4227,0.0190,23633,27215,31115,14014,19556,24723,26585,38012,14498,11821,53,025
"Whatcom County, Washington",216812,107228,109584,181943,2212,6537,8977,619,6978,9546,1193,8353,216812,196835,19977,0.4463,0.0094,30586,32407,33240,17911,22762,18172,28571,25352,17363,18091,53,073
"Okanogan County, Washington",41638,21061,20577,30423,204,4073,362,46,4313,2217,306,1911,41638,33427,8211,0.4320,0.0170,23961,26402,28246,12473,25037,22005,14449,18826,14832,13384,53,047
"Kittitas County, Washington",44825,22555,22270,39721,432,340,750,360,1700,1522,133,1389,44825,40903,3922,0.4442,0.0149,27948,29428,30173,16514,18960,38126,15176,16717,16037,11866,53,037
"Benton County, Washington",194168,97139,97029,158279,3143,1335,4990,145,18554,7722,1331,6391,194168,152832,41336,0.4303,0.0078,31580,33768,36444,16343,23370,24473,47985,27139,17630,14304,53,005
"Columbia County, Washington",4001,1930,2071,3650,30,1,98,38,34,150,63,87,4001,3695,306,0.4667,0.0362,31206,32650,33819,18263,18770,,12400,,,25561,53,013
"Asotin County, Washington",22337,10721,11616,20732,98,294,196,35,142,840,113,727,22337,21484,853,0.4312,0.0210,27896,28455,28814,11429,,11534,75749,,19404,12080,53,003
"Garfield County, Washington",2224,1099,1125,2040,0,9,71,0,0,104,0,104,2224,2177,47,0.3661,0.0360,25539,26923,27528,,-666666666,,12368,-666666666,-666666666,6759,53,023
"Mason County, Washington",62627,32413,30214,52310,1068,1748,886,286,3070,3259,316,2943,62627,56566,6061,0.4195,0.0161,27253,29318,29797,10851,28097,16897,24701,26291,9516,16879,53,045
"Stevens County, Washington",44214,21944,22270,39263,205,2185,287,22,427,1825,58,1767,44214,42610,1604,0.4360,0.0124,25197,26395,26753,11771,28682,15594,15925,29432,14081,14539,53,065
"Spokane County, Washington",497875,246906,250969,438838,8009,7248,11117,2507,7063,23093,1552,21541,497875,470182,27693,0.4564,0.0053,29982,31530,31915,19435,19108,16957,24442,17266,19341,15733,53,063
"Chelan County, Washington",75757,37764,37993,64606,360,545,829,58,6791,2568,486,2082,75757,54683,21074,0.4510,0.0140,29204,31048,34605,16060,18328,18139,20843,47590,14340,28272,53,007
"Rock County, Wisconsin",161769,79654,82115,142557,7081,398,1955,28,4379,5371,308,5063,161769,147987,13782,0.4150,0.0098,28103,29780,30893,12989,17855,19215,23593,21125,16873,8576,55,105
"Waushara County, Wisconsin",24116,12641,11475,22425,435,104,86,9,658,399,35,364,24116,22592,1524,0.4318,0.0202,27347,28648,29294,10916,7636,16275,18234,,9652,10019,55,137
"Adams County, Wisconsin",20073,10783,9290,18642,568,156,126,0,191,390,47,343,20073,19292,781,0.4342,0.0185,25591,26676,27058,10981,8064,6787,9008,-666666666,18616,15579,55,001
"Bayfield County, Wisconsin",14992,7632,7360,12908,125,1489,76,0,33,361,16,345,14992,14713,279,0.4168,0.0115,29886,31763,32095,8854,12949,18392,18667,-666666666,21724,19142,55,007
"Lafayette County, Wisconsin",16735,8443,8292,16248,107,72,65,0,153,90,8,82,16735,16110,625,0.4088,0.0121,28198,28478,28922,16120,16529,8733,14351,-666666666,23261,25571,55,065
"Monroe County, Wisconsin",45502,23019,22483,42339,762,480,407,10,805,699,133,566,45502,43519,1983,0.3979,0.0135,27729,28015,28364,16762,35412,26893,25196,23520,20093,12942,55,081
"Pierce County, Wisconsin",41603,20641,20962,39925,188,73,505,1,165,746,19,727,41603,40777,826,0.3986,0.0110,32525,33121,33266,24528,13238,19114,10186,,27405,23072,55,093
"Wood County, Wisconsin",73274,36056,37218,69042,444,406,1517,14,686,1165,55,1110,73274,71152,2122,0.4218,0.0123,30006,30280,30494,15622,25758,20020,42738,,12472,12229,55,141
"Ashland County, Wisconsin",15712,7930,7782,13193,110,1885,68,11,59,386,0,386,15712,15274,438,0.4322,0.0183,23505,24526,24762,11613,2816,16757,18849,,15276,28441,55,003
"Calumet County, Wisconsin",49807,24954,24853,47140,420,284,1199,2,283,479,21,458,49807,47738,2069,0.3943,0.0136,34015,34713,35508,14518,16221,52429,21573,,19159,10036,55,015
"Florence County, Wisconsin",4337,2275,2062,4275,13,18,0,0,0,31,0,31,4337,4276,61,0.4850,0.0514,30674,30836,30926,25884,,34100,-666666666,-666666666,-666666666,19265,55,037
"Clark County, Wisconsin",34491,17478,17013,33223,169,85,148,1,378,487,18,469,34491,32961,1530,0.4159,0.0114,24114,24373,24771,11795,13541,31705,39968,,12135,13299,55,019
"Jefferson County, Wisconsin",84652,42343,42309,79520,727,105,567,37,1801,1895,381,1514,84652,78728,5924,0.3976,0.0129,30329,31183,31994,14769,13613,44170,20937,,17189,15085,55,055
"Kenosha County, Wisconsin",168330,83312,85018,144087,12636,663,2471,41,3282,5150,962,4188,168330,146585,21745,0.4394,0.0087,30740,32794,34555,17617,17528,30475,34723,32895,16759,12701,55,059
"Iron County, Wisconsin",5715,2915,2800,5519,47,56,18,0,14,61,3,58,5715,5642,73,0.4467,0.0228,28550,28721,28524,38025,12113,15493,120250,-666666666,6357,15798,55,051
"St. Croix County, Wisconsin",87917,43899,44018,84262,672,178,946,2,336,1521,114,1407,87917,85894,2023,0.3935,0.0112,37419,38153,38491,18719,14831,28724,23624,,15881,21136,55,109
"Oconto County, Wisconsin",37556,19187,18369,36265,156,336,143,0,94,562,24,538,37556,36906,650,0.3952,0.0094,29392,29793,29998,15467,25342,22896,18958,-666666666,10644,14290,55,083
"Lincoln County, Wisconsin",27848,13999,13849,26978,169,111,91,0,7,492,3,489,27848,27427,421,0.3938,0.0094,29642,30047,30233,14774,18752,26883,41153,-666666666,,9891,55,069
"Waupaca County, Wisconsin",51444,26297,25147,49559,291,245,173,5,489,682,58,624,51444,49872,1572,0.4155,0.0116,30627,31205,31613,13953,10220,20348,31269,,18079,9879,55,135
"Barron County, Wisconsin",45252,22616,22636,43086,627,338,323,0,373,505,12,493,45252,44141,1111,0.4359,0.0193,28326,28879,29091,17979,16232,14172,27403,-666666666,21134,11502,55,005
"Sawyer County, Wisconsin",16370,8339,8031,12625,89,2794,99,5,217,541,45,496,16370,15943,427,0.5057,0.0389,30094,34337,34417,13508,33119,14674,19133,,12502,19540,55,113
"Green Lake County, Wisconsin",18757,9437,9320,18068,180,60,54,0,158,237,20,217,18757,17859,898,0.4102,0.0132,27915,28391,28961,14850,19553,20668,17870,-666666666,18161,8584,55,047
"Marquette County, Wisconsin",15207,7746,7461,14606,94,67,55,0,129,256,9,247,15207,14712,495,0.3935,0.0091,26068,26529,26819,16917,9910,33210,28282,-666666666,17696,7575,55,077
"Marinette County, Wisconsin",40537,20375,20162,39168,284,199,185,11,90,600,64,536,40537,39868,669,0.4228,0.0118,26959,27026,27127,20657,11493,22993,51562,,17831,23842,55,075
"Racine County, Wisconsin",195398,96702,98696,157639,21852,1127,2452,78,6272,5978,1053,4925,195398,170256,25142,0.4314,0.0073,30386,33840,35629,17443,14653,27785,37956,67128,17717,7011,55,101
"Winnebago County, Wisconsin",169926,85597,84329,156571,3829,970,4582,20,1152,2802,171,2631,169926,163137,6789,0.4717,0.0120,33000,34156,34915,14262,10607,25266,31139,,22128,9149,55,139
"Forest County, Wisconsin",9018,4541,4477,7267,68,1351,44,7,23,258,12,246,9018,8810,208,0.4215,0.0175,24808,26104,26272,14006,12981,21666,26995,,14622,8697,55,041
"Grant County, Wisconsin",51828,26920,24908,49993,726,65,494,12,125,413,6,407,51828,50997,831,0.4116,0.0113,24974,25327,25550,11701,6498,26865,29234,,21546,10729,55,043
"Rusk County, Wisconsin",14183,7109,7074,13637,140,55,32,22,45,252,9,243,14183,13924,259,0.4146,0.0151,24731,24724,24852,14805,19543,20538,40394,,15980,28112,55,107
"Sheboygan County, Wisconsin",115205,57922,57283,102818,2129,279,6446,8,1084,2441,277,2164,115205,108037,7168,0.4092,0.0087,30151,31861,32743,15099,14933,27005,17671,,16969,10476,55,117
"Langlade County, Wisconsin",19164,9721,9443,18308,153,120,43,3,113,424,3,421,19164,18796,368,0.4078,0.0140,26212,26743,27045,8966,11905,23266,16847,,9346,14705,55,067
"Outagamie County, Wisconsin",184754,92241,92513,165877,2529,2969,6462,37,3548,3332,276,3056,184754,176965,7789,0.4137,0.0083,32098,33812,33982,19648,16724,19149,19417,6862,14613,13516,55,087
"Vernon County, Wisconsin",30516,15302,15214,29680,79,64,160,10,147,376,27,349,30516,30040,476,0.4528,0.0386,26726,27005,27074,19318,9351,16130,30272,,10488,15168,55,123
"Columbia County, Wisconsin",56954,29047,27907,54076,705,225,436,16,459,1037,53,984,56954,55117,1837,0.4056,0.0116,33012,33939,34270,17542,7300,16154,26268,22706,16292,16197,55,021
"Kewaunee County, Wisconsin",20360,10279,10081,19723,81,61,62,0,128,305,2,303,20360,19788,572,0.3956,0.0146,30098,30477,30754,15314,29435,18157,30056,-666666666,10656,16351,55,061
"Brown County, Wisconsin",259786,128824,130962,220920,6034,6380,8324,46,9727,8355,1282,7073,259786,237951,21835,0.4317,0.0106,31213,33807,34714,13372,13030,17162,26556,,13633,11745,55,009
"Marathon County, Wisconsin",135264,67976,67288,122856,883,356,7864,54,684,2567,142,2425,135264,131628,3636,0.4421,0.0131,31879,33407,33828,13100,13111,18388,19176,33281,11977,11263,55,073
"Oneida County, Wisconsin",35345,17724,17621,33996,261,463,165,17,103,340,22,318,35345,34828,517,0.4519,0.0175,32784,33357,33531,15625,14963,20659,28310,,,19116,55,085
"Trempealeau County, Wisconsin",29438,14932,14506,27192,154,105,155,0,1560,272,38,234,29438,27098,2340,0.3970,0.0077,27733,29019,29450,11493,12378,17711,19257,-666666666,11337,10621,55,121
"Washburn County, Wisconsin",15689,7771,7918,14994,68,232,86,42,23,244,2,242,15689,15410,279,0.4543,0.0248,29336,29876,30035,16178,11447,20123,22838,,41357,16111,55,129
"Dodge County, Wisconsin",87776,45777,41999,81999,2412,266,564,25,837,1673,226,1447,87776,83670,4106,0.3972,0.0114,28543,29594,30013,16718,9442,19587,34989,,15147,10919,55,027
"Walworth County, Wisconsin",103013,51374,51639,96114,1037,306,1052,38,2007,2459,535,1924,103013,91641,11372,0.4310,0.0101,30593,31542,32938,15137,13124,33674,23210,,15428,16378,55,127
"Crawford County, Wisconsin",16288,8490,7798,15542,321,57,80,0,20,268,24,244,16288,16058,230,0.4345,0.0196,26038,26972,27070,12387,3088,8281,8645,-666666666,17320,8971,55,023
"Manitowoc County, Wisconsin",79407,39451,39956,74896,719,401,2186,4,170,1031,62,969,79407,76363,3044,0.4062,0.0112,28803,29548,30086,15581,9869,34917,16053,,16399,14678,55,071
"Sauk County, Wisconsin",63596,31747,31849,60031,513,695,416,10,752,1179,232,947,63596,60468,3128,0.4150,0.0118,29608,29960,30367,22321,20946,23037,35847,,40216,10635,55,111
"Burnett County, Wisconsin",15258,7832,7426,13962,81,621,59,0,23,512,19,493,15258,14988,270,0.4195,0.0123,28424,29379,29543,12142,20096,17143,19866,-666666666,16843,18898,55,013
"Chippewa County, Wisconsin",63635,33078,30557,60433,794,102,837,0,99,1370,8,1362,63635,62541,1094,0.4072,0.0102,28277,29009,29271,8109,10156,6632,32148,-666666666,1792,7634,55,017
"Door County, Wisconsin",27439,13535,13904,26455,184,199,138,0,127,336,34,302,27439,26620,819,0.4384,0.0175,36155,36786,37210,19386,23186,20844,33704,-666666666,12211,12713,55,029
"Douglas County, Wisconsin",43402,21757,21645,40314,560,678,465,3,127,1255,38,1217,43402,42731,671,0.4133,0.0133,28888,29925,30032,17232,15130,19563,15347,,7309,13998,55,031
"Jackson County, Wisconsin",20506,10955,9551,17950,436,1154,103,0,302,561,49,512,20506,19835,671,0.4128,0.0150,26037,27502,27723,13789,6033,18859,20114,-666666666,17401,15227,55,053
"Iowa County, Wisconsin",23620,11892,11728,22817,194,54,166,19,154,216,18,198,23620,23209,411,0.4311,0.0181,33674,34089,34179,23595,9493,33302,37803,,14710,24595,55,049
"Ozaukee County, Wisconsin",88284,43342,44942,82714,1200,237,1970,67,580,1516,137,1379,88284,85758,2526,0.4857,0.0165,47980,48636,49032,28190,44157,39199,54134,11633,28073,17836,55,089
"Richland County, Wisconsin",17539,8834,8705,16753,97,55,102,5,310,217,1,216,17539,17146,393,0.3964,0.0142,26379,27005,27123,11180,6852,10849,15068,,11918,16633,55,103
"Campbell County, Wyoming",47708,24559,23149,45357,128,416,164,0,197,1446,100,1346,47708,43634,4074,0.3865,0.0194,33286,33848,35430,17992,27546,26256,31060,-666666666,21215,20091,56,005
"Johnson County, Wyoming",8515,4477,4038,7851,45,381,0,0,113,125,16,109,8515,8327,188,0.4895,0.0598,34885,35600,35671,30273,18911,25309,-666666666,-666666666,39196,21030,56,019
"Natrona County, Wyoming",80610,40816,39794,75885,1099,866,530,43,514,1673,101,1572,80610,73887,6723,0.4365,0.0148,33082,33651,34864,19739,15796,23407,38271,68533,22704,24245,56,025
"Converse County, Wyoming",13997,7206,6791,13417,1,8,24,0,73,474,38,436,13997,12879,1118,0.3973,0.0303,32069,32767,33566,22513,,14338,,-666666666,19896,13832,56,009
"Niobrara County, Wyoming",2448,1088,1360,2278,13,96,33,0,12,16,3,13,2448,2335,113,0.4539,0.0374,22688,23214,22984,22835,,15627,,-666666666,,3000,56,027
"Teton County, Wyoming",23059,11911,11148,20832,274,77,282,35,1375,184,22,162,23059,19626,3433,0.4879,0.0410,53703,55745,59876,27142,115492,,15793,,20923,32421,56,039
"Sweetwater County, Wyoming",44117,22882,21235,41084,354,742,279,204,563,891,32,859,44117,37075,7042,0.4127,0.0201,32624,33087,35311,20599,27194,14653,23840,68297,31460,23742,56,037
"Platte County, Wyoming",8673,4499,4174,8223,1,7,59,0,127,256,40,216,8673,7975,698,0.4635,0.0678,31553,32352,33517,12822,,,52864,-666666666,5813,14540,56,031
"Park County, Wyoming",29121,14276,14845,27485,47,328,167,3,422,669,56,613,29121,27539,1582,0.4437,0.0419,35059,36166,36796,17684,18381,22791,24688,,15396,11878,56,029
"Sheridan County, Wyoming",30012,14852,15160,28534,153,368,211,0,183,563,11,552,30012,28760,1252,0.4383,0.0204,34059,34616,35019,21615,46042,19565,23876,-666666666,8956,24017,56,033
"Big Horn County, Wyoming",11901,6033,5868,11249,53,155,48,18,223,155,72,83,11901,10836,1065,0.3985,0.0154,23978,24400,25317,12467,29832,19240,18908,15150,13728,13433,56,003
"Crook County, Wyoming",7410,3730,3680,7068,12,137,25,0,16,152,0,152,7410,7323,87,0.4387,0.0363,32256,32609,32702,27499,,44836,,-666666666,45500,10889,56,011
"Albany County, Wyoming",38102,19916,18186,34340,463,317,1166,10,547,1259,145,1114,38102,34502,3600,0.4667,0.0228,26665,27895,28723,17682,9827,15285,19473,,14164,14472,56,001
"Carbon County, Wyoming",15477,8332,7145,14401,165,263,150,9,212,277,26,251,15477,12697,2780,0.4106,0.0195,29890,30519,32612,19329,34001,17810,9936,,20868,24928,56,007
"Goshen County, Wyoming",13438,6948,6490,12511,10,153,73,0,314,377,140,237,13438,12011,1427,0.4219,0.0298,27739,27091,27893,29202,,8284,45792,-666666666,72929,16733,56,015
"Uinta County, Wyoming",20609,10505,10104,19252,20,160,22,0,437,718,0,718,20609,18725,1884,0.4002,0.0190,27009,27233,28076,17942,,11387,33609,-666666666,14676,30994,56,041
"Washakie County, Wyoming",8129,4137,3992,7293,1,52,0,0,445,338,37,301,8129,6976,1153,0.3898,0.0331,27556,28547,29134,20544,,47529,-666666666,-666666666,19263,14098,56,043
"Hot Springs County, Wyoming",4680,2387,2293,4504,0,113,0,0,30,33,1,32,4680,4533,147,0.4246,0.0356,32359,31950,31440,55405,-666666666,34579,-666666666,-666666666,,43473,56,017
"Fremont County, Wyoming",40076,20135,19941,29179,236,8527,55,8,566,1505,268,1237,40076,37323,2753,0.4298,0.0218,27598,32173,32806,15664,25050,14225,14031,,20636,18321,56,013
"Sublette County, Wyoming",9951,5367,4584,9578,0,43,12,0,0,318,36,282,9951,9220,731,0.3580,0.0356,33231,33759,34047,28596,-666666666,,,-666666666,-666666666,18532,56,035
"Weston County, Wyoming",7100,3768,3332,6570,36,37,310,3,0,144,0,144,7100,6993,107,0.4284,0.0235,29152,30515,30756,15111,,44881,4823,,-666666666,23131,56,045
"Hatillo Municipio, Puerto Rico",40390,19407,20983,39469,225,0,16,0,449,231,223,8,40390,44,40346,0.5175,0.0237,10659,10632,,10664,10397,-666666666,,-666666666,13476,10299,72,065
"Humacao Municipio, Puerto Rico",53466,25267,28199,29266,11060,163,223,0,12374,380,230,150,53466,410,53056,0.5308,0.0383,12093,13529,99266,11583,11682,12031,,-666666666,9421,7599,72,069
"Morovis Municipio, Puerto Rico",31320,15537,15783,29005,455,36,27,0,1303,494,155,339,31320,163,31157,0.4698,0.0252,9715,9745,5643,9737,9338,,,-666666666,9002,9989,72,101
"Mayag�ez Municipio, Puerto Rico",77255,36902,40353,21510,2799,173,33,1,50781,1958,847,1111,77255,610,76645,0.6106,0.0186,10678,15426,32381,10566,17279,,,,8272,12281,72,097
"Trujillo Alto Municipio, Puerto Rico",67780,31892,35888,55351,6533,84,75,11,4883,843,120,723,67780,469,67311,0.4887,0.0227,15886,16275,23333,15828,13289,10305,,,14929,17083,72,139
"Quebradillas Municipio, Puerto Rico",24036,11606,12430,20084,1070,70,34,0,2600,178,11,167,24036,276,23760,0.5155,0.0484,9819,10170,23417,9696,9639,2164,,-666666666,7307,9884,72,115
"Moca Municipio, Puerto Rico",36872,18012,18860,29315,1255,101,56,0,5726,419,68,351,36872,308,36564,0.5594,0.0515,8806,8857,7382,8824,8345,,,-666666666,8923,5708,72,099
"Culebra Municipio, Puerto Rico",1314,676,638,665,68,6,13,0,502,60,0,60,1314,103,1211,0.4175,0.0451,11830,13148,25190,10760,7506,,,-666666666,11445,7345,72,049
"Salinas Municipio, Puerto Rico",28633,13843,14790,16359,9578,62,130,0,2280,224,56,168,28633,133,28500,0.4800,0.0235,9034,9066,,9052,8932,31619,6618,-666666666,8304,13696,72,123
"Barceloneta Municipio, Puerto Rico",24299,11541,12758,20951,841,0,142,0,2130,235,50,185,24299,50,24249,0.4961,0.0261,9170,8806,,9184,14674,-666666666,7923,-666666666,10628,9456,72,017
"Yauco Municipio, Puerto Rico",36439,17475,18964,28189,1300,152,5,0,6279,514,204,310,36439,95,36344,0.5118,0.0160,8339,8475,8333,8325,11240,6254,,-666666666,7374,5961,72,153
"Guaynabo Municipio, Puerto Rico",88663,41805,46858,68681,5785,231,85,0,8480,5401,396,5005,88663,1371,87292,0.5749,0.0152,23895,25194,34649,23603,21379,18744,30398,-666666666,17574,20116,72,061
"Cabo Rojo Municipio, Puerto Rico",49005,23237,25768,13649,986,122,11,0,33985,252,119,133,49005,66,48939,0.5359,0.0217,9245,10466,11176,9242,7904,8932,,-666666666,8796,9502,72,023
"Fajardo Municipio, Puerto Rico",32001,14948,17053,18212,3426,31,119,0,9345,868,228,640,32001,433,31568,0.5259,0.0411,11663,11727,14394,11629,14585,,14784,-666666666,10323,12864,72,053
"Patillas Municipio, Puerto Rico",17334,8481,8853,4393,12542,47,0,0,334,18,18,0,17334,44,17290,0.5057,0.0361,9223,10127,,9234,8863,,-666666666,-666666666,11714,,72,109
"Rinc�n Municipio, Puerto Rico",14269,6844,7425,11649,177,0,5,0,575,1863,10,1853,14269,1593,12676,0.4746,0.0339,11650,11556,20440,10454,13273,-666666666,,-666666666,11215,12251,72,117
"Aguas Buenas Municipio, Puerto Rico",26275,12756,13519,16707,2028,269,0,0,841,6430,33,6397,26275,221,26054,0.5356,0.0405,10188,9424,21513,10092,9447,16718,-666666666,-666666666,12052,11891,72,007
"Bayam�n Municipio, Puerto Rico",182955,86408,96547,122394,14260,267,261,12,11497,34264,994,33270,182955,1611,181344,0.4980,0.0097,14377,15160,16631,14334,13999,10269,16123,,11823,12619,72,021
"Cayey Municipio, Puerto Rico",44530,21378,23152,30429,2585,68,0,0,2683,8765,147,8618,44530,131,44399,0.4957,0.0163,12088,12378,12326,12088,10760,11031,-666666666,-666666666,14423,10768,72,035
"Maunabo Municipio, Puerto Rico",11023,5411,5612,2807,8039,8,0,0,99,70,31,39,11023,127,10896,0.4721,0.0659,9471,10124,,9577,9234,,-666666666,-666666666,10440,9139,72,095
"Pe�uelas Municipio, Puerto Rico",20984,10190,10794,15013,769,31,38,0,4867,266,51,215,20984,65,20919,0.4733,0.0261,8609,8922,12023,8610,8254,13035,,-666666666,7539,11879,72,111
"San Sebasti�n Municipio, Puerto Rico",37964,18448,19516,26678,1091,0,105,0,9407,683,51,632,37964,837,37127,0.5262,0.0456,8739,8584,9322,8703,6749,-666666666,19302,-666666666,8993,12839,72,131
"Toa Alta Municipio, Puerto Rico",73405,35281,38124,59922,5551,248,322,6,4376,2980,190,2790,73405,734,72671,0.4994,0.0201,14241,14651,5951,14281,11993,5657,9028,,12777,13652,72,135
"Vieques Municipio, Puerto Rico",8771,4332,4439,5296,856,7,156,0,2349,107,0,107,8771,524,8247,0.4542,0.0466,11156,11894,24392,10391,11493,,,-666666666,10216,7448,72,147
"Yabucoa Municipio, Puerto Rico",34149,16541,17608,10487,22748,39,12,0,491,372,125,247,34149,27,34122,0.5104,0.0259,9148,9774,,9148,8791,,,-666666666,10427,10626,72,151
"Caguas Municipio, Puerto Rico",131363,61168,70195,100543,11133,239,268,0,15474,3706,1009,2697,131363,1344,130019,0.5204,0.0169,14654,14342,19049,14620,15168,14412,12106,-666666666,17121,11479,72,025
"Can�vanas Municipio, Puerto Rico",46108,22224,23884,22804,5103,0,124,0,17799,278,48,230,46108,126,45982,0.5351,0.0330,11920,13887,6107,11918,13322,-666666666,10894,-666666666,9094,6269,72,029
"Coamo Municipio, Puerto Rico",39265,19056,20209,26204,10011,0,0,0,2969,81,42,39,39265,225,39040,0.5100,0.0217,10761,10564,8523,10773,11001,-666666666,-666666666,-666666666,11757,8572,72,043
"Dorado Municipio, Puerto Rico",37208,17728,19480,29444,4566,0,46,0,1037,2115,99,2016,37208,580,36628,0.5563,0.0312,16570,17461,37518,16256,11234,-666666666,15311,-666666666,18976,14528,72,051
"Barranquitas Municipio, Puerto Rico",28755,14162,14593,25576,1368,17,0,0,1362,432,149,283,28755,0,28755,0.4921,0.0372,8221,8288,-666666666,8221,7899,,-666666666,-666666666,7352,7928,72,019
"Orocovis Municipio, Puerto Rico",21407,10725,10682,17816,697,39,0,0,2422,433,27,406,21407,83,21324,0.5515,0.0417,7889,8438,,7898,4454,7054,-666666666,-666666666,5669,3299,72,107
"A�asco Municipio, Puerto Rico",27368,13240,14128,20550,757,0,0,1,3006,3054,45,3009,27368,1030,26338,0.4697,0.0231,10259,10390,14403,10108,9870,-666666666,-666666666,,9298,10423,72,011
"Ceiba Municipio, Puerto Rico",11853,5660,6193,7629,1053,8,25,0,2893,245,0,245,11853,163,11690,0.5624,0.0853,13044,14842,29338,12890,11982,,,-666666666,8695,10068,72,037
"Comer�o Municipio, Puerto Rico",19539,9692,9847,16018,1819,76,23,0,1439,164,68,96,19539,112,19427,0.5215,0.0226,6903,6873,12952,6878,5649,5607,,-666666666,9080,6210,72,045
"Isabela Municipio, Puerto Rico",42420,20629,21791,28867,2270,37,0,0,10909,337,80,257,42420,595,41825,0.4976,0.0196,9228,9509,13427,9198,11357,,-666666666,-666666666,8022,10467,72,071
"Lares Municipio, Puerto Rico",26451,13026,13425,18825,118,12,0,0,7308,188,0,188,26451,114,26337,0.5523,0.0389,8735,8869,9894,8710,14450,,-666666666,-666666666,8342,7543,72,081
"Las Piedras Municipio, Puerto Rico",37768,18163,19605,13198,23475,0,0,0,635,460,89,371,37768,105,37663,0.5082,0.0263,11239,11773,,11230,11112,-666666666,-666666666,-666666666,8168,6640,72,085
"San Juan Municipio, Puerto Rico",344606,157742,186864,237250,43991,1336,1311,70,46619,14029,2832,11197,344606,6412,338194,0.6179,0.0090,18569,20861,30766,18410,13649,16462,18642,15567,12674,15022,72,127
"Vega Alta Municipio, Puerto Rico",37724,18044,19680,28138,4071,24,90,0,4094,1307,258,1049,37724,592,37132,0.5572,0.0329,11678,12217,14681,11656,9294,,3336,-666666666,10211,12548,72,143
"Maricao Municipio, Puerto Rico",6202,3069,3133,2503,149,18,0,0,3428,104,104,0,6202,10,6192,0.4770,0.0437,5974,6877,,5984,4936,,-666666666,-666666666,5376,5375,72,093
"Aibonito Municipio, Puerto Rico",23457,11263,12194,17922,2793,18,21,0,2523,180,66,114,23457,94,23363,0.4789,0.0395,10630,11093,42445,10584,8734,,,-666666666,9536,11260,72,009
"Juncos Municipio, Puerto Rico",39128,18630,20498,18501,4738,38,83,0,13919,1849,16,1833,39128,276,38852,0.4773,0.0198,9316,9575,3803,9357,10130,,,-666666666,8831,8761,72,077
"Sabana Grande Municipio, Puerto Rico",23054,10877,12177,16113,560,44,0,0,5900,437,162,275,23054,40,23014,0.4993,0.0271,9560,9416,,9560,10343,,-666666666,-666666666,10036,7924,72,121
"Hormigueros Municipio, Puerto Rico",16180,7461,8719,4890,390,0,0,0,10620,280,143,137,16180,32,16148,0.4952,0.0420,11874,11994,,11883,25508,-666666666,-666666666,-666666666,11297,12668,72,067
"Adjuntas Municipio, Puerto Rico",18181,8862,9319,13712,145,25,3,0,4182,114,11,103,18181,58,18123,0.5259,0.0256,7126,6789,13902,7109,8164,,,-666666666,8198,8135,72,001
"Camuy Municipio, Puerto Rico",32222,15424,16798,26206,545,9,0,0,5203,259,132,127,32222,220,32002,0.5404,0.0366,10252,10816,6341,10261,11565,,-666666666,-666666666,7311,9371,72,027
"Gu�nica Municipio, Puerto Rico",16783,8091,8692,10484,699,30,0,0,5371,199,127,72,16783,165,16618,0.5130,0.0409,7430,7832,,7370,15079,10687,-666666666,-666666666,5166,19967,72,055
"Manat� Municipio, Puerto Rico",39692,18720,20972,33602,1681,68,92,0,4032,217,96,121,39692,612,39080,0.5183,0.0216,10946,11067,6919,10979,12563,6985,8030,-666666666,8990,18569,72,091
"Naguabo Municipio, Puerto Rico",26266,12332,13934,17314,1036,0,86,0,7317,513,0,513,26266,166,26100,0.4467,0.0254,9263,9064,19849,9159,10387,-666666666,,-666666666,9491,11026,72,103
"Naranjito Municipio, Puerto Rico",28557,14039,14518,24091,1827,0,0,0,1016,1623,17,1606,28557,38,28519,0.4776,0.0265,9150,9317,,9160,7878,-666666666,-666666666,-666666666,8030,8802,72,105
"San Germ�n Municipio, Puerto Rico",32114,15606,16508,18746,691,37,0,0,12456,184,156,28,32114,211,31903,0.5435,0.0282,9874,10446,14929,9838,10813,28051,-666666666,-666666666,8779,18563,72,125
"Utuado Municipio, Puerto Rico",29402,14279,15123,18189,398,17,112,0,10077,609,354,255,29402,187,29215,0.5071,0.0223,8639,8416,8441,8620,10930,,4945,-666666666,8917,10111,72,141
"Arecibo Municipio, Puerto Rico",87242,41785,45457,71713,3662,255,709,0,9892,1011,495,516,87242,550,86692,0.5108,0.0151,10203,10229,8332,10215,12162,18189,6930,-666666666,8960,13739,72,013
"Arroyo Municipio, Puerto Rico",18111,8514,9597,10946,3429,0,0,0,3513,223,44,179,18111,38,18073,0.4428,0.0290,7979,7409,,7990,10490,-666666666,-666666666,-666666666,7417,6156,72,015
"Cata�o Municipio, Puerto Rico",24888,11764,13124,16314,2557,7,113,0,4198,1699,156,1543,24888,253,24635,0.5634,0.0174,12195,12882,13673,12191,12759,,20882,-666666666,10383,8687,72,033
"Florida Municipio, Puerto Rico",11910,5693,6217,10459,206,0,0,0,1195,50,0,50,11910,140,11770,0.4521,0.0390,8871,9092,,8899,7701,-666666666,-666666666,-666666666,7139,,72,054
"Monroe County, Alabama",21512,10230,11282,11814,8927,346,120,0,24,281,0,281,21512,21210,302,0.5477,0.0284,18890,23778,23928,6069,11639,24193,74431,-666666666,,13829,01,099
"Lawrence County, Alabama",33171,16003,17168,25942,3627,1878,44,24,5,1651,167,1484,33171,32464,707,0.4389,0.0259,23557,23570,23844,9627,18253,31297,81202,,,24500,01,079
"Lee County, Alabama",159287,78372,80915,111986,36675,226,6577,18,861,2944,246,2698,159287,153422,5865,0.5081,0.0121,26960,30267,30572,21730,18384,23051,26090,,17168,13263,01,081
"Pickens County, Alabama",20298,9708,10590,11362,8367,25,13,8,262,261,22,239,20298,19366,932,0.4997,0.0309,22417,29580,30488,12139,13470,,,,8031,13234,01,107
"Sumter County, Alabama",12985,6014,6971,3201,9346,8,338,0,59,33,4,29,12985,12972,13,0.5469,0.0437,15882,28264,28264,19162,11895,23325,3353,-666666666,,9367,01,119
"Choctaw County, Alabama",13075,6253,6822,7420,5590,9,13,0,8,35,0,35,13075,13002,73,0.4809,0.0225,22182,26395,26466,12241,16649,,,-666666666,,10160,01,023
"Marengo County, Alabama",19538,9446,10092,8855,10518,51,0,0,58,56,0,56,19538,19423,115,0.5386,0.0494,23056,27766,27876,9783,19047,25890,-666666666,-666666666,24116,27436,01,091
"Russell County, Alabama",58213,28124,30089,29256,24957,165,518,72,840,2405,212,2193,58213,55093,3120,0.4540,0.0154,22055,24353,24334,19458,20471,16608,20775,,6822,16746,01,113
"Covington County, Alabama",37351,18172,19179,31624,4826,58,159,13,70,601,0,601,37351,36747,604,0.4553,0.0161,23071,24743,24862,16743,13191,27316,9210,,25380,17901,01,039
"Crenshaw County, Alabama",13865,6814,7051,9938,3198,109,188,0,146,286,6,280,13865,13590,275,0.5040,0.0451,23353,25048,24947,19273,19599,9394,38573,-666666666,15272,5862,01,041
"Lauderdale County, Alabama",92585,44315,48270,80561,9364,417,612,61,179,1391,76,1315,92585,90173,2412,0.4672,0.0144,27189,28256,28612,22035,19916,23875,26344,6431,36899,15437,01,077
"Lowndes County, Alabama",10236,4830,5406,2546,7601,13,0,0,0,76,0,76,10236,10166,70,0.4999,0.0221,19491,32888,33053,13366,15025,,-666666666,-666666666,-666666666,9883,01,085
"Limestone County, Alabama",93052,46427,46625,75143,12468,853,1174,24,1662,1728,45,1683,93052,87573,5479,0.4509,0.0145,27699,29228,29961,14025,22343,31915,27368,,12953,12594,01,083
"St. Clair County, Alabama",87306,43755,43551,76224,8252,315,737,8,689,1081,182,899,87306,85217,2089,0.4068,0.0134,24861,25673,25771,15949,18506,31253,23704,,12225,22869,01,115
"Winston County, Alabama",23875,11840,12035,23001,90,93,31,9,161,490,4,486,23875,23141,734,0.4517,0.0266,21799,22253,22487,13371,7080,9514,11326,,14311,8416,01,133
"Cullman County, Alabama",82313,40560,41753,78392,998,348,334,3,793,1445,171,1274,82313,78770,3543,0.4548,0.0146,22980,23499,23902,10523,17371,19191,21633,,9496,7413,01,043
"Elmore County, Alabama",81212,39450,41762,60824,17402,209,392,0,774,1611,70,1541,81212,78865,2347,0.4359,0.0152,27475,30542,30756,22656,17221,24938,41467,-666666666,28915,18638,01,051
"Jackson County, Alabama",52094,25536,26558,47412,1799,615,215,77,552,1424,31,1393,52094,50589,1505,0.4616,0.0159,21608,22113,22233,12435,17505,18338,8163,38942,4663,19055,01,071
"Talladega County, Alabama",80565,39156,41409,51720,26010,345,470,28,678,1314,49,1265,80565,78747,1818,0.4584,0.0173,22498,25306,25487,15978,16879,13985,70836,,8605,15309,01,121
"Washington County, Alabama",16643,8420,8223,11003,4086,1227,62,0,5,260,0,260,16643,16461,182,0.4684,0.0450,22776,23201,23420,9545,23643,19526,3071,-666666666,,10818,01,129
"Coffee County, Alabama",51288,25314,25974,38923,8829,617,666,0,644,1609,10,1599,51288,47739,3549,0.4427,0.0157,27577,30454,31057,20701,20106,18133,15040,-666666666,12310,13902,01,031
"Morgan County, Alabama",119122,58660,60462,95966,15228,740,775,48,4054,2311,97,2214,119122,109431,9691,0.4511,0.0116,25907,28048,29019,11667,17570,37605,22415,,10359,17171,01,103
"Chilton County, Alabama",43930,21672,22258,36599,4148,123,190,0,1858,1012,97,915,43930,40514,3416,0.4845,0.0337,24611,26458,26671,15643,19131,17733,15114,-666666666,13034,4134,01,021
"Colbert County, Alabama",54495,26075,28420,43288,8615,367,267,29,723,1206,150,1056,54495,53146,1349,0.4496,0.0183,24918,26537,26709,15653,19746,18668,29335,9197,18402,8968,01,033
"Dale County, Alabama",49255,24234,25021,35889,9749,377,633,4,947,1656,50,1606,49255,46185,3070,0.4500,0.0151,23837,26313,26676,17006,17506,24532,17560,,9198,18130,01,045
"Etowah County, Alabama",102939,49651,53288,82710,16212,751,739,66,751,1710,76,1634,102939,99059,3880,0.4483,0.0128,24065,25867,26308,9864,16695,12854,41302,,11139,10331,01,055
"DeKalb County, Alabama",71200,35304,35896,60972,1004,934,140,621,5899,1630,147,1483,71200,60980,10220,0.4748,0.0169,21004,22438,23326,8466,18053,18222,42412,5795,7772,22643,01,049
"Lamar County, Alabama",13933,6800,7133,12187,1558,0,0,0,119,69,0,69,13933,13715,218,0.4623,0.0423,21666,22510,22774,8310,17047,-666666666,-666666666,-666666666,3610,7932,01,075
"Randolph County, Alabama",22574,10989,11585,17443,4547,51,68,51,84,330,7,323,22574,21909,665,0.4733,0.0351,23247,25645,26000,10083,16318,18647,,,4121,1823,01,111
"Mobile County, Alabama",414659,197928,216731,243658,147434,2915,8117,62,5004,7469,488,6981,414659,402686,11973,0.4765,0.0078,25215,30338,30487,21445,17567,27420,24336,48726,16892,14528,01,097
"Walker County, Alabama",64493,31506,32987,58547,4007,109,319,0,338,1173,0,1173,64493,62948,1545,0.4587,0.0158,22772,23586,23813,10841,15045,26565,26301,-666666666,13889,9807,01,127
"Cleburne County, Alabama",14938,7281,7657,14068,393,39,3,0,126,309,18,291,14938,14576,362,0.4622,0.0277,21989,22418,22211,24377,20407,,,-666666666,5952,11226,01,029
"Greene County, Alabama",8426,3950,4476,1445,6713,48,0,0,0,220,22,198,8426,8283,143,0.5041,0.0356,14209,28845,28845,,11440,,-666666666,-666666666,-666666666,,01,063
"Barbour County, Alabama",25782,13697,12085,12216,12266,72,96,1,778,353,22,331,25782,24676,1106,0.4731,0.0156,18461,25132,25473,10382,12687,9764,19880,,9185,10129,01,005
"Bullock County, Alabama",10352,5663,4689,2276,7893,122,56,0,5,0,0,0,10352,10301,51,0.5174,0.0479,20346,36395,36944,10267,15911,,,-666666666,,-666666666,01,011
"Calhoun County, Alabama",115098,55315,59783,85558,23676,353,1065,9,1701,2736,202,2534,115098,110895,4203,0.4676,0.0160,24706,26873,27196,13756,18450,13316,44955,,14028,11375,01,015
"Clarke County, Alabama",24387,11539,12848,12935,11173,25,123,0,0,131,8,123,24387,24339,48,0.5185,0.0217,21111,26748,26786,20760,13896,56760,84811,-666666666,-666666666,13294,01,025
"Montgomery County, Alabama",226941,107354,119587,82862,130866,414,6104,56,2522,4117,532,3585,226941,219192,7749,0.4929,0.0089,28008,40594,41852,21174,20168,23693,33067,28070,29759,15770,01,101
"Marshall County, Alabama",95145,46977,48168,87887,2456,389,570,46,2096,1701,211,1490,95145,82184,12961,0.4805,0.0162,23833,24352,26439,9617,13867,28499,34290,86800,13064,18396,01,095
"Henry County, Alabama",17124,8232,8892,12179,4749,4,0,0,37,155,15,140,17124,16676,448,0.4350,0.0185,24069,27412,27684,17635,15977,,-666666666,-666666666,21403,9981,01,067
"Madison County, Alabama",357560,174665,182895,243835,86012,1975,9073,324,4500,11841,779,11062,357560,340266,17294,0.4673,0.0071,35526,40226,41065,20865,24049,39722,41887,25144,14262,24888,01,089
"Tallapoosa County, Alabama",40636,19517,21119,28251,11145,130,155,0,555,400,15,385,40636,39682,954,0.4617,0.0163,23655,28050,28053,18560,13877,29541,14991,-666666666,6576,10824,01,123
"Aleutians West Census Area, Alaska",5750,3432,2318,1699,246,651,2300,148,314,392,107,285,5750,4952,798,0.3628,0.0112,37070,53508,60069,27554,47209,31394,29855,27258,37627,14473,02,016
"Wilcox County, Alabama",10809,5134,5675,2903,7511,22,0,0,57,316,0,316,10809,10739,70,0.5108,0.0287,16584,27160,27179,,13177,7364,-666666666,-666666666,,4056,01,131
"Denali Borough, Alaska",2232,1117,1115,1810,18,44,101,0,5,254,0,254,2232,2223,9,0.3631,0.0441,34956,37893,37893,,10961,28484,4697,-666666666,,28318,02,068
"Kenai Peninsula Borough, Alaska",58220,30314,27906,48489,370,4493,886,194,518,3270,163,3107,58220,55845,2375,0.4322,0.0142,33820,36323,36823,20169,15773,20069,30484,15578,31299,20021,02,122
"Bristol Bay Borough, Alaska",890,526,364,501,4,291,3,2,8,81,0,81,890,858,32,0.3911,0.0323,45259,57564,58240,33441,20575,30111,,,18725,25522,02,060
"Kodiak Island Borough, Alaska",13649,7281,6368,7284,36,1862,3144,90,193,1040,408,632,13649,12430,1219,0.3869,0.0386,32516,41681,42703,23161,30506,20388,24394,23676,27995,16270,02,150
"Northwest Arctic Borough, Alaska",7734,4156,3578,859,87,6382,76,0,41,289,1,288,7734,7645,89,0.4375,0.0188,23230,64820,64896,47774,36343,16499,49080,-666666666,63161,31840,02,188
"Bethel Census Area, Alaska",18040,9381,8659,1986,119,14927,187,3,124,694,15,679,18040,17611,429,0.4446,0.0146,19760,57069,61739,16401,48135,14023,34796,,23827,26648,02,050
"North Slope Borough, Alaska",9797,6116,3681,3099,84,5093,548,175,98,700,10,690,9797,9590,207,0.4156,0.0260,49903,95414,95923,72742,83104,24102,44715,35905,100193,32678,02,185
"Sitka City and Borough, Alaska",8738,4471,4267,5655,103,1118,632,8,45,1177,69,1108,8738,8172,566,0.4222,0.0272,38423,44257,45030,24819,32012,26838,31555,,23982,25833,02,220
"Fairbanks North Star Borough, Alaska",99653,53846,45807,75281,4493,7233,3068,561,1227,7790,161,7629,99653,91702,7951,0.4061,0.0128,36374,39955,41084,22837,32880,21427,37324,24479,26537,19693,02,090
"Ketchikan Gateway Borough, Alaska",13804,7060,6744,9219,103,2013,1062,5,143,1259,44,1215,13804,13103,701,0.4161,0.0166,34900,40894,41526,25974,28488,23441,24745,,30411,18974,02,130
"Matanuska-Susitna Borough, Alaska",103464,53912,49552,85927,1121,5888,1437,226,484,8381,347,8034,103464,98520,4944,0.4171,0.0080,30943,33265,33790,21283,27124,20730,19478,15490,22704,17678,02,170
"Nome Census Area, Alaska",9925,5240,4685,1601,89,7396,160,43,23,613,7,606,9925,9672,253,0.4294,0.0187,22293,52758,55159,20624,33842,15207,23933,18679,20209,26449,02,180
"Dillingham Census Area, Alaska",4975,2573,2402,875,67,3587,76,3,34,333,0,333,4975,4802,173,0.4285,0.0226,25334,51931,55488,24587,27099,18139,35137,,65688,26201,02,070
"Haines Borough, Alaska",2518,1335,1183,2040,1,217,74,4,11,171,0,171,2518,2421,97,0.3796,0.0388,33521,34939,35142,35178,,26346,19291,,,28829,02,100
"Yakutat City and Borough, Alaska",689,369,320,309,2,195,57,16,5,105,0,105,689,639,50,0.3498,0.0273,31878,41057,41244,24422,,23383,27072,19506,24460,25765,02,282
"Juneau City and Borough, Alaska",32330,16517,15813,22182,325,3532,2314,320,415,3242,176,3066,32330,30207,2123,0.3947,0.0343,43276,48695,49803,26148,190719,26290,28816,24190,33029,23436,02,110
"Lake and Peninsula Borough, Alaska",1375,710,665,314,9,926,34,5,2,85,0,85,1375,1356,19,0.4318,0.0462,24571,42177,41721,29316,,18713,15774,,,21856,02,164
"Southeast Fairbanks Census Area, Alaska",6876,3779,3097,5269,47,907,156,2,140,355,10,345,6876,6495,381,0.3858,0.0201,32409,36927,37249,22735,45877,14586,2719,,26591,24517,02,240
"Yukon-Koyukuk Census Area, Alaska",5415,2910,2505,1229,7,3820,33,0,8,318,4,314,5415,5284,131,0.4666,0.0136,22386,37528,38642,14598,,17742,24936,-666666666,12100,20081,02,290
"Anchorage Municipality, Alaska",296112,151144,144968,186522,16439,21876,28445,6890,6813,29127,1864,27263,296112,269265,26847,0.4251,0.0090,39839,48818,50306,28026,27871,24108,24347,22805,28389,22752,02,020
"Aleutians East Borough, Alaska",3425,1989,1436,605,144,1349,878,25,159,265,33,232,3425,3079,346,0.3987,0.0202,32510,52268,51989,33677,31853,26955,30322,13980,28671,27330,02,013
"Skagway Municipality, Alaska",1061,555,506,917,13,55,19,0,5,52,7,45,1061,1006,55,0.3224,0.0209,39842,41761,41976,28387,41254,25958,41232,-666666666,54120,18448,02,230
"Prince of Wales-Hyder Census Area, Alaska",6474,3514,2960,3053,24,2583,76,41,24,673,18,655,6474,6230,244,0.4139,0.0141,27236,35680,35903,21959,31971,20005,14521,13390,21779,18984,02,198
"Petersburg Borough, Alaska",3255,1649,1606,2346,23,237,302,17,6,324,6,318,3255,2918,337,0.4388,0.0227,33227,38494,41372,19758,15148,18722,22736,20212,66217,16835,02,195
"Kusilvak Census Area, Alaska",8198,4388,3810,319,60,7480,32,2,3,302,0,302,8198,8117,81,0.4305,0.0213,12578,78883,83083,24431,25093,9703,34659,,,9113,02,158
"Maricopa County, Arizona",4253913,2104145,2149768,3301814,232690,82699,176740,9405,296569,153996,30773,123223,4253913,2942822,1311091,0.4666,0.0023,31697,34303,40775,17411,23425,18474,36930,23690,16786,18638,04,013
"Graham County, Arizona",37879,20330,17549,29917,752,4808,246,51,996,1109,189,920,37879,25426,12453,0.4049,0.0157,18113,19940,22252,14960,14186,9772,18626,,13539,12097,04,009
"Santa Cruz County, Arizona",46584,22285,24299,39656,248,362,430,0,5376,512,232,280,46584,7685,38899,0.4933,0.0266,20324,20782,39148,16998,11158,30111,16636,-666666666,13300,59234,04,023
"La Paz County, Arizona",20701,10677,10024,15914,170,2924,158,8,932,595,79,516,20701,15087,5614,0.4663,0.0325,21845,22908,25046,17561,28680,15939,20503,,24423,16284,04,012
"Mohave County, Arizona",206064,104047,102017,186510,2262,4862,2512,509,4976,4433,684,3749,206064,172583,33481,0.4451,0.0090,24829,25262,26312,18667,18741,17023,35800,40155,19079,16763,04,015
"Coconino County, Arizona",140217,68918,71299,89502,1869,37388,2908,176,3866,4508,503,4005,140217,120551,19666,0.4654,0.0130,26387,32437,34597,20080,13502,14730,19576,18172,23476,15516,04,005
"Yuma County, Arizona",207829,106973,100856,155842,4498,2677,2734,128,36390,5560,1370,4190,207829,76159,131670,0.4462,0.0103,21178,22434,31960,15514,26607,14554,35062,12180,15271,16808,04,027
"Greenlee County, Arizona",9504,5064,4440,8642,213,436,29,0,163,21,3,18,9504,5090,4414,0.3908,0.0326,25349,25588,30569,20616,15056,26639,,-666666666,25939,8810,04,011
"Pinal County, Arizona",419721,219048,200673,336611,18782,20782,7589,1410,18046,16501,2735,13766,419721,294348,125373,0.4235,0.0100,23653,25499,29230,16000,20698,12175,20380,10302,18291,12327,04,021
"St. Francis County, Arkansas",26294,14441,11853,10743,14624,151,152,0,347,277,89,188,26294,25586,708,0.4729,0.0236,17491,21809,21977,15116,14532,9854,13839,-666666666,21901,6904,05,123
"White County, Arkansas",78804,38751,40053,71645,3206,275,552,21,1053,2052,99,1953,78804,75422,3382,0.4731,0.0186,23747,24718,25089,10844,14411,23680,25967,,7850,12099,05,145
"Nevada County, Arkansas",8440,4425,4015,5348,2927,6,26,1,0,132,0,132,8440,8416,24,0.4140,0.0238,18618,22052,22090,,12788,,,,-666666666,9970,05,099
"Cross County, Arkansas",16998,8200,8798,12695,3308,24,10,0,8,953,8,945,16998,16668,330,0.4752,0.0510,24486,25665,25931,16400,22040,,,-666666666,,17989,05,037
"Drew County, Arkansas",18502,9033,9469,12701,5333,18,43,0,230,177,0,177,18502,17893,609,0.4806,0.0317,23005,24443,24968,9081,19322,,20242,-666666666,8922,47711,05,043
"Columbia County, Arkansas",23892,11444,12448,14476,8351,87,267,0,448,263,61,202,23892,23242,650,0.4974,0.0403,21372,26851,27232,10010,12884,39945,13872,-666666666,9280,11389,05,027
"Saline County, Arkansas",118009,58030,59979,105202,8293,406,1403,62,550,2093,180,1913,118009,112558,5451,0.3983,0.0108,29358,30242,30704,19894,24148,28921,20033,24784,15722,15580,05,125
"Van Buren County, Arkansas",16684,8284,8400,15996,81,120,14,0,34,439,63,376,16684,16176,508,0.4450,0.0187,21622,21667,21895,13698,6093,49696,,-666666666,,14079,05,141
"Izard County, Arkansas",13559,7018,6541,12835,254,195,18,0,45,212,10,202,13559,13257,302,0.4257,0.0500,20501,21076,21289,10702,5313,12869,,-666666666,5102,15328,05,065
"Lincoln County, Arkansas",13695,8590,5105,9104,4292,49,0,0,177,73,2,71,13695,13179,516,0.4452,0.0344,13636,16937,17290,5337,7050,3196,-666666666,-666666666,3872,19811,05,079
"Logan County, Arkansas",21757,10643,11114,19905,293,228,503,0,262,566,190,376,21757,21115,642,0.4486,0.0255,22221,20996,21037,15195,11537,55241,5670,-666666666,11577,77166,05,083
"Crittenden County, Arkansas",49013,23271,25742,21763,23789,155,352,76,90,2788,21,2767,49013,47803,1210,0.4568,0.0165,21882,28868,29384,13827,15677,12314,25142,14155,12997,20920,05,035
"Franklin County, Arkansas",17780,8675,9105,16743,172,273,105,37,59,391,18,373,17780,17235,545,0.4480,0.0237,20262,20701,20992,7429,11938,9384,8277,6243,18431,17565,05,047
"Pike County, Arkansas",10808,5346,5462,9740,355,75,54,0,390,194,22,172,10808,10105,703,0.4352,0.0248,21919,22761,23057,14362,14344,20928,7996,-666666666,15857,9910,05,109
"Jefferson County, Arkansas",70424,34906,35518,28231,39889,213,661,0,814,616,41,575,70424,68992,1432,0.4695,0.0175,20925,27291,27506,13620,16596,10688,27046,-666666666,13829,15825,05,069
"Montgomery County, Arkansas",8993,4440,4553,8205,20,161,122,0,275,210,4,206,8993,8610,383,0.4524,0.0323,22347,23582,23590,11049,6655,17093,8282,-666666666,8436,5998,05,097
"Scott County, Arkansas",10442,5332,5110,9179,28,248,94,0,434,459,5,454,10442,9650,792,0.4325,0.0267,17375,17468,17843,6663,,26843,87710,-666666666,6634,6470,05,127
"Sebastian County, Arkansas",127461,62274,65187,95473,8877,1644,5590,28,10398,5451,873,4578,127461,109601,17860,0.4781,0.0143,25084,28172,29366,11633,14510,20920,24521,,12167,14767,05,131
"Benton County, Arkansas",258980,128399,130581,227609,4359,3710,9862,1440,4495,7505,765,6740,258980,216403,42577,0.4549,0.0092,32624,33117,35972,18434,35063,20135,40647,11598,25034,20469,05,007
"Chicot County, Arkansas",10826,5266,5560,4733,5861,24,43,0,64,101,16,85,10826,10246,580,0.5579,0.0471,21843,25445,27648,7293,18833,,53581,-666666666,7450,25028,05,017
"Johnson County, Arkansas",26291,12976,13315,24033,424,45,490,34,569,696,32,664,26291,22664,3627,0.4427,0.0241,19681,20034,21585,9425,11490,,38405,,10021,8748,05,071
"Lee County, Arkansas",9398,5309,4089,3978,5313,27,13,0,8,59,0,59,9398,9231,167,0.4992,0.0310,15771,21074,21142,16186,11932,3511,,-666666666,,12288,05,077
"Pope County, Arkansas",63644,31317,32327,58030,1895,355,654,0,1136,1574,41,1533,63644,58081,5563,0.4640,0.0181,22110,22529,23421,11945,14506,13999,23633,-666666666,12949,23624,05,115
"Desha County, Arkansas",11887,5623,6264,5855,5596,30,39,0,206,161,23,138,11887,11189,698,0.4642,0.0255,18475,23520,24803,7675,13844,28760,,-666666666,7741,12040,05,041
"Fulton County, Arkansas",12139,6048,6091,11686,71,55,6,5,61,255,0,255,12139,11956,183,0.4311,0.0208,19413,19747,19818,13368,1442,10142,,,14080,13206,05,049
"Garland County, Arkansas",98296,47182,51114,84747,8031,791,523,6,1582,2616,299,2317,98296,92862,5434,0.4881,0.0249,26791,28092,28836,12730,17810,14752,39166,,28055,12699,05,051
"Prairie County, Arkansas",8244,4120,4124,7037,1073,29,29,0,22,54,9,45,8244,8183,61,0.4400,0.0238,24075,25909,25953,14787,13313,,,-666666666,,13039,05,117
"Van Wert County, Ohio",28281,13891,14390,27211,344,58,95,0,166,407,90,317,28281,27368,913,0.4150,0.0213,26698,27189,27495,14181,16508,10226,20099,-666666666,26383,6527,39,161
"Washington County, Ohio",60671,29953,30718,58146,745,329,391,10,213,837,34,803,60671,60017,654,0.4593,0.0194,27860,28495,28570,17900,14533,14580,18148,,14985,9019,39,167
"Williams County, Ohio",36936,18266,18670,35125,383,131,212,6,453,626,196,430,36936,35338,1598,0.4008,0.0183,25428,26018,26277,15518,9035,13975,24143,,19188,9576,39,171
"Auglaize County, Ohio",45784,22705,23079,44271,229,89,197,36,363,599,28,571,45784,45012,772,0.3997,0.0139,29908,30380,30466,18442,20026,24461,28324,47858,14570,8378,39,011
"Columbiana County, Ohio",104003,52418,51585,98739,2292,126,140,3,755,1948,67,1881,104003,102210,1793,0.4472,0.0137,25853,26529,26532,18256,10624,16105,65998,,10356,13247,39,029
"Darke County, Ohio",51734,25557,26177,50415,344,115,236,0,82,542,5,537,51734,50942,792,0.4017,0.0134,26262,26552,26724,13601,15279,28307,12289,-666666666,20102,12823,39,037
"Ottawa County, Ohio",40709,20215,20494,38906,467,90,75,3,555,613,152,461,40709,38663,2046,0.4236,0.0166,33081,33602,34054,22492,17286,11946,58312,,17818,25928,39,123
"Fulton County, Ohio",42305,20940,21365,39432,170,159,170,14,1440,920,326,594,42305,38658,3647,0.3969,0.0184,28411,29227,29862,16398,27798,19630,27106,,19406,9673,39,051
"Hardin County, Ohio",31542,15639,15903,30328,207,3,242,0,152,610,57,553,31542,31025,517,0.3957,0.0137,22329,22713,22832,9374,18101,,17358,-666666666,8532,10086,39,065
"Jackson County, Ohio",32524,15885,16639,31509,202,13,38,29,0,733,79,654,32524,32183,341,0.4133,0.0280,22117,22396,22510,8993,18286,,,,-666666666,12472,39,079
"Lucas County, Ohio",432379,209580,222799,311698,81735,1194,7758,148,9973,19873,3764,16109,432379,402169,30210,0.4880,0.0057,28361,32745,33300,16738,17783,18359,27836,19253,16837,9756,39,095
"Morrow County, Ohio",34976,17461,17515,33697,363,41,22,0,128,725,31,694,34976,34472,504,0.4165,0.0309,27212,27743,27718,18160,1055,,,-666666666,7772,18288,39,117
"Noble County, Ohio",14443,8616,5827,13355,816,11,13,0,74,174,0,174,14443,14340,103,0.4543,0.0613,24616,25778,25819,3046,12403,,,-666666666,3976,4103,39,121
"Preble County, Ohio",41207,20397,20810,40003,239,107,189,0,7,662,9,653,41207,40868,339,0.4024,0.0201,27031,27319,27328,21455,18902,26747,23105,-666666666,,13758,39,135
"Seneca County, Ohio",55475,27649,27826,52041,1544,170,317,0,375,1028,91,937,55475,52681,2794,0.4288,0.0200,25555,26501,26607,21289,9609,21309,17273,-666666666,15716,8502,39,147
"Stark County, Ohio",373475,181448,192027,328522,27492,512,3200,66,2069,11614,601,11013,373475,365982,7493,0.4383,0.0060,28434,29819,29985,18565,17859,29123,43960,43361,18252,11712,39,151
"Allen County, Ohio",103642,52371,51271,85951,12213,260,766,0,919,3533,293,3240,103642,100565,3077,0.4417,0.0142,25662,27524,27805,16321,16767,38555,41498,-666666666,14889,9533,39,003
"Coshocton County, Ohio",36574,18108,18466,35455,403,86,110,0,27,493,17,476,36574,36207,367,0.4240,0.0157,22471,22625,22637,20417,20711,30467,13568,-666666666,,14561,39,031
"Crawford County, Ohio",42021,20612,21409,40626,380,29,232,14,116,624,3,621,42021,41339,682,0.4447,0.0295,24513,24421,24514,35003,26946,25397,32472,,121211,8630,39,033
"Delaware County, Ohio",197008,97504,99504,172894,6551,198,11579,63,814,4909,257,4652,197008,192026,4982,0.4279,0.0081,47183,47788,48074,37919,47089,28283,51332,45919,54195,15838,39,041
"Guernsey County, Ohio",39274,19522,19752,37386,486,79,148,0,300,875,0,875,39274,38809,465,0.4348,0.0158,23599,24036,24153,11563,12243,25459,83683,-666666666,3800,7707,39,059
"Hocking County, Ohio",28495,14129,14366,27700,231,20,86,0,55,403,37,366,28495,28199,296,0.4113,0.0150,24138,24443,24422,23532,6442,,9626,-666666666,,16354,39,073
"Mercer County, Ohio",40806,20578,20228,39647,252,0,179,179,156,393,0,393,40806,40025,781,0.4078,0.0199,28513,28932,29213,14238,14925,-666666666,8516,15373,19479,13643,39,107
"Ross County, Ohio",77051,40551,36500,69564,4120,15,418,10,456,2468,119,2349,77051,76104,947,0.4466,0.0155,23756,24800,24811,17198,15164,,28710,,12470,10094,39,141
"Cuyahoga County, Ohio",1253783,597647,656136,784683,371298,3516,36876,305,18989,38116,4373,33743,1253783,1181291,72492,0.5124,0.0035,31804,38810,39840,18394,18576,25983,40903,27921,18645,14735,39,035
"Lorain County, Ohio",306713,151054,155659,261088,26140,1034,3370,103,3745,11233,1402,9831,306713,276790,29923,0.4480,0.0078,29777,32116,33291,17590,15671,23009,27027,16539,26464,10908,39,093
"Miami County, Ohio",104800,51847,52953,98365,2170,151,1404,19,207,2484,78,2406,104800,103103,1697,0.4175,0.0129,29703,30246,30425,21299,20456,22518,38483,,51227,10148,39,109
"Montgomery County, Ohio",532034,256154,275880,388086,109355,1264,11223,205,4553,17348,823,16525,532034,516896,15138,0.4670,0.0053,28807,32030,32385,17121,19793,11631,35324,9259,15833,14185,39,113
"Trumbull County, Ohio",201794,98467,103327,178761,16775,304,990,9,274,4681,314,4367,201794,198255,3539,0.4494,0.0097,26116,27245,27393,16252,17822,24643,34850,,22104,11166,39,155
"Wood County, Ohio",129936,63995,65941,119584,3459,222,2164,59,1301,3147,602,2545,129936,122823,7113,0.4531,0.0118,31324,32154,32471,22580,18699,14807,39975,12315,25247,11746,39,173
"Ashtabula County, Ohio",98136,49335,48801,90979,3696,158,486,53,533,2231,182,2049,98136,94139,3997,0.4439,0.0102,22817,23430,23695,15657,14361,17687,35259,,12091,10229,39,007
"Adair County, Oklahoma",22113,10969,11144,9359,75,9727,145,39,407,2361,105,2256,22113,20652,1461,0.4606,0.0191,16851,19751,19817,10245,9949,15260,21676,15400,11253,12819,40,001
"Stephens County, Oklahoma",43983,21328,22655,36613,769,2331,277,37,1735,2221,102,2119,43983,40663,3320,0.4557,0.0149,25374,27181,27427,15783,16125,19389,9887,,14471,15623,40,137
"Cimarron County, Oklahoma",2189,1095,1094,2129,5,10,4,0,33,8,5,3,2189,1716,473,0.4623,0.0704,27929,26307,29380,22905,,34130,,-666666666,139339,,40,025
"Carter County, Oklahoma",48406,23494,24912,36108,3108,3843,550,10,621,4166,263,3903,48406,44984,3422,0.4530,0.0184,25110,27917,28776,12958,17555,18807,21416,,18858,13695,40,019
"Grant County, Oklahoma",4418,2240,2178,3961,50,35,5,3,115,249,0,249,4418,4203,215,0.4029,0.0304,29060,29726,29748,21154,45188,39031,20620,,22185,17371,40,053
"Greer County, Oklahoma",5943,3419,2524,4660,495,188,0,0,259,341,162,179,5943,5274,669,0.4462,0.0294,18292,21088,21625,9917,6480,7518,-666666666,-666666666,14775,5853,40,055
"McClain County, Oklahoma",38634,19191,19443,32643,421,2137,119,23,738,2553,52,2501,38634,35586,3048,0.4153,0.0156,29797,31245,32058,16586,15199,23801,9127,,15092,24069,40,087
"McIntosh County, Oklahoma",19819,9784,10035,13847,535,3149,13,22,46,2207,25,2182,19819,19285,534,0.4598,0.0208,22922,24437,24785,9707,29622,17894,,,10404,19454,40,091
"Murray County, Oklahoma",13875,6954,6921,10530,220,1365,81,0,136,1543,34,1509,13875,12981,894,0.4402,0.0281,26837,29416,30120,15333,10683,22396,6165,-666666666,19110,17236,40,099
"Noble County, Oklahoma",11411,5625,5786,9559,20,842,12,5,58,915,9,906,11411,10995,416,0.4474,0.0322,27828,30133,30369,17484,19520,16931,,,23290,14545,40,103
"Ottawa County, Oklahoma",31566,15520,16046,21463,342,5287,223,232,572,3447,112,3335,31566,29805,1761,0.4457,0.0102,20209,22035,22534,9743,5584,18288,18088,14438,12333,15071,40,115
"Sequoyah County, Oklahoma",41359,20382,20977,26698,775,8342,301,21,568,4654,74,4580,41359,39679,1680,0.4479,0.0147,20020,21111,21370,11581,21277,19386,10618,5771,13583,16151,40,135
"Wagoner County, Oklahoma",77850,38525,39325,58837,2693,6656,1147,63,1126,7328,258,7070,77850,73207,4643,0.3988,0.0092,28286,30395,31033,18066,20043,23886,23686,23421,18275,20670,40,145
"Woods County, Oklahoma",9127,4924,4203,8114,218,142,87,0,60,506,98,408,9127,8479,648,0.4352,0.0239,27232,28798,29669,15783,9326,15849,12116,-666666666,17057,16825,40,151
"Caddo County, Oklahoma",29342,15361,13981,18501,658,7002,113,46,989,2033,144,1889,29342,25680,3662,0.4462,0.0205,22062,25742,27439,8858,19739,16923,,,10105,13889,40,015
"Muskogee County, Oklahoma",69084,33709,35375,40215,7453,12573,500,19,2231,6093,180,5913,69084,64920,4164,0.4736,0.0150,22775,26266,26643,12231,16747,20845,33375,,13096,13798,40,101
"Okfuskee County, Oklahoma",12115,6486,5629,7722,923,1614,11,0,80,1765,92,1673,12115,11643,472,0.4407,0.0162,17281,19376,19557,15248,10150,14291,,-666666666,20900,14523,40,107
"Bryan County, Oklahoma",45759,22228,23531,34018,877,6935,246,46,908,2729,86,2643,45759,43096,2663,0.4664,0.0180,23453,25299,25582,16221,15327,18749,27800,28604,18424,16207,40,013
"Harper County, Oklahoma",3847,1887,1960,3624,4,13,0,0,161,45,6,39,3847,2951,896,0.4260,0.0456,24714,23986,27328,16360,,,-666666666,-666666666,42112,24936,40,059
"Kay County, Oklahoma",44880,22275,22605,35313,986,3805,229,0,1268,3279,111,3168,44880,41361,3519,0.4459,0.0137,24853,27346,27996,14951,13598,14452,21302,-666666666,18934,15996,40,071
"Craig County, Oklahoma",14493,7394,7099,9589,465,3185,130,22,53,1049,34,1015,14493,13977,516,0.4231,0.0184,20704,22643,23133,9830,10971,17615,10365,31059,22460,17650,40,035
"Tulsa County, Oklahoma",642781,313659,329122,450615,64783,31257,20542,559,24355,50670,2088,48582,642781,562769,80012,0.4825,0.0045,30894,35262,37502,15231,18836,25611,28455,17508,13687,20127,40,143
"Canadian County, Oklahoma",136710,67922,68788,110729,3759,5505,4042,25,4472,8178,1198,6980,136710,124922,11788,0.4011,0.0119,30545,32732,33329,18400,26246,23357,26451,,15068,18023,40,017
"Harmon County, Oklahoma",2721,1299,1422,1760,238,11,20,0,469,223,105,118,2721,1943,778,0.4384,0.0257,22588,28465,29294,13102,14964,15118,,-666666666,12920,5378,40,057
"Pushmataha County, Oklahoma",11119,5439,5680,8215,98,1505,54,12,29,1206,7,1199,11119,10704,415,0.4956,0.0266,23346,25440,25508,20167,11772,19799,4331,,26893,15396,40,127
"Latimer County, Oklahoma",10495,5312,5183,7032,101,2182,76,0,49,1055,34,1021,10495,10119,376,0.4819,0.0326,23842,27327,27634,9134,6707,18672,11517,-666666666,2178,14843,40,077
"Osage County, Oklahoma",47311,23675,23636,30734,5344,6186,195,12,533,4307,64,4243,47311,45643,1668,0.4414,0.0136,24363,26874,27110,13175,20186,22359,18773,,13456,16114,40,113
"Texas County, Oklahoma",21121,11313,9808,13427,910,147,651,9,5292,685,228,457,21121,11557,9564,0.3884,0.0219,22120,24902,29502,15555,25154,19224,9906,,16661,18246,40,139
"Garfield County, Oklahoma",62190,31003,31187,51146,2570,1224,582,609,2550,3509,149,3360,62190,54633,7557,0.4362,0.0148,26454,28525,29805,16048,17553,21463,19221,22778,19188,11648,40,047
"Johnston County, Oklahoma",11041,5458,5583,7896,210,729,8,13,89,2096,196,1900,11041,10465,576,0.4454,0.0264,20930,22633,22882,12127,8941,23615,,,18908,14766,40,069
"Pittsburg County, Oklahoma",44382,22583,21799,32257,1303,2941,167,65,297,7352,80,7272,44382,42182,2200,0.4574,0.0184,24750,27658,28003,16238,22062,17047,29442,14003,18114,15807,40,121
"Roger Mills County, Oklahoma",3708,1814,1894,3287,17,110,0,0,68,226,0,226,3708,3447,261,0.4868,0.0291,26431,28147,29268,9774,,23155,-666666666,-666666666,15044,7235,40,129
"Woodward County, Oklahoma",20967,11122,9845,18662,286,290,38,4,707,980,38,942,20967,18348,2619,0.4364,0.0398,28248,30015,31961,14146,10654,15197,15524,,20711,9433,40,153
"Cherokee County, Oklahoma",48599,23863,24736,24926,707,16657,310,106,784,5109,105,5004,48599,45175,3424,0.4540,0.0152,20575,24034,24922,10815,10706,16720,34815,21095,12561,17987,40,021
"Delaware County, Oklahoma",42112,20756,21356,27637,148,9572,510,36,468,3741,138,3603,42112,40545,1567,0.4579,0.0169,22976,26469,26711,13151,8176,16587,21204,30556,13834,15418,40,041
"Ellis County, Oklahoma",4072,1954,2118,3765,9,75,33,0,29,161,37,124,4072,3776,296,0.4598,0.0317,27120,27146,28265,11359,,39348,12639,-666666666,22069,21334,40,045
"Grady County, Oklahoma",54733,27348,27385,46853,1218,2615,275,0,371,3401,127,3274,54733,51606,3127,0.4407,0.0125,28577,30296,31090,13823,16442,19606,23294,-666666666,15087,18042,40,051
"Payne County, Oklahoma",81512,41891,39621,65987,3262,3755,3605,69,314,4520,121,4399,81512,77692,3820,0.5249,0.0178,23589,25273,25444,20604,13886,13551,19255,3816,21831,18229,40,119
"Pottawatomie County, Oklahoma",72000,34410,37590,54660,2449,10456,502,47,565,3321,107,3214,72000,68353,3647,0.4419,0.0104,23155,25377,25820,13338,12032,16878,31002,11336,15037,14911,40,125
"Creek County, Oklahoma",71160,35189,35971,56455,1520,8060,386,47,559,4133,88,4045,71160,68291,2869,0.4484,0.0115,25150,26987,27397,16109,17391,18239,23393,27509,14640,17933,40,037
"Tillman County, Oklahoma",7515,3860,3655,4934,607,192,1,4,1216,561,179,382,7515,5529,1986,0.4626,0.0305,21673,26583,27563,11750,14728,13479,,,11642,10460,40,141
"Washita County, Oklahoma",11432,5740,5692,10273,131,141,24,0,266,597,69,528,11432,10307,1125,0.4394,0.0284,26744,27751,28731,13743,19212,20823,121575,-666666666,12236,15119,40,149
"Cotton County, Oklahoma",5929,2984,2945,4743,131,571,0,0,44,440,0,440,5929,5476,453,0.3936,0.0195,22596,25372,25676,15440,9939,13792,-666666666,-666666666,9827,9141,40,033
"Kiowa County, Oklahoma",9001,4463,4538,7064,314,387,69,6,423,738,175,563,9001,7962,1039,0.4318,0.0207,20888,23588,24141,11710,13756,11249,10381,,13838,8323,40,075
"Le Flore County, Oklahoma",49909,25067,24842,37782,1051,5432,270,0,948,4426,114,4312,49909,46457,3452,0.4561,0.0130,20656,21925,22620,10130,14644,17339,30474,-666666666,12126,16555,40,079
"McCurtain County, Oklahoma",32966,16217,16749,21174,2633,4612,222,286,601,3438,260,3178,32966,31032,1934,0.4526,0.0126,19692,22227,22376,10681,15305,15892,23739,10976,12021,14342,40,089
"Major County, Oklahoma",7718,3795,3923,6925,27,149,43,10,320,244,18,226,7718,6995,723,0.4344,0.0257,28801,30455,31228,15951,23681,16498,,,17132,9184,40,093
"Mayes County, Oklahoma",40980,20435,20545,27336,212,6997,163,98,189,5985,33,5952,40980,39558,1422,0.4267,0.0182,23861,26375,26561,16518,15743,19480,12229,46324,22240,17785,40,097
"Oklahoma County, Oklahoma",782051,382760,399291,535498,117920,21516,26550,792,27564,52211,3104,49107,782051,648108,133943,0.4891,0.0052,30398,34889,39283,14343,20327,23720,30404,13354,15549,17922,40,109
"Custer County, Oklahoma",29209,14413,14796,23433,929,973,354,10,1101,2409,229,2180,29209,23950,5259,0.4760,0.0292,25569,28041,31083,13021,16153,16022,14742,,24906,10911,40,039
"Beaver County, Oklahoma",5415,2756,2659,4348,14,100,0,0,848,105,11,94,5415,4170,1245,0.4219,0.0276,24610,26726,28175,13788,6507,26719,-666666666,-666666666,14526,18816,40,007
"Love County, Oklahoma",9933,4958,4975,8264,253,545,78,0,264,529,11,518,9933,8426,1507,0.3903,0.0208,21704,22109,23557,13495,17853,20529,69487,-666666666,16705,13872,40,085
"Beckham County, Oklahoma",22621,12222,10399,18953,863,430,180,8,1112,1075,118,957,22621,19348,3273,0.4498,0.0326,24049,25723,25782,23096,8199,16211,18840,,25881,9550,40,009
"Choctaw County, Oklahoma",14886,7170,7716,9387,1693,2291,2,22,211,1280,16,1264,14886,14259,627,0.5136,0.0287,21329,22677,22680,15501,18913,21846,,,14517,14806,40,023
"Jackson County, Oklahoma",25384,12579,12805,17963,1764,413,345,20,3070,1809,618,1191,25384,19349,6035,0.4334,0.0202,23226,26636,27802,13503,16802,21523,49656,,13254,8159,40,065
"Lincoln County, Oklahoma",34854,17326,17528,29712,640,2658,122,29,129,1564,46,1518,34854,33688,1166,0.4479,0.0142,24454,25292,25455,18318,15613,23502,16225,12672,8402,15960,40,081
"Marion County, Oregon",335553,167333,168220,271989,4588,3090,6751,3015,23540,22580,3348,19232,335553,247271,88282,0.4312,0.0099,26143,28331,31744,14025,16589,19964,26523,19509,16257,13650,41,047
"Jackson County, Oregon",214267,104458,109809,195769,1324,2338,2767,760,3106,8203,522,7681,214267,187399,26868,0.4656,0.0132,28728,29499,31201,15463,15780,20256,41391,20857,16479,15922,41,029
"Grant County, Oregon",7183,3631,3552,6801,22,99,31,6,38,186,2,184,7183,6920,263,0.4287,0.0278,26029,26461,26723,18175,,21441,41948,,15576,14215,41,023
"Jefferson County, Oregon",23143,12010,11133,16448,206,3903,138,18,1586,844,177,667,23143,18521,4622,0.4133,0.0182,22492,25749,27552,15795,10063,13271,18566,,17791,14529,41,031
"Clackamas County, Oregon",405788,199775,206013,357240,3753,3054,17046,1189,8120,15386,1282,14104,405788,371129,34659,0.4464,0.0059,39619,40894,41959,23638,28694,26753,41900,25179,22878,22651,41,005
"Linn County, Oregon",122870,60623,62247,111089,496,1124,1366,100,3396,5299,780,4519,122870,111960,10910,0.4258,0.0148,25781,26613,27127,17078,23636,15620,26395,13955,18228,15599,41,043
"Tillamook County, Oregon",26076,13139,12937,24118,103,188,160,121,457,929,19,910,26076,23381,2695,0.4430,0.0349,27122,28145,29729,11112,21763,10471,44646,6088,12451,11453,41,057
"Baker County, Oregon",15984,8232,7752,14855,149,213,139,45,300,283,10,273,15984,15333,651,0.4385,0.0218,26152,26775,26938,19840,15872,30237,21640,15404,10561,16241,41,001
"Josephine County, Oregon",85481,41984,43497,78686,379,1003,841,60,1554,2958,153,2805,85481,79235,6246,0.4644,0.0193,24763,25474,25662,18774,18676,21875,29370,15472,12383,12997,41,033
"Umatilla County, Oregon",76898,40110,36788,65736,717,2485,668,137,3945,3210,496,2714,76898,56585,20313,0.4391,0.0196,23464,24569,27341,15149,14483,16296,41446,11926,17685,12238,41,059
"Lincoln County, Oregon",47881,23050,24831,42224,290,1390,543,109,1024,2301,367,1934,47881,43541,4340,0.4448,0.0168,27072,28194,28876,15979,17386,15536,42333,8272,15040,17331,41,041
"Columbia County, Oregon",50851,25506,25345,47208,280,474,573,111,324,1881,109,1772,50851,48317,2534,0.4201,0.0224,29317,29701,30302,21151,26593,27398,21953,23756,49377,19672,41,009
"Sherman County, Oregon",1605,871,734,1532,9,15,2,14,0,33,0,33,1605,1547,58,0.5114,0.0616,33821,34972,36087,6645,11222,12233,,,-666666666,10224,41,055
"Wasco County, Oregon",25866,12918,12948,22559,82,925,183,152,1165,800,109,691,25866,21269,4597,0.4173,0.0229,26249,27456,29227,16471,20718,20376,18114,8563,17791,17095,41,065
"Lane County, Oregon",368882,181850,187032,320920,3910,4028,9794,911,9645,19674,1550,18124,368882,336896,31986,0.4637,0.0068,28070,29332,30026,16374,18936,18832,31253,16891,16846,15623,41,039
"Malheur County, Oregon",30431,16581,13850,27106,350,341,390,21,1308,915,150,765,30431,20256,10175,0.4467,0.0179,18700,19657,22456,13320,5459,4132,19736,,10483,12413,41,045
"Washington County, Oregon",581821,287522,294299,442993,11642,3626,59272,2478,30950,30860,4215,26645,581821,485581,96240,0.4268,0.0054,37657,39523,42556,18678,32086,28197,45129,33321,18089,19713,41,067
"Morrow County, Oregon",11215,5683,5532,9936,26,167,69,28,631,358,18,340,11215,7191,4024,0.3915,0.0247,22599,23687,28376,14400,,12872,12367,,16829,11605,41,049
"Clatsop County, Oregon",38562,19166,19396,35170,282,223,400,126,574,1787,192,1595,38562,35302,3260,0.4145,0.0127,28750,29338,30226,16923,16456,21683,56585,18726,21755,16731,41,007
"Curry County, Oregon",22507,11043,11464,20420,102,429,127,20,133,1276,69,1207,22507,20944,1563,0.4470,0.0220,28365,29111,28976,25710,29966,37913,24943,,24190,14009,41,015
"Gilliam County, Oregon",1907,912,995,1773,0,82,9,13,23,7,0,7,1907,1788,119,0.3959,0.0342,25649,26435,26618,18751,-666666666,20033,,,,,41,021
"Lake County, Oregon",7843,4192,3651,7141,15,202,112,0,74,299,30,269,7843,7216,627,0.4424,0.0223,22469,23157,23882,13692,,22147,19320,-666666666,20746,8856,41,037
"Union County, Oregon",26028,12911,13117,23961,190,342,277,322,194,742,58,684,26028,24803,1225,0.4622,0.0220,27425,27756,28018,18053,16753,23459,60590,13711,13921,18410,41,061
"Delaware County, Pennsylvania",563527,271056,292471,391240,120783,968,31210,198,5430,13698,1310,12388,563527,542830,20697,0.4820,0.0050,38251,44574,45130,20876,21832,15948,35768,12945,17165,18390,42,045
"Union County, Pennsylvania",45114,24802,20312,39188,2882,323,746,26,1038,911,227,684,45114,42471,2643,0.4501,0.0204,25606,28263,28718,9313,6666,1125,15319,,9225,7365,42,119
"Wayne County, Pennsylvania",51536,27278,24258,48418,1668,116,313,9,164,848,97,751,51536,49316,2220,0.4187,0.0152,26570,27104,27274,19932,12008,2260,76267,,2841,14475,42,127
"Dauphin County, Pennsylvania",274515,132864,141651,194998,52691,662,11431,79,6213,8441,1023,7418,274515,250075,24440,0.4489,0.0078,32485,37143,38412,17048,20132,15653,29755,149530,17123,17208,42,043
"Westmoreland County, Pennsylvania",354751,173251,181500,336272,8530,320,3243,56,712,5618,458,5160,354751,350696,4055,0.4415,0.0052,32916,33488,33599,19309,21420,19977,44076,16720,15738,12793,42,129
"Forest County, Pennsylvania",7351,5807,1544,4753,2205,23,23,0,135,212,48,164,7351,6885,466,0.3799,0.0255,15360,18100,18643,5654,11019,,16061,-666666666,4582,7195,42,053
"Monroe County, Pennsylvania",167586,82895,84691,128602,24147,576,4041,61,5177,4982,1272,3710,167586,141756,25830,0.4147,0.0095,28486,29092,29926,23729,28928,42480,24971,,25889,14968,42,089
"Philadelphia County, Pennsylvania",1575522,745543,829979,648890,666047,5843,112651,769,93651,47671,8659,39012,1575522,1347811,227711,0.5155,0.0036,26557,36731,40459,15425,19450,17188,24308,20917,14870,16886,42,101
"Blair County, Pennsylvania",123842,60619,63223,118279,2008,42,866,55,462,2130,117,2013,123842,122334,1508,0.4448,0.0117,26648,27099,27132,19894,18607,20733,24311,47851,14480,12319,42,013
"Cambria County, Pennsylvania",134550,66180,68370,125997,4479,72,640,40,479,2843,381,2462,134550,132425,2125,0.4412,0.0106,25779,26664,26765,11658,11584,14125,46114,11213,9274,7630,42,021
"Berks County, Pennsylvania",416642,204883,211759,344336,21739,2983,5867,39,18350,23328,2913,20415,416642,331894,84748,0.4393,0.0065,30187,33080,35674,13897,19474,14281,27117,,16828,10787,42,011
"Huntingdon County, Pennsylvania",45421,24052,21369,41637,2485,52,240,7,214,786,155,631,45421,44563,858,0.4098,0.0098,24159,24663,24810,40078,14896,13042,12561,,10448,34978,42,061
"Lawrence County, Pennsylvania",87382,42321,45061,81402,3207,84,425,0,319,1945,61,1884,87382,86182,1200,0.4624,0.0125,27734,28763,28923,16005,15616,18943,30782,-666666666,9329,7362,42,073
"Mifflin County, Pennsylvania",46362,22744,23618,44917,367,73,88,26,229,662,19,643,46362,45666,696,0.4144,0.0200,24407,24813,24832,17010,17962,8537,12626,19219,10166,8878,42,087
"Cumberland County, Pennsylvania",247433,122321,125112,218340,9402,312,10078,55,2984,6262,717,5545,247433,238215,9218,0.4227,0.0079,36012,37253,37587,18968,20057,19235,42053,113962,17142,16126,42,041
"Allegheny County, Pennsylvania",1225561,591630,633931,981847,157891,1354,44791,334,5670,33674,2066,31608,1225561,1200636,24925,0.4869,0.0029,36907,40305,40388,29903,21035,19970,37191,20956,21673,15304,42,003
"Snyder County, Pennsylvania",40466,20063,20403,39044,415,12,275,0,234,486,68,418,40466,39562,904,0.4040,0.0137,26415,26719,26843,15135,11709,,49820,-666666666,12435,8144,42,109
"Susquehanna County, Pennsylvania",41340,20794,20546,40307,300,35,138,19,164,377,20,357,41340,40642,698,0.4444,0.0121,29630,29917,30064,14966,13178,24611,53535,,10581,13041,42,115
"Crawford County, Pennsylvania",86164,42194,43970,82348,1561,38,401,31,256,1529,204,1325,86164,85080,1084,0.4328,0.0113,25731,26372,26370,19618,11725,13574,19451,,19006,8894,42,039
"Erie County, Pennsylvania",275972,136256,139716,239451,20071,657,4586,68,2957,8182,955,7227,275972,264605,11367,0.4578,0.0074,27349,29406,29888,11177,14549,20715,17915,27334,14525,9002,42,049
"Fulton County, Pennsylvania",14506,7360,7146,13980,309,36,43,0,14,124,15,109,14506,14430,76,0.4075,0.0134,26082,26524,26570,10464,13117,26353,25053,-666666666,24214,9088,42,057
"Juniata County, Pennsylvania",24562,12238,12324,23744,256,0,123,0,276,163,8,155,24562,23690,872,0.4004,0.0166,25057,25360,25755,11579,14519,-666666666,22722,-666666666,17035,12677,42,067
"Schuylkill County, Pennsylvania",143555,73333,70222,134386,4322,303,736,15,1692,2101,283,1818,143555,137685,5870,0.4280,0.0079,26070,26943,27247,13667,8370,7080,43780,,11300,15242,42,107
"Wyoming County, Pennsylvania",27588,13887,13701,26827,255,23,63,0,49,371,9,362,27588,27080,508,0.4061,0.0125,28810,29140,29414,17571,10199,50796,29846,-666666666,57041,12460,42,131
"Adams County, Pennsylvania",102023,50224,51799,94449,1479,67,705,0,2991,2332,536,1796,102023,94978,7045,0.3982,0.0081,30534,31659,32071,16486,24678,23255,19859,-666666666,14013,13274,42,001
"Armstrong County, Pennsylvania",66331,33003,33328,64771,591,19,193,0,53,704,116,588,66331,65839,492,0.4155,0.0084,26465,26694,26714,19860,13347,47974,18802,-666666666,20681,18338,42,005
"Clinton County, Pennsylvania",39074,19278,19796,37595,637,80,298,11,72,381,26,355,39074,38497,577,0.4125,0.0111,23780,24096,24170,14689,9465,9881,34721,,20229,11456,42,035
"Carbon County, Pennsylvania",63931,31783,32148,61489,1269,23,323,8,117,702,8,694,63931,61046,2885,0.4019,0.0126,26867,27297,27663,17691,17976,24578,28070,,5456,8098,42,025
"Centre County, Pennsylvania",161443,84972,76471,141282,6396,154,10245,49,934,2383,275,2108,161443,156763,4680,0.4696,0.0101,29432,30880,31097,19691,21271,6884,20266,16104,17782,11213,42,027
"Northumberland County, Pennsylvania",92325,46545,45780,87514,2469,253,315,76,483,1215,121,1094,92325,89319,3006,0.4366,0.0116,25506,26269,26608,9256,5443,23113,57074,,9343,11607,42,097
"Northampton County, Pennsylvania",301778,148366,153412,259902,16649,850,8295,114,5510,10458,1522,8936,301778,263061,38717,0.4392,0.0084,34017,35547,37099,20363,27669,24240,32639,22141,21040,14941,42,095
"Cameron County, Pennsylvania",4686,2369,2317,4527,5,20,38,0,7,89,21,68,4686,4645,41,0.4243,0.0276,25898,26163,26207,7141,,,28168,-666666666,,10651,42,023
"Venango County, Pennsylvania",52376,25842,26534,50691,434,12,191,0,131,917,22,895,52376,51809,567,0.4245,0.0122,25837,26079,26163,15667,13373,7767,50583,-666666666,22571,13923,42,121
"Beaver County, Pennsylvania",166896,80949,85947,150877,9844,180,858,78,713,4346,212,4134,166896,164355,2541,0.4248,0.0084,30016,31445,31524,22411,18265,26607,19529,36054,29605,9192,42,007
"Bucks County, Pennsylvania",626370,307383,318987,551303,25066,1032,29423,139,7321,12086,1762,10324,626370,594132,32238,0.4480,0.0043,44103,45756,46626,23140,28691,25687,43241,16601,19997,19268,42,017
"Lackawanna County, Pennsylvania",211454,102480,108974,193707,6005,127,5598,48,1614,4355,445,3910,211454,196383,15071,0.4611,0.0083,28427,29467,30640,12530,15521,15772,20943,5067,19347,13615,42,069
"McKean County, Pennsylvania",41806,21531,20275,39500,1040,28,186,15,328,709,57,652,41806,40933,873,0.4475,0.0187,25517,26360,26088,30541,5328,40679,32166,,11258,12629,42,083
"Fayette County, Pennsylvania",132289,65327,66962,122463,5192,48,434,346,425,3381,104,3277,132289,130786,1503,0.4653,0.0138,25876,26737,26831,13380,15852,28858,26585,20141,9840,12544,42,051
"Montgomery County, Pennsylvania",821301,399358,421943,652245,74569,1044,61405,265,11030,20743,2025,18718,821301,780139,41162,0.4667,0.0038,46776,50069,50992,25988,31734,27171,44459,39595,18306,20399,42,091
"Greene County, Pennsylvania",37144,19304,17840,34983,1217,34,124,8,110,668,137,531,37144,36582,562,0.4402,0.0190,26902,27844,27955,8596,5380,2821,25391,,9501,21042,42,059
"Lebanon County, Pennsylvania",138674,67999,70675,120787,3335,91,1937,59,10046,2419,649,1770,138674,121132,17542,0.4034,0.0095,28560,30265,31033,13922,21138,31430,26558,,13417,18515,42,075
"Luzerne County, Pennsylvania",317884,156972,160912,281858,14667,661,3926,181,10577,6014,1026,4988,317884,282809,35075,0.4478,0.0060,27919,29685,30743,13829,11005,11216,34926,21785,13179,9797,42,079
"Montour County, Pennsylvania",18294,8846,9448,16911,323,6,866,0,17,171,20,151,18294,18123,171,0.4823,0.0216,34095,32797,32702,36136,10517,,68042,-666666666,,38122,42,093
"Columbia County, Pennsylvania",66220,31910,34310,62838,1221,82,740,26,609,704,94,610,66220,64453,1767,0.4498,0.0134,25794,26194,26475,14432,9606,41482,28391,25177,22703,16325,42,037
"Butler County, Pennsylvania",186566,92301,94265,178940,1754,80,2353,46,399,2994,170,2824,186566,183881,2685,0.4388,0.0066,36383,36606,36710,27996,37494,23494,46365,86765,28131,15227,42,019
"Jefferson County, Pennsylvania",44084,21887,22197,43169,235,78,127,21,47,407,20,387,44084,43701,383,0.4206,0.0107,24974,25129,25227,11906,23297,11976,28406,,14483,13095,42,065
"Lancaster County, Pennsylvania",538347,263680,274667,476443,23028,875,11691,94,14778,11438,1707,9731,538347,483134,55213,0.4274,0.0060,30778,32264,33367,16808,19610,26240,27012,25231,15987,14684,42,071
"Perry County, Pennsylvania",45924,23184,22740,44567,429,88,182,0,165,493,17,476,45924,45070,854,0.3919,0.0119,29685,30024,30265,16184,12815,25960,30432,-666666666,16758,18398,42,099
"Potter County, Pennsylvania",16937,8475,8462,16480,68,39,58,0,38,254,15,239,16937,16719,218,0.4306,0.0184,24087,24289,24375,11944,6297,33503,45783,-666666666,24161,9359,42,105
"Tioga County, Pennsylvania",41226,20516,20710,40026,273,45,233,11,101,537,44,493,41226,40706,520,0.4290,0.0144,26059,26352,26418,16023,22864,12511,21687,,13592,11749,42,117
"Providence County, Rhode Island",634533,308485,326048,465512,60942,3677,26407,528,53630,23837,6530,17307,634533,493327,141206,0.4818,0.0060,30356,34122,37332,16395,20841,15158,29843,22384,16184,16108,44,007
"Bristol County, Rhode Island",48900,23570,25330,46295,695,43,996,0,174,697,36,661,48900,47479,1421,0.4881,0.0151,43617,44338,44968,18700,19323,19498,47370,-666666666,5699,25556,44,001
"Newport County, Rhode Island",83075,40948,42127,74452,3084,354,1632,202,984,2367,84,2283,83075,78382,4693,0.4700,0.0134,45442,47658,48313,27260,30605,14921,31292,,15654,23035,44,005
"Aiken County, South Carolina",166926,80764,86162,117891,41289,595,1635,76,1595,3845,411,3434,166926,157561,9365,0.4545,0.0090,27526,31049,32085,14740,19188,45499,28740,15224,14571,11380,45,003
"Newberry County, South Carolina",38068,18536,19532,23914,12011,162,61,9,1644,267,99,168,38068,35271,2797,0.4518,0.0150,23344,27524,28373,12662,16644,19604,17210,,14552,7273,45,071
"Edgefield County, South Carolina",26769,14363,12406,16048,9771,64,101,0,498,287,42,245,26769,25210,1559,0.4785,0.0265,25410,31113,32020,17956,16021,5605,106337,-666666666,16336,17903,45,037
"Clarendon County, South Carolina",34017,16740,17277,16768,16588,29,21,9,295,307,18,289,34017,32981,1036,0.4848,0.0217,20967,27189,27806,12699,14829,53934,,,17084,13126,45,027
"Colleton County, South Carolina",37568,17958,19610,21594,14411,289,47,200,796,231,0,231,37568,36381,1187,0.4535,0.0200,21003,25284,25541,8524,15946,18974,11311,,6629,5514,45,029
"Sumter County, South Carolina",106995,51474,55521,51309,50309,321,1328,43,827,2858,289,2569,106995,102848,4147,0.4447,0.0145,22272,28005,28593,17924,17109,16565,22665,,17360,11721,45,085
"Lexington County, South Carolina",286316,139495,146821,227064,41765,813,5019,275,4136,7244,619,6625,286316,269318,16998,0.4332,0.0071,30316,33041,33761,18366,20158,25293,29122,15120,14756,14305,45,063
"Barnwell County, South Carolina",21577,10300,11277,10963,9869,69,32,8,475,161,0,161,21577,21065,512,0.4685,0.0194,19620,25456,25501,10193,13610,19468,,,7629,23801,45,011
"York County, South Carolina",258641,124828,133813,192415,49312,1605,5077,146,4053,6033,681,5352,258641,244853,13788,0.4504,0.0083,32227,36263,36982,20233,21011,19470,27882,24612,15877,13399,45,091
"Berkeley County, South Carolina",209065,103989,105076,140244,49833,945,4799,209,5977,7058,471,6587,209065,195560,13505,0.4203,0.0101,28331,32387,32928,18892,20891,25595,25500,12745,15276,14076,45,015
"Darlington County, South Carolina",67253,31693,35560,38068,27373,256,310,9,52,1185,58,1127,67253,65915,1338,0.4789,0.0140,21587,27034,27510,11862,14652,28120,25447,,20192,4628,45,031
"Georgetown County, South Carolina",61605,29133,32472,39776,19263,75,321,0,1223,947,144,803,61605,59720,1885,0.4948,0.0210,29929,37223,37374,15772,17001,17425,35416,-666666666,12502,8150,45,043
"Anderson County, South Carolina",195995,94565,101430,156465,31052,319,1813,83,1856,4407,232,4175,195995,188867,7128,0.4518,0.0107,25807,27690,27963,16180,18993,19954,34327,33284,12900,9184,45,007
"Chesterfield County, South Carolina",46024,22642,23382,29010,14887,219,222,35,709,942,0,942,46024,44077,1947,0.4481,0.0228,20676,24038,24451,12926,15312,13673,20799,,11761,10316,45,025
"Greenwood County, South Carolina",70264,32553,37711,44848,22516,25,588,0,897,1390,273,1117,70264,66055,4209,0.4835,0.0240,23945,27684,28827,10742,17644,,23964,-666666666,17159,10086,45,047
"Horry County, South Carolina",320915,155100,165815,259166,44077,1691,4161,181,7079,4560,777,3783,320915,301625,19290,0.4462,0.0087,26917,29499,30113,14247,15706,19881,26691,13496,10834,16825,45,051
"Kershaw County, South Carolina",64361,31261,33100,45858,15409,147,253,0,950,1744,186,1558,64361,61671,2690,0.4384,0.0185,24253,27406,27824,15308,16751,11554,24121,-666666666,20445,10783,45,055
"Orangeburg County, South Carolina",88454,41524,46930,30394,54504,302,762,83,575,1834,193,1641,88454,86537,1917,0.4882,0.0178,19992,27628,28304,6822,16244,15067,30278,,10391,5192,45,075
"Abbeville County, South Carolina",24657,11966,12691,17220,6761,0,80,0,51,545,52,493,24657,24310,347,0.4769,0.0302,21185,23383,23521,10360,16955,-666666666,16536,-666666666,3849,6491,45,001
"Bamberg County, South Carolina",14600,7113,7487,5285,8923,78,43,0,161,110,6,104,14600,14309,291,0.4598,0.0225,18873,26344,26553,6412,14873,,19791,-666666666,8716,11567,45,009
"Calhoun County, South Carolina",14713,7013,7700,8149,6089,80,0,0,233,162,57,105,14713,14173,540,0.4871,0.0434,25953,30934,31350,14844,20299,26050,-666666666,-666666666,15466,,45,017
"Dillon County, South Carolina",30871,14567,16304,14439,14844,665,81,2,13,827,2,825,30871,30030,841,0.5054,0.0387,16473,22027,22174,8920,11802,11623,19472,,12208,6988,45,033
"Richland County, South Carolina",408263,197835,210428,185683,190401,686,11452,477,7430,12134,1208,10926,408263,387530,20733,0.4736,0.0082,29010,38037,38850,19833,21928,21222,25457,14606,15222,14818,45,079
"Fairfield County, South Carolina",22712,10854,11858,9010,12794,58,74,0,6,770,0,770,22712,22241,471,0.5119,0.0388,22527,28706,29309,12319,18968,,28718,-666666666,,10185,45,039
"Hampton County, South Carolina",19807,10247,9560,8459,10568,36,106,36,392,210,60,150,19807,19019,788,0.3977,0.0148,17523,21745,22226,8470,14515,48564,16286,,10852,5777,45,049
"Greenville County, South Carolina",498402,241853,256549,370649,90220,1966,11906,364,11687,11610,2097,9513,498402,453772,44630,0.4684,0.0063,30776,34060,35569,15075,21682,22192,32189,11104,13717,14392,45,045
"Lancaster County, South Carolina",89546,43592,45954,66119,19193,188,1008,0,771,2267,193,2074,89546,84854,4692,0.4747,0.0178,29271,32372,32746,23898,18946,207601,40738,-666666666,20954,9198,45,057
"Dorchester County, South Carolina",155474,75635,79839,105419,39452,632,2955,152,2165,4699,613,4086,155474,147417,8057,0.4268,0.0118,28704,32358,32948,19651,22044,12456,23429,,19566,12486,45,035
"Florence County, South Carolina",138561,64599,73962,74711,58898,382,1801,110,717,1942,122,1820,138561,135039,3522,0.4834,0.0152,25149,31866,32395,16782,16699,18735,42192,9078,13876,13563,45,041
"Laurens County, South Carolina",66710,32455,34255,46741,16482,100,300,46,1385,1656,159,1497,66710,63591,3119,0.4540,0.0275,21743,24123,24453,11937,17691,14003,13985,10413,11989,5215,45,059
"McCormick County, South Carolina",9606,5334,4272,4849,4483,34,43,0,31,166,5,161,9606,9543,63,0.4771,0.0493,24419,32792,32972,11048,16590,8062,,-666666666,697,,45,065
"Pickens County, South Carolina",122746,61190,61556,108436,8153,334,2401,62,1244,2116,194,1922,122746,118369,4377,0.4569,0.0112,24803,25692,25919,16394,20600,22331,17244,,14297,11258,45,077
"Union County, South Carolina",27644,13228,14416,18058,8680,16,3,0,101,786,7,779,27644,27242,402,0.4742,0.0437,22372,25138,25103,14344,17644,,,-666666666,11350,12798,45,087
"Williamsburg County, South Carolina",31794,15307,16487,10164,20564,100,186,0,354,426,89,337,31794,31067,727,0.4869,0.0283,18454,24526,25006,8491,15829,16074,12339,-666666666,9089,11267,45,089
"Aurora County, South Dakota",2759,1448,1311,2541,31,101,0,0,61,25,0,25,2759,2559,200,0.4083,0.0427,31468,32711,33308,18932,,3274,-666666666,-666666666,26348,,46,003
"Grant County, South Dakota",7217,3756,3461,6835,11,202,14,0,21,134,0,134,7217,7056,161,0.4176,0.0295,31453,32473,32594,26636,,19109,986,-666666666,27552,4148,46,051
"Tripp County, South Dakota",5468,2719,2749,4476,0,680,21,0,0,291,0,291,5468,5457,11,0.4299,0.0367,26242,28872,28944,,-666666666,8369,,-666666666,-666666666,25926,46,123
"Jackson County, South Dakota",3287,1611,1676,1292,3,1832,18,0,4,138,0,138,3287,3268,19,0.4782,0.0455,13595,20877,20950,5316,,7281,9744,-666666666,,30415,46,071
"Minnehaha County, South Dakota",186749,94085,92664,160346,10095,4415,4033,39,2541,5280,440,4840,186749,177682,9067,0.4199,0.0086,30471,33156,33676,17004,13835,8975,25776,,15549,9695,46,099
"Custer County, South Dakota",8573,4286,4287,8000,33,300,36,0,14,190,0,190,8573,8304,269,0.4084,0.0350,30439,31029,31767,11413,20285,16296,21633,-666666666,,33303,46,033
"Hyde County, South Dakota",1331,666,665,1132,16,151,0,0,5,27,0,27,1331,1322,9,0.4274,0.0543,31692,33238,33327,,,24438,-666666666,-666666666,,,46,069
"Clark County, South Dakota",3673,1876,1797,3552,9,72,5,0,6,29,0,29,3673,3562,111,0.5018,0.0769,30339,31157,31607,15611,,4972,,-666666666,,5010,46,025
"Faulk County, South Dakota",2322,1165,1157,2206,1,98,2,0,0,15,0,15,2322,2292,30,0.4372,0.0487,29065,30146,30146,,,9291,,-666666666,-666666666,,46,049
"Kingsbury County, South Dakota",4967,2537,2430,4861,0,9,10,0,61,26,1,25,4967,4859,108,0.4085,0.0250,32259,32421,32537,23894,-666666666,,80450,-666666666,26489,,46,077
"Walworth County, South Dakota",5510,2726,2784,4375,262,548,75,0,71,179,0,179,5510,5395,115,0.4506,0.0607,31302,34864,34944,13858,,21106,,-666666666,13148,21620,46,129
"Clay County, South Dakota",13925,6879,7046,12405,161,551,360,0,142,306,50,256,13925,13529,396,0.5167,0.0405,26230,27995,28281,11330,10749,7115,16420,-666666666,10611,16036,46,027
"Day County, South Dakota",5506,2857,2649,4796,34,592,5,0,10,69,0,69,5506,5389,117,0.4953,0.0432,28873,30931,31048,20303,,13803,,-666666666,23650,19730,46,037
"Douglas County, South Dakota",2930,1417,1513,2790,0,65,2,0,2,71,2,69,2930,2911,19,0.4337,0.0427,29458,30277,30373,,-666666666,7043,,-666666666,,,46,043
"Harding County, South Dakota",1311,695,616,1198,27,41,4,0,17,24,0,24,1311,1285,26,0.3861,0.0678,31599,33000,33138,,,3737,,-666666666,,9725,46,063
"McPherson County, South Dakota",2364,1192,1172,2264,1,82,10,0,0,7,1,6,2364,2349,15,0.4741,0.0436,27240,28040,28027,,,,30240,-666666666,-666666666,,46,089
"Roberts County, South Dakota",10285,5290,4995,6020,63,3821,11,0,57,313,0,313,10285,9943,342,0.4686,0.0289,26537,35621,34822,36837,54994,12097,212100,-666666666,50086,11569,46,109
"Sully County, South Dakota",1331,698,633,1270,0,17,0,0,0,44,0,44,1331,1313,18,0.5082,0.0732,42276,43272,43272,,-666666666,,-666666666,-666666666,-666666666,,46,119
"Lincoln County, South Dakota",54914,27152,27762,52001,646,310,605,17,304,1031,28,1003,54914,53815,1099,0.4441,0.0205,39797,40562,40871,19524,22383,15300,58821,19071,20678,14303,46,083
"Lake County, South Dakota",12574,6569,6005,11900,56,75,231,0,21,291,0,291,12574,12380,194,0.4696,0.0421,31574,32291,32426,20592,6734,14593,18787,-666666666,14081,22842,46,079
"Lawrence County, South Dakota",25234,12595,12639,23474,214,595,308,32,80,531,34,497,25234,24429,805,0.4549,0.0349,31744,33100,33403,16519,13111,11136,23597,,17953,10256,46,081
"Codington County, South Dakota",27993,14080,13913,26507,168,601,164,12,25,516,14,502,27993,27355,638,0.4374,0.0259,29992,30285,30522,14708,28155,9797,100358,,15600,18061,46,029
"Butte County, South Dakota",10177,5083,5094,9601,68,235,0,0,45,228,24,204,10177,9816,361,0.4740,0.0485,26702,27619,28042,13272,,8584,-666666666,-666666666,5751,18075,46,019
"Corson County, South Dakota",4168,2113,2055,1215,19,2858,1,0,0,75,0,75,4168,4152,16,0.5425,0.0425,15984,33453,33418,12031,14747,8620,,-666666666,-666666666,14036,46,031
"Edmunds County, South Dakota",3940,2008,1932,3857,4,34,5,0,14,26,5,21,3940,3870,70,0.4169,0.0395,32492,32993,33265,9980,,7850,,-666666666,15736,,46,045
"Campbell County, South Dakota",1435,753,682,1424,0,5,1,0,0,5,0,5,1435,1431,4,0.5444,0.1142,39986,40263,40291,30275,-666666666,,,-666666666,-666666666,,46,021
"Bennett County, South Dakota",3437,1620,1817,1219,2,1825,15,0,17,359,0,359,3437,3151,286,0.3962,0.0275,16625,30244,30789,7205,,9275,17773,-666666666,,8103,46,007
"Haakon County, South Dakota",2082,1012,1070,1970,1,60,0,0,0,51,0,51,2082,2063,19,0.4615,0.0371,24426,24779,24599,,,3208,-666666666,-666666666,-666666666,,46,055
"Jones County, South Dakota",735,364,371,725,0,10,0,0,0,0,0,0,735,735,0,0.4053,0.0495,28850,28917,28917,-666666666,-666666666,,-666666666,-666666666,-666666666,-666666666,46,075
"Meade County, South Dakota",27424,14349,13075,24924,531,864,341,11,168,585,33,552,27424,26268,1156,0.4036,0.0225,28654,29840,29849,26023,20826,15825,11013,,18617,17477,46,093
"McCook County, South Dakota",5511,2771,2740,5262,42,29,0,0,92,86,8,78,5511,5319,192,0.3696,0.0287,28032,28636,28995,12141,4790,26614,-666666666,-666666666,17695,13953,46,087
"Turner County, South Dakota",8264,4138,4126,8065,27,52,3,0,8,109,0,109,8264,8075,189,0.4270,0.0332,29465,29769,30107,13301,22930,21708,,-666666666,,14907,46,125
"Brown County, South Dakota",38840,19060,19780,34963,836,1215,1153,0,39,634,18,616,38840,37813,1027,0.4556,0.0352,31977,33875,34511,10450,19154,13177,12519,-666666666,9387,17043,46,013
"Hanson County, South Dakota",3397,1709,1688,3384,0,1,0,0,0,12,0,12,3397,3397,0,0.3702,0.0269,25039,24978,24978,-666666666,-666666666,,-666666666,-666666666,-666666666,41733,46,061
"Mellette County, South Dakota",2055,1026,1029,836,0,1200,0,0,0,19,0,19,2055,1953,102,0.4925,0.0387,13538,23714,23680,6230,-666666666,6635,-666666666,-666666666,-666666666,1732,46,095
"Perkins County, South Dakota",2907,1474,1433,2802,0,63,0,0,5,37,11,26,2907,2861,46,0.4745,0.0479,33065,33635,33918,10609,-666666666,21162,-666666666,-666666666,,14146,46,105
"Pennington County, South Dakota",109294,54990,54304,90568,1237,9604,1442,73,711,5659,278,5381,109294,103858,5436,0.4497,0.0145,30518,34188,34454,18111,20228,9672,17298,25441,17586,14475,46,103
"Union County, South Dakota",15177,7693,7484,14283,128,127,176,0,130,333,66,267,15177,14721,456,0.4502,0.0355,40699,40916,41175,15774,126398,6773,74560,-666666666,8448,6073,46,127
"Miner County, South Dakota",2229,1152,1077,2152,21,5,7,0,11,33,0,33,2229,2185,44,0.4105,0.0288,27570,27897,28077,18823,15614,,,-666666666,31555,11382,46,097
"Ziebach County, South Dakota",2814,1398,1416,665,1,2109,15,0,4,20,0,20,2814,2803,11,0.4554,0.0260,14943,28128,28096,,,10861,,-666666666,,18590,46,137
"Deuel County, South Dakota",4306,2255,2051,4288,0,1,0,0,3,14,4,10,4306,4180,126,0.3862,0.0306,29281,29373,29258,31706,-666666666,,-666666666,-666666666,,,46,039
"Bon Homme County, South Dakota",6969,4071,2898,6179,104,417,55,0,34,180,5,175,6969,6774,195,0.4040,0.0222,23525,24969,25158,10017,7384,6471,36485,-666666666,,23153,46,009
"Brule County, South Dakota",5256,2598,2658,4553,1,581,21,0,4,96,0,96,5256,5118,138,0.5013,0.0468,28292,30624,29535,60606,,12232,,-666666666,,6289,46,015
"Fall River County, South Dakota",6774,3404,3370,5879,21,430,91,0,103,250,0,250,6774,6499,275,0.3861,0.0289,27266,27827,28035,19373,,28158,31789,-666666666,22630,14188,46,047
"Gregory County, South Dakota",4201,2144,2057,3700,0,289,70,0,15,127,8,119,4201,4174,27,0.4683,0.0291,27579,30052,30084,,-666666666,9396,,-666666666,,11771,46,053
"Oglala Lakota County, South Dakota",14335,6989,7346,713,12,13257,0,0,16,337,0,337,14335,13773,562,0.5119,0.0303,10148,21309,21172,9290,,9480,-666666666,-666666666,,4474,46,102
"Maury County, Tennessee",89776,43111,46665,75671,10408,286,833,19,619,1940,222,1718,89776,84690,5086,0.4373,0.0226,27307,28537,29392,14530,21958,14805,30602,,16947,11534,47,119
"Union County, Tennessee",19293,9556,9737,18851,86,6,33,44,25,248,0,248,19293,18990,303,0.4628,0.0354,21677,21906,22111,9474,4437,,,,,15006,47,173
"Montgomery County, Tennessee",196387,98123,98264,139288,39308,1109,4467,747,2961,8507,663,7844,196387,176904,19483,0.4204,0.0109,25938,27862,28481,20448,22640,37059,21682,21785,16687,14045,47,125
"Dickson County, Tennessee",51988,25458,26530,48045,2164,220,271,0,246,1042,78,964,51988,50205,1783,0.4571,0.0290,26093,27013,27398,14329,15606,20473,25880,-666666666,15835,9142,47,043
"Morgan County, Tennessee",21596,12050,9546,20293,1093,31,0,0,94,85,0,85,21596,21323,273,0.4569,0.0266,19726,20861,20976,4052,1682,4206,-666666666,-666666666,1121,6971,47,129
"Grundy County, Tennessee",13331,6571,6760,11310,89,118,25,6,13,1770,0,1770,13331,13167,164,0.4792,0.0262,18782,19681,19889,5647,7715,19564,11884,,,13605,47,061
"Monroe County, Tennessee",45876,22701,23175,43427,958,367,187,0,248,689,61,628,45876,43901,1975,0.4462,0.0256,21919,21268,21698,11480,18138,137348,13941,-666666666,20670,9373,47,123
"Henry County, Tennessee",32279,15554,16725,28896,2736,50,81,0,83,433,14,419,32279,31476,803,0.4462,0.0235,22727,23469,23614,22340,15598,40340,26778,-666666666,67665,6863,47,079
"Cocke County, Tennessee",35336,17105,18231,33520,737,290,0,10,21,758,47,711,35336,34529,807,0.4847,0.0266,21332,20646,20609,17522,16445,11063,-666666666,,20890,60580,47,029
"Crockett County, Tennessee",14499,6907,7592,11426,1918,24,51,0,795,285,29,256,14499,12984,1515,0.4391,0.0289,22050,23947,24185,13784,18712,8304,27347,-666666666,8407,6695,47,033
"DeKalb County, Tennessee",19601,9750,9851,18447,293,0,186,15,384,276,0,276,19601,18027,1574,0.5013,0.0454,25643,25364,26091,12781,32057,-666666666,41547,,10176,49621,47,041
"Lake County, Tennessee",7526,4642,2884,5112,2190,16,10,0,83,115,17,98,7526,7357,169,0.5398,0.0559,16671,20179,20354,12146,9161,,,-666666666,12751,5135,47,095
"Knox County, Tennessee",456185,221667,234518,389831,40310,1373,9983,182,5145,9361,441,8920,456185,437408,18777,0.4836,0.0065,31678,33559,34133,15821,19488,33789,33478,21787,12787,14166,47,093
"Lewis County, Tennessee",11956,5735,6221,11407,195,0,83,0,33,238,10,228,11956,11688,268,0.4234,0.0284,21510,22004,22145,14130,13486,-666666666,,-666666666,,10064,47,101
"McMinn County, Tennessee",52773,25537,27236,48645,2018,135,396,26,478,1075,0,1075,52773,50732,2041,0.4920,0.0387,23842,24407,24688,15033,18894,20514,24409,24746,15417,11516,47,107
"Marshall County, Tennessee",32269,15877,16392,28913,2373,7,103,0,346,527,76,451,32269,30626,1643,0.4216,0.0259,24876,25682,26459,12331,19647,,19996,-666666666,11825,13484,47,117
"Obion County, Tennessee",30520,14647,15873,25980,3072,72,113,11,551,721,122,599,30520,29235,1285,0.4669,0.0213,23141,25015,25359,11316,13951,13085,11535,,13942,4946,47,131
"Rhea County, Tennessee",32628,16106,16522,30802,732,68,109,0,231,686,70,616,32628,31014,1614,0.4685,0.0207,22070,22550,23002,11936,12342,,14501,-666666666,18692,14169,47,143
"Scott County, Tennessee",21954,10855,11099,21521,116,62,3,0,22,230,23,207,21954,21759,195,0.4477,0.0271,19179,19326,19371,12029,10202,21179,,-666666666,2368,11326,47,151
"Tipton County, Tennessee",61446,30240,31206,47936,11113,230,469,94,272,1332,54,1278,61446,59771,1675,0.4439,0.0210,27212,28704,28474,35471,22352,53648,32618,,10326,12737,47,167
"Anderson County, Tennessee",75775,36904,38871,69213,2470,379,1018,29,645,2021,85,1936,75775,73655,2120,0.4655,0.0198,27913,28617,28967,14742,22016,8520,40395,,18884,11654,47,001
"Dyer County, Tennessee",37576,18157,19419,30899,4893,199,282,53,250,1000,86,914,37576,36322,1254,0.4912,0.0351,25427,27098,27249,16294,18994,22000,41209,,7905,4889,47,045
"Fentress County, Tennessee",17994,8893,9101,17602,30,32,112,0,53,165,0,165,17994,17725,269,0.4451,0.0247,19013,19063,19197,12312,2327,,28968,-666666666,,6921,47,049
"Gibson County, Tennessee",49175,23688,25487,38399,8718,189,192,39,307,1331,317,1014,49175,47858,1317,0.4528,0.0201,22565,24906,24938,20558,13826,30924,22625,,26731,10112,47,053
"Hamilton County, Tennessee",357546,172447,185099,269435,69465,623,7256,147,3247,7373,454,6919,357546,338008,19538,0.4826,0.0085,31184,34798,35940,14814,19424,30950,29946,28043,15469,18136,47,065
"Loudon County, Tennessee",51610,25234,26376,48775,522,94,371,0,994,854,26,828,51610,47217,4393,0.4496,0.0254,30175,30834,32127,13998,18775,38672,30111,-666666666,16217,14874,47,105
"Rutherford County, Tennessee",307128,151446,155682,237854,44030,724,9918,37,4849,9716,866,8850,307128,283228,23900,0.4084,0.0084,28883,30810,31890,16604,23099,30292,28195,15711,14777,15619,47,149
"Smith County, Tennessee",19458,9675,9783,18492,512,88,20,0,114,232,33,199,19458,18947,511,0.4966,0.0771,26256,26877,25945,54727,15448,10836,,-666666666,,19001,47,159
"Wilson County, Tennessee",132663,65056,67607,116765,9283,370,1998,69,1876,2302,201,2101,132663,127291,5372,0.4083,0.0109,32850,34073,34494,17710,23821,33539,27570,26222,12939,28150,47,189
"Sullivan County, Tennessee",156734,76050,80684,148189,3063,188,892,125,943,3334,162,3172,156734,153867,2867,0.4770,0.0121,26933,27411,27580,11709,18668,13484,44546,22162,11281,13955,47,163
"Warren County, Tennessee",40454,20091,20363,37141,603,141,241,119,873,1336,91,1245,40454,36842,3612,0.4840,0.0300,22328,23052,23708,14319,15318,7845,22980,1971,18262,11248,47,177
"Washington County, Tennessee",127055,61851,65204,116028,5340,377,2010,5,718,2577,148,2429,127055,122782,4273,0.4842,0.0143,28261,29102,29462,17372,18065,13250,37944,,14122,9986,47,179
"Benton County, Tennessee",16112,7887,8225,15213,511,69,34,0,0,285,9,276,16112,15835,277,0.4704,0.0239,21374,22000,22155,14308,11024,14942,,-666666666,-666666666,8773,47,005
"Campbell County, Tennessee",39687,19306,20381,38679,128,161,155,0,129,435,16,419,39687,39197,490,0.4893,0.0357,23064,23217,23355,10504,43208,24329,12744,-666666666,16556,8693,47,013
"Cannon County, Tennessee",13976,6899,7077,13417,234,34,4,0,43,244,0,244,13976,13676,300,0.4332,0.0353,24700,24970,25273,10875,18908,,,-666666666,,18617,47,015
"Fayette County, Tennessee",39692,19510,20182,27653,10892,334,273,1,225,314,0,314,39692,38658,1034,0.4769,0.0178,31629,37428,37925,13490,18178,6490,22612,,18599,31459,47,047
"Hancock County, Tennessee",6585,3293,3292,6439,37,19,51,0,3,36,4,32,6585,6530,55,0.4887,0.0545,20578,20841,20862,18409,,23084,,-666666666,,,47,067
"Johnson County, Tennessee",17789,9682,8107,16768,584,85,63,0,50,239,5,234,17789,17437,352,0.4811,0.0315,19784,20367,20427,17835,9564,9513,11724,-666666666,22330,9102,47,091
"Lincoln County, Tennessee",33711,16620,17091,30196,2371,69,186,0,40,849,210,639,33711,32557,1154,0.4314,0.0193,25077,26061,26418,13166,17682,16155,16313,-666666666,32655,13038,47,103
"Moore County, Tennessee",6322,3101,3221,5899,84,149,107,0,0,83,6,77,6322,6309,13,0.4608,0.0561,29969,31245,31257,,24069,5697,,-666666666,-666666666,,47,127
"Franklin County, Tennessee",41512,20414,21098,37381,2139,65,231,26,588,1082,46,1036,41512,40150,1362,0.4761,0.0279,27027,27977,28238,13991,21853,36389,16921,,15965,10630,47,051
"Blount County, Tennessee",128443,62290,66153,120724,3396,369,993,127,259,2575,100,2475,128443,124263,4180,0.4611,0.0150,29634,30243,30385,24347,20411,20770,26419,21694,18161,17275,47,009
"Lawrence County, Tennessee",42937,21088,21849,41010,746,119,229,49,137,647,17,630,42937,42045,892,0.4450,0.0212,20752,20697,20841,13899,16859,19228,81155,15553,,11897,47,099
"Carter County, Tennessee",56391,27618,28773,54400,860,198,214,0,111,608,9,599,56391,55378,1013,0.4700,0.0232,21963,22180,22284,14442,13515,44800,13666,-666666666,3064,13440,47,019
"Grainger County, Tennessee",23013,11465,11548,22501,94,88,75,0,1,254,0,254,23013,22271,742,0.4268,0.0357,22151,22365,22262,25374,20886,18845,21939,-666666666,,4913,47,057
"Lauderdale County, Tennessee",26297,13505,12792,16395,8804,198,84,0,215,601,12,589,26297,25655,642,0.4361,0.0193,18128,20751,20986,13915,13328,21565,13399,-666666666,20504,15545,47,097
"Marion County, Tennessee",28417,13832,14585,26522,603,62,131,0,38,1061,54,1007,28417,27919,498,0.4482,0.0241,24714,25243,25437,12682,23393,8285,24208,-666666666,26958,13203,47,115
"Overton County, Tennessee",22004,10857,11147,21473,139,0,104,75,7,206,5,201,22004,21700,304,0.4489,0.0251,20581,20665,20888,4768,4707,-666666666,24423,,,28228,47,133
"Sumner County, Tennessee",179473,87811,91662,157397,12715,593,2282,228,2404,3854,318,3536,179473,171039,8434,0.4427,0.0135,32297,33434,33970,18883,24055,33260,39276,13082,28145,12508,47,165
"Trousdale County, Tennessee",9573,5302,4271,8152,911,24,18,0,0,468,0,468,9573,9508,65,0.4022,0.0422,23634,24770,24803,,19547,,,-666666666,-666666666,9428,47,169
"Williamson County, Tennessee",218648,107021,111627,195112,9305,424,9057,56,709,3985,427,3558,218648,208291,10357,0.4447,0.0077,50931,51672,52993,24498,47877,27701,48036,,23023,36236,47,187
"Clay County, Tennessee",7686,3771,3915,7280,262,77,7,0,10,50,0,50,7686,7634,52,0.4801,0.0531,19512,19953,19989,4923,7665,22586,,-666666666,,,47,027
"Greene County, Tennessee",68669,33550,35119,65069,1459,176,246,48,293,1378,311,1067,68669,66750,1919,0.4730,0.0206,23668,24396,24552,11640,12468,11807,18944,,13117,6572,47,059
"Shelby County, Tennessee",937005,445994,491011,368340,501627,1607,23924,251,25207,16049,1446,14603,937005,878468,58537,0.5106,0.0052,28828,42751,44990,14436,19479,21365,36516,34543,11137,18465,47,157
"Van Buren County, Tennessee",5704,2882,2822,5523,13,0,0,0,11,157,0,157,5704,5646,58,0.4102,0.0313,19560,19541,19672,,12892,-666666666,-666666666,-666666666,,22007,47,175
"Henderson County, Tennessee",27859,13446,14413,24937,2174,0,55,28,85,580,17,563,27859,27234,625,0.4365,0.0260,21793,22472,22850,7238,18787,-666666666,51767,,15386,3016,47,077
"Hickman County, Tennessee",24678,12910,11768,22723,1230,69,86,4,120,446,33,413,24678,24082,596,0.4816,0.0750,22248,23418,23693,11026,5655,,,,19113,11769,47,081
"Jefferson County, Tennessee",53247,26099,27148,50837,961,64,302,11,214,858,25,833,53247,51339,1908,0.4559,0.0277,24855,25394,25863,12109,15934,12447,9743,,16791,11443,47,089
"Sequatchie County, Tennessee",14730,7331,7399,14305,28,9,0,0,26,362,0,362,14730,14213,517,0.3972,0.0245,22383,22450,22628,19403,28118,,-666666666,-666666666,,16820,47,153
"Sevier County, Tennessee",96287,47281,49006,91233,724,338,828,9,1215,1940,89,1851,96287,90675,5612,0.4285,0.0162,23869,24388,25028,10962,19894,23791,19815,,12216,9844,47,155
"Carroll County, Tennessee",28018,13692,14326,24273,2872,98,103,49,59,564,57,507,28018,27303,715,0.4667,0.0277,22007,22962,23175,12844,17487,9186,22259,,12905,8523,47,017
"Chester County, Tennessee",17150,8207,8943,14734,1776,7,86,0,145,402,2,400,17150,16962,188,0.4295,0.0287,21425,22342,22355,13482,15010,,18323,-666666666,12546,20398,47,023
"Davidson County, Tennessee",684017,329948,354069,436135,187189,1640,24045,452,17052,17504,1944,15560,684017,614383,69634,0.4844,0.0052,34343,40552,43780,15863,23176,38879,32004,13194,15233,21027,47,037
"Jackson County, Tennessee",11615,5826,5789,11137,82,0,8,0,169,219,28,191,11615,11381,234,0.4442,0.0289,20276,20670,20733,7538,23754,-666666666,,-666666666,9127,8315,47,087
"Perry County, Tennessee",7912,3978,3934,7459,274,9,35,0,9,126,20,106,7912,7720,192,0.6254,0.0874,28270,29468,30002,4754,11619,,,-666666666,,4363,47,135
"Roane County, Tennessee",52897,25931,26966,49726,1282,138,402,16,174,1159,150,1009,52897,51957,940,0.4755,0.0189,27897,28304,28286,26979,24948,13185,21410,,30607,17351,47,145
"Meigs County, Tennessee",11962,5937,6025,11520,236,27,11,0,0,168,7,161,11962,11721,241,0.4384,0.0224,23555,23734,24079,7577,17822,,,-666666666,-666666666,12989,47,121
"Hamblen County, Tennessee",63740,31141,32599,56020,2756,126,657,139,2568,1474,306,1168,63740,56366,7374,0.4486,0.0260,22252,23534,24510,8561,17321,20086,30832,,5313,9640,47,063
"Haywood County, Tennessee",17779,8246,9533,8006,9005,0,8,8,624,128,0,128,17779,17000,779,0.4846,0.0362,22148,27166,27548,13104,18530,-666666666,,,14342,3256,47,075
"Erath County, Texas",41482,20216,21266,37175,699,477,312,21,1530,1268,170,1098,41482,32811,8671,0.4984,0.0309,25290,25806,27818,15876,3767,18486,22928,,16865,35681,48,143
"Brazoria County, Texas",353999,179060,174939,258490,48391,2024,22847,56,13968,8223,1399,6824,353999,247268,106731,0.4266,0.0098,33547,34640,40341,23021,31961,22058,38590,,19221,21822,48,039
"Motley County, Texas",1156,580,576,1000,19,0,0,0,96,41,7,34,1156,932,224,0.4731,0.0596,26103,27914,30069,17376,,-666666666,-666666666,-666666666,20059,2571,48,345
"Donley County, Texas",3387,1634,1753,3039,172,13,14,0,72,77,5,72,3387,3014,373,0.4279,0.0298,23711,24056,25187,13795,26808,,10757,-666666666,17621,8704,48,129
"Atascosa County, Texas",48828,24398,24430,45293,124,91,152,0,1059,2109,208,1901,48828,17628,31200,0.4510,0.0258,24421,24706,35703,18407,63512,14709,9368,-666666666,25253,17084,48,013
"Coleman County, Texas",8391,4220,4171,7758,254,39,79,0,130,131,25,106,8391,6926,1465,0.5029,0.0479,27842,28641,30111,20343,24392,18782,12006,-666666666,15067,12095,48,083
"Nolan County, Texas",14966,7669,7297,13108,754,112,66,3,730,193,52,141,14966,9439,5527,0.4998,0.0412,25820,27493,31471,19608,11083,15393,21444,,17213,9679,48,353
"Hudspeth County, Texas",4098,2019,2079,2843,65,0,74,0,1045,71,6,65,4098,886,3212,0.5103,0.0640,14190,16104,27836,10292,6071,-666666666,56541,-666666666,6793,9725,48,229
"Medina County, Texas",49334,25551,23783,44727,1275,191,371,11,1612,1147,512,635,49334,23864,25470,0.4399,0.0195,26274,27361,35536,19384,7555,16364,23951,,18713,18012,48,325
"Ward County, Texas",11586,5864,5722,9903,569,176,67,0,717,154,61,93,11586,5455,6131,0.4366,0.0299,26570,26022,35839,18648,31997,22949,54081,-666666666,30479,15702,48,475
"Henderson County, Texas",80460,39097,41363,71849,5243,666,530,37,1020,1115,71,1044,80460,70388,10072,0.4678,0.0150,25280,26288,28335,11994,17852,19208,13908,,15724,13671,48,213
"Harrison County, Texas",66645,32556,34089,49105,14084,246,489,15,1590,1116,269,847,66645,58018,8627,0.4571,0.0268,25418,28119,30378,13688,18547,30549,17448,,14540,11470,48,203
"Menard County, Texas",2123,1117,1006,1727,15,25,0,0,198,158,49,109,2123,1395,728,0.4367,0.0357,25067,25520,28402,19718,,51484,-666666666,-666666666,26670,13915,48,327
"Lamar County, Texas",49532,23917,25615,40256,6162,207,429,133,309,2036,111,1925,49532,45728,3804,0.4648,0.0201,23833,25467,26599,14217,15915,24398,19945,45588,25606,14562,48,277
"Fayette County, Texas",25066,12351,12715,22619,1592,13,119,0,464,259,54,205,25066,19854,5212,0.4795,0.0224,30097,31630,35663,16030,14665,25338,35771,-666666666,15027,15707,48,149
"Williamson County, Texas",527057,259443,267614,422753,33244,1269,33857,401,14507,21026,2920,18106,527057,398924,128133,0.3963,0.0064,35825,36994,41263,23918,30209,26500,41436,38706,26181,19338,48,491
"Polk County, Texas",47837,25878,21959,40283,4945,763,317,62,533,934,30,904,47837,40644,7193,0.4612,0.0165,24686,26330,28178,16925,14655,20362,34488,,14477,14541,48,373
"Refugio County, Texas",7236,3586,3650,5773,428,18,14,0,568,435,4,431,7236,3605,3631,0.4370,0.0329,23810,24660,29334,18654,31328,19717,,-666666666,20265,9675,48,391
"Caldwell County, Texas",41401,20893,20508,33001,2636,270,420,26,4381,667,101,566,41401,20089,21312,0.4494,0.0257,23881,25579,33840,17523,13363,23530,9668,63485,19957,14764,48,055
"Wilbarger County, Texas",12906,6347,6559,10055,1257,160,90,0,1114,230,50,180,12906,9167,3739,0.4222,0.0300,24078,25790,29041,16382,15469,43898,26000,-666666666,17483,13693,48,487
"Reagan County, Texas",3752,1951,1801,1538,27,0,0,0,2139,48,31,17,3752,1100,2652,0.3684,0.0371,25397,33791,39092,19978,11030,-666666666,-666666666,-666666666,19750,16171,48,383
"Hale County, Texas",34113,17751,16362,29237,1637,260,104,7,1118,1750,313,1437,34113,13960,20153,0.4172,0.0193,19854,21062,28993,15401,10923,12953,22045,,14709,12200,48,189
"Shelby County, Texas",25478,12572,12906,19850,4671,204,415,0,242,96,17,79,25478,20873,4605,0.4620,0.0229,20969,23380,26408,11667,12876,13232,5985,-666666666,16608,8384,48,419
"Runnels County, Texas",10310,5233,5077,9506,317,21,25,0,328,113,31,82,10310,6815,3495,0.4469,0.0244,23042,23467,27554,15232,15824,12910,,-666666666,16291,18851,48,399
"San Jacinto County, Texas",27819,13718,14101,23978,2917,134,0,13,293,484,58,426,27819,24256,3563,0.4310,0.0179,21808,22644,23847,14040,18956,,-666666666,,8660,6985,48,407
"Tom Green County, Texas",117466,58343,59123,101066,5011,444,1470,50,7226,2199,440,1759,117466,71147,46319,0.4705,0.0161,28444,28757,34140,21310,19299,43343,69737,16206,23921,19434,48,451
"Victoria County, Texas",91970,44999,46971,80532,5505,269,1032,41,2487,2104,321,1783,91970,49237,42733,0.4619,0.0164,28576,29284,38118,19853,21705,17174,52201,,20764,18454,48,469
"Waller County, Texas",49987,24869,25118,30385,12280,392,487,24,5380,1039,239,800,49987,35084,14903,0.4555,0.0189,24495,31368,37500,14894,13781,9077,40564,,13157,7678,48,473
"Wichita County, Texas",131818,68325,63493,103021,13618,1443,2945,63,5817,4911,697,4214,131818,107000,24818,0.4629,0.0123,23921,26436,28856,14302,13337,20854,21881,21678,16392,11584,48,485
"Wilson County, Texas",48198,24197,24001,44891,708,145,212,44,938,1260,120,1140,48198,29203,18995,0.4263,0.0184,30935,31627,36960,22576,22493,29935,30213,,20575,19112,48,493
"Hockley County, Texas",23162,11428,11734,20710,785,154,74,17,830,592,205,387,23162,12192,10970,0.4407,0.0167,23440,24222,30645,17009,15037,17197,37773,,21141,10879,48,219
"Maverick County, Texas",57970,28736,29234,53746,312,705,269,32,2586,320,252,68,57970,2764,55206,0.4754,0.0291,16891,16243,29701,15970,91132,27922,53859,,13881,23383,48,323
"Fannin County, Texas",34175,18034,16141,29964,2133,207,255,13,640,963,63,900,34175,30423,3752,0.4382,0.0157,24581,26369,27997,10070,11320,18098,12338,,5022,15686,48,147
"Midland County, Texas",164194,82543,81651,138187,10784,1144,3502,72,6935,3570,934,2636,164194,91869,72325,0.4711,0.0134,39179,41054,55015,24539,24774,55198,38230,,30251,23606,48,329
"Live Oak County, Texas",12123,6634,5489,11241,348,22,117,0,245,150,101,49,12123,7341,4782,0.4291,0.0277,24244,24817,31277,14132,4699,,54214,-666666666,8234,32584,48,297
"Llano County, Texas",20640,10138,10502,19270,30,183,82,0,383,692,84,608,20640,18527,2113,0.5174,0.0370,35822,36593,37855,17916,4477,13121,,-666666666,13872,38036,48,299
"Karnes County, Texas",15387,9133,6254,11173,1230,32,14,0,2551,387,51,336,15387,7083,8304,0.5403,0.0407,26875,31127,46473,17012,6376,,,-666666666,20384,13340,48,255
"Brazos County, Texas",219193,111074,108119,166133,22995,823,13763,46,8849,6584,656,5928,219193,163674,55519,0.5144,0.0111,26539,28931,32921,16885,19882,29084,21959,11633,14845,14495,48,041
"Cass County, Texas",30087,14692,15395,23487,5234,39,110,1,552,664,0,664,30087,28752,1335,0.4330,0.0180,22545,24766,24910,12955,14913,50187,30842,,10112,11508,48,067
"Gaines County, Texas",20321,10320,10001,19033,447,93,95,13,552,88,60,28,20321,11946,8375,0.4525,0.0553,22710,22828,23589,21239,20899,44575,25123,,17491,8431,48,165
"Gray County, Texas",22685,11903,10782,19337,1007,309,153,19,1303,557,102,455,22685,16220,6465,0.4674,0.0310,24911,27047,31170,14898,7581,10045,15484,,17600,10704,48,179
"Madison County, Texas",14128,8127,6001,10376,2120,36,441,26,515,614,83,531,14128,10898,3230,0.4523,0.0232,17856,21813,26678,6997,6762,,11481,,9136,2253,48,313
"Jack County, Texas",8842,4987,3855,8226,423,23,12,0,78,80,18,62,8842,7377,1465,0.4601,0.0281,25626,26864,30447,9454,3340,34796,23508,-666666666,20355,18949,48,237
"Kendall County, Texas",41982,20415,21567,37886,323,265,369,25,1471,1643,129,1514,41982,32088,9894,0.4825,0.0284,43241,45135,48834,26546,49980,28928,56172,,19477,19579,48,259
"Bosque County, Texas",18122,8935,9187,17231,290,84,92,0,120,305,36,269,18122,14859,3263,0.4223,0.0199,26039,26565,29000,15063,20538,19438,18500,-666666666,12043,11137,48,035
"Bexar County, Texas",1925865,950030,975835,1535359,146703,13229,54366,2058,112433,61717,15023,46694,1925865,770360,1155505,0.4694,0.0036,26988,27824,42060,19955,25438,20495,32406,32072,20118,18850,48,029
"Bailey County, Texas",7092,3640,3452,5917,56,75,70,0,963,11,11,0,7092,2534,4558,0.4342,0.0671,21449,21919,36131,13882,,,,-666666666,18889,,48,017
"Baylor County, Texas",3591,1752,1839,3335,119,0,0,0,72,65,6,59,3591,3221,370,0.4555,0.0461,25264,25638,24539,32623,27598,-666666666,-666666666,-666666666,18519,9272,48,023
"Cameron County, Texas",421750,204788,216962,398395,2279,1101,2944,72,13600,3359,1824,1535,421750,44311,377439,0.4863,0.0078,16587,16425,34510,14475,24052,46855,35640,20647,14932,10787,48,061
"Denton County, Texas",807047,397140,409907,605355,76648,3742,66753,694,25249,28606,4968,23638,807047,652000,155047,0.4346,0.0040,39535,42038,46776,22802,31970,29761,39883,27099,23295,21938,48,121
"Washington County, Texas",34796,17259,17537,26986,5806,228,591,36,578,571,77,494,34796,29313,5483,0.4837,0.0372,29604,32871,36884,14586,18924,14050,18241,,24255,7923,48,477
"Morris County, Texas",12424,5981,6443,8614,2948,75,17,6,473,291,77,214,12424,11248,1176,0.4406,0.0368,23438,26520,27239,12843,17954,26592,,,10071,9117,48,343
"Stephens County, Texas",9372,4808,4564,8531,222,98,38,0,203,280,0,280,9372,7173,2199,0.4770,0.0510,24405,25375,27685,17763,5369,25838,33621,-666666666,7830,20199,48,429
"Harris County, Texas",4602523,2288295,2314228,2892342,875347,18386,320575,3129,387299,105445,24298,81147,4602523,2643560,1958963,0.4978,0.0023,31901,36112,54856,18637,23484,21873,37192,21851,18119,22831,48,201
"Andrews County, Texas",17818,9102,8716,16464,353,0,63,21,698,219,13,206,17818,7839,9979,0.4506,0.0540,31190,30151,39642,22585,17769,-666666666,544075,,21080,17559,48,003
"Gillespie County, Texas",26208,12731,13477,23870,33,739,42,0,639,885,98,787,26208,20202,6006,0.4733,0.0273,33515,34836,38872,15823,,10743,18412,-666666666,27343,21195,48,171
"Gonzales County, Texas",20667,10448,10219,12748,1381,57,52,4,6068,357,219,138,20667,10231,10436,0.4764,0.0276,26618,31937,38468,17387,23170,12298,16398,,17168,14393,48,177
"Lynn County, Texas",5808,2977,2831,4944,86,37,43,4,370,324,233,91,5808,3057,2751,0.4977,0.0237,25279,26429,34370,16030,40419,10849,13651,,25549,6848,48,305
"Young County, Texas",18114,8930,9184,17197,354,145,89,0,278,51,0,51,18114,14782,3332,0.4334,0.0432,25855,26641,28744,16203,8394,18868,16463,-666666666,10412,,48,503
"Zapata County, Texas",14369,7177,7192,13418,19,0,179,0,718,35,0,35,14369,827,13542,0.5389,0.0789,17228,17445,31818,16618,,-666666666,,-666666666,14354,,48,505
"Hood County, Texas",56901,28004,28897,54311,487,535,455,7,456,650,119,531,56901,49875,7026,0.4573,0.0220,32727,32606,34578,22362,22091,71364,18416,,30529,18661,48,221
"Hopkins County, Texas",36240,17801,18439,30278,2549,65,243,42,2328,735,73,662,36240,30197,6043,0.4583,0.0218,26267,28167,30083,15058,16624,24975,19401,,16620,15435,48,223
"Ochiltree County, Texas",10348,5230,5118,9141,141,197,19,0,493,357,115,242,10348,4784,5564,0.4560,0.0404,24260,25651,34323,16713,15130,19269,98305,-666666666,15193,3595,48,357
"King County, Texas",228,118,110,226,0,0,0,0,2,0,0,0,228,190,38,0.3535,0.0703,31564,31473,36197,8400,-666666666,-666666666,-666666666,-666666666,,-666666666,48,269
"Knox County, Texas",3733,1853,1880,3175,242,30,5,0,193,88,36,52,3733,2464,1269,0.4163,0.0320,21796,22833,26543,15169,14724,31903,,-666666666,18526,8214,48,275
"McLennan County, Texas",248429,121359,127070,193415,36520,1110,4051,110,7657,5566,1086,4480,248429,183696,64733,0.4738,0.0101,24826,27209,31843,14908,16410,16908,18248,21698,16311,15361,48,309
"Cherokee County, Texas",51903,26607,25296,42247,7044,324,192,43,884,1169,152,1017,51903,40048,11855,0.4390,0.0167,21520,22814,26391,12347,13968,26577,76084,,14083,15932,48,073
"Concho County, Texas",4233,2802,1431,3999,94,10,48,0,65,17,5,12,4233,1861,2372,0.4888,0.0669,17684,17298,29259,8598,45231,,,-666666666,16029,7324,48,095
"Delta County, Texas",5215,2527,2688,4571,391,16,35,0,27,175,17,158,5215,4835,380,0.4332,0.0329,25004,25658,25848,26960,12582,,29089,-666666666,88763,20009,48,119
"Edwards County, Texas",2055,1062,993,2049,0,1,0,0,4,1,0,1,2055,861,1194,0.4919,0.0693,29814,29867,52559,13489,-666666666,,-666666666,-666666666,,,48,137
"Eastland County, Texas",18270,9245,9025,16775,673,71,119,0,586,46,9,37,18270,15307,2963,0.5607,0.0536,23940,23407,25124,11862,48278,15292,39202,-666666666,10310,9515,48,133
"Jones County, Texas",19891,12507,7384,13435,2944,153,78,0,1963,1318,362,956,19891,14444,5447,0.4561,0.0314,17673,23533,26403,10495,3674,3919,1118,-666666666,9169,4458,48,253
"Reeves County, Texas",15125,8689,6436,11913,492,26,228,13,2322,131,57,74,15125,3773,11352,0.4325,0.0360,20876,20441,33435,17352,15220,11335,40987,12085,23190,8460,48,389
"Sabine County, Texas",10458,5072,5386,9376,653,13,0,20,83,313,0,313,10458,10003,455,0.4967,0.0352,23450,24904,25703,7867,12323,,-666666666,,3811,4472,48,403
"Sherman County, Texas",3058,1574,1484,2690,11,6,0,0,220,131,45,86,3058,1756,1302,0.4116,0.0344,26335,26674,33382,17296,8045,,-666666666,-666666666,27155,18305,48,421
"Swisher County, Texas",7484,4036,3448,6138,415,256,17,8,176,474,198,276,7484,4230,3254,0.4740,0.0487,19258,21074,26865,13969,4040,24622,,,22505,5672,48,437
"Hunt County, Texas",92152,45279,46873,73179,7328,1047,1164,43,7759,1632,117,1515,92152,77557,14595,0.4479,0.0128,25077,27978,29047,14012,14946,17844,20828,,11557,13038,48,231
"Camp County, Texas",12813,6220,6593,9302,2122,52,44,0,1026,267,16,251,12813,9654,3159,0.4255,0.0294,20898,23650,26267,13778,14706,28598,,-666666666,11424,10695,48,063
"Hansford County, Texas",5547,2783,2764,5055,20,4,0,0,367,101,35,66,5547,2929,2618,0.4344,0.0405,20127,20782,27006,12399,,,-666666666,-666666666,12717,12303,48,195
"Guadalupe County, Texas",155137,76850,78287,112036,12304,507,2692,440,22307,4851,955,3896,155137,96675,58462,0.4043,0.0107,30817,32899,37233,22013,33833,28602,26703,25713,21818,19440,48,187
"Clay County, Texas",10387,5195,5192,9874,64,119,60,0,65,205,6,199,10387,9771,616,0.4399,0.0201,27678,28073,28986,10747,14350,23013,,-666666666,5062,28683,48,077
"Hill County, Texas",35399,17603,17796,30666,2375,432,120,65,1142,599,74,525,35399,28152,7247,0.4549,0.0222,24745,26146,28736,14887,13510,11117,21883,21268,22284,13014,48,217
"Nacogdoches County, Texas",65558,31365,34193,49751,11677,587,1198,7,1000,1338,77,1261,65558,52993,12565,0.4865,0.0176,22580,24720,28210,12051,15793,9242,25010,,18273,8974,48,347
"Parmer County, Texas",9852,5059,4793,8228,107,76,25,24,926,466,261,205,9852,3651,6201,0.4022,0.0261,23686,24856,35424,17485,37661,11429,,,20423,10759,48,369
"Presidio County, Texas",7123,3497,3626,6743,0,80,180,0,120,0,0,0,7123,1167,5956,0.4587,0.0263,16066,16207,38976,12097,-666666666,2528,21773,-666666666,8585,-666666666,48,377
"Val Verde County, Texas",49027,24925,24102,45335,760,171,304,31,1905,521,91,430,49027,8941,40086,0.4591,0.0243,20881,21024,38450,17450,23636,12305,20713,,17051,20686,48,465
"Ector County, Texas",158342,80249,78093,127857,7254,703,1831,82,15760,4855,1113,3742,158342,63889,94453,0.4598,0.0148,28700,30071,38860,23149,21335,22807,55751,,21992,16134,48,135
"Glasscock County, Texas",1430,787,643,1009,0,0,0,0,421,0,0,0,1430,804,626,0.4606,0.0888,30902,39058,45641,11972,-666666666,-666666666,-666666666,-666666666,11353,-666666666,48,173
"Grimes County, Texas",27630,14892,12738,21641,4253,233,45,0,751,707,117,590,27630,21014,6616,0.4909,0.0423,23513,26981,31263,13603,11434,21973,,-666666666,9828,5967,48,185
"Collin County, Texas",944350,464248,480102,659642,89841,4404,136170,624,23528,30141,4882,25259,944350,800981,143369,0.4324,0.0043,43439,46387,50925,23943,33946,37266,43325,29494,23712,24319,48,085
"Angelina County, Texas",87607,42659,44948,69372,12962,599,1007,5,2421,1241,113,1128,87607,68433,19174,0.4495,0.0184,22322,23540,26613,13275,17179,13780,37567,,14697,14604,48,005
"Cottle County, Texas",1623,792,831,1185,243,5,0,0,140,50,0,50,1623,1241,382,0.4697,0.0638,20108,24089,27991,12285,13928,,-666666666,-666666666,3549,,48,101
"Hays County, Texas",204150,101636,102514,179579,8168,703,2892,96,7231,5481,1447,4034,204150,125816,78334,0.4547,0.0121,30715,31919,38442,20992,22929,30630,28700,,18739,20085,48,209
"Rockwall County, Texas",93642,46167,47475,80024,5685,224,2300,0,2535,2874,416,2458,93642,77436,16206,0.4030,0.0147,39295,41027,44476,22564,31225,28120,36769,-666666666,24069,23359,48,397
"Lipscomb County, Texas",3469,1840,1629,2953,18,69,34,0,251,144,35,109,3469,2418,1051,0.4322,0.0284,28491,29190,32550,21116,34650,19639,7968,-666666666,31810,16693,48,295
"Matagorda County, Texas",36743,18319,18424,26782,3595,141,710,53,4464,998,255,743,36743,21302,15441,0.4792,0.0223,24376,27116,33926,16932,17523,11407,12474,39902,18427,11604,48,321
"Pecos County, Texas",15797,9010,6787,13078,578,173,74,17,1747,130,41,89,15797,4960,10837,0.4354,0.0535,20688,21662,29418,18444,4121,17708,19953,,19517,19107,48,371
"Rusk County, Texas",53595,28379,25216,42148,9196,96,301,22,820,1012,123,889,53595,44740,8855,0.4458,0.0155,24842,27167,30451,12598,16120,10748,20123,,14025,19192,48,401
"Throckmorton County, Texas",1567,694,873,1527,16,0,0,0,0,24,0,24,1567,1332,235,0.4814,0.0571,28895,29345,31064,19894,,-666666666,-666666666,-666666666,-666666666,13883,48,447
"Walker County, Texas",71539,41642,29897,52337,16475,286,923,10,456,1052,89,963,71539,58752,12787,0.4809,0.0191,17789,19668,22923,8880,12606,16641,14156,,14884,10423,48,471
"Wood County, Texas",43815,21807,22008,39245,2378,321,133,37,1151,550,21,529,43815,39502,4313,0.4789,0.0372,27841,29260,30634,11457,13903,50510,40707,,9958,8653,48,499
"Aransas County, Texas",24763,12026,12737,22104,381,50,488,0,681,1059,60,999,24763,18007,6756,0.5351,0.0382,30939,31701,37445,14708,5847,22414,68223,-666666666,21937,13063,48,007
"Childress County, Texas",7226,4449,2777,6042,552,69,121,0,311,131,27,104,7226,4985,2241,0.4452,0.0434,20234,22377,27160,11655,7244,,10592,-666666666,12219,6306,48,075
"Coke County, Texas",3275,1606,1669,2928,20,44,6,0,241,36,4,32,3275,2577,698,0.3979,0.0233,24768,25279,26014,20181,,,,-666666666,18478,37850,48,081
"Coryell County, Texas",75389,37630,37759,54268,10601,618,1554,651,1442,6255,261,5994,75389,61758,13631,0.4155,0.0247,21507,23745,25745,14695,16995,25641,18972,24132,25516,8768,48,099
"Hemphill County, Texas",4061,1965,2096,3766,35,17,24,0,120,99,72,27,4061,2606,1455,0.4351,0.0467,26781,27465,34563,13024,15680,,,-666666666,13863,20695,48,211
"Moore County, Texas",21801,11438,10363,15913,873,189,1713,0,2372,741,201,540,21801,9828,11973,0.3876,0.0214,21650,23205,31523,16155,26149,22199,14868,-666666666,17684,11180,48,341
"Navarro County, Texas",48583,23845,24738,36424,6312,942,309,539,2852,1205,147,1058,48583,35570,13013,0.4567,0.0171,23422,25448,29522,12762,20526,11220,20553,21723,14018,10645,48,349
"San Augustine County, Texas",8327,4085,4242,6119,1760,165,13,0,138,132,0,132,8327,7744,583,0.5260,0.0527,23261,25174,25415,22698,18550,7500,,-666666666,10267,11014,48,405
"Shackelford County, Texas",3311,1770,1541,3181,6,10,7,0,24,83,0,83,3311,2926,385,0.4541,0.0476,23855,24159,25023,17420,,,,-666666666,27996,9747,48,417
"Starr County, Texas",63894,31073,32821,60751,37,40,83,0,2722,261,204,57,63894,595,63299,0.5136,0.0305,14122,14077,34669,13971,,47238,,-666666666,15273,10847,48,427
"Upton County, Texas",3634,1843,1791,1735,246,5,25,0,1612,11,0,11,3634,1797,1837,0.4476,0.0323,26183,35473,33576,19813,14744,,30936,-666666666,17005,,48,461
"Bastrop County, Texas",82577,42014,40563,58681,6498,408,736,0,14140,2114,847,1267,82577,52188,30389,0.4189,0.0179,26540,29957,33268,18498,21755,22158,17588,-666666666,16684,16268,48,021
"Hall County, Texas",3074,1546,1528,2489,250,20,9,0,218,88,2,86,3074,2017,1057,0.5354,0.0641,22846,25795,29771,14710,11674,15200,,-666666666,10860,4632,48,191
"Franklin County, Texas",10679,5362,5317,9184,414,22,5,8,676,370,109,261,10679,9164,1515,0.4290,0.0316,25602,27133,28148,14344,24806,,,,14637,9997,48,159
"Frio County, Texas",19394,11580,7814,14505,854,19,172,0,3510,334,63,271,19394,4115,15279,0.5051,0.0600,18288,20917,39702,14892,4520,,10381,-666666666,11557,14507,48,163
"Lampasas County, Texas",20640,10187,10453,18227,903,52,223,88,411,736,166,570,20640,16615,4025,0.4200,0.0184,28158,27929,29994,18051,52451,16042,30967,12580,18698,11155,48,281
"Mason County, Texas",4161,2146,2015,3632,1,90,92,0,86,260,18,242,4161,3183,978,0.4740,0.0433,25602,26415,28268,19411,,23258,,-666666666,26392,22144,48,319
"Dickens County, Texas",2216,1143,1073,2023,68,17,12,0,69,27,27,0,2216,1543,673,0.5054,0.0508,23452,24268,28598,13360,8613,,,-666666666,11894,,48,125
"Tarrant County, Texas",2019977,988765,1031212,1372149,327437,9980,107577,3639,134367,64828,10999,53829,2019977,1443735,576242,0.4611,0.0029,32092,36126,43670,18388,24372,30271,30747,18979,18078,17989,48,439
"Anderson County, Texas",57863,35412,22451,42549,12141,270,319,9,1674,901,107,794,57863,47721,10142,0.4225,0.0179,16868,19528,21921,10572,8251,11605,13364,,16275,11478,48,001
"Jackson County, Texas",14820,7226,7594,12770,983,0,134,8,627,298,157,141,14820,9947,4873,0.4161,0.0292,26329,27763,33066,16077,19403,-666666666,31983,,15243,8883,48,239
"Milam County, Texas",24664,12343,12321,20849,2429,35,134,0,513,704,8,696,24664,18205,6459,0.4364,0.0246,24015,25577,28757,16095,15469,31723,31367,-666666666,20935,7710,48,331
"Comanche County, Texas",13495,6738,6757,12741,170,63,74,0,297,150,23,127,13495,9766,3729,0.4356,0.0358,25127,25544,28510,17586,8192,9546,18524,-666666666,24138,20654,48,093
"Brooks County, Texas",7180,3724,3456,6461,49,64,0,0,435,171,35,136,7180,439,6741,0.4822,0.0379,13800,13663,15044,13806,,,-666666666,-666666666,20650,8636,48,047
"Cass County, Iowa",13191,6547,6644,12811,40,54,61,21,59,145,8,137,13191,12865,326,0.4255,0.0216,27853,28059,28194,22053,27530,33861,28813,,,8468,19,029
"Cherokee County, Iowa",11468,5796,5672,10871,269,51,78,0,7,192,3,189,11468,11321,147,0.4298,0.0222,32667,33502,33651,33008,14124,,,-666666666,,33257,19,035
"Crawford County, Iowa",17132,8547,8585,14699,438,93,337,28,1224,313,134,179,17132,12374,4758,0.4883,0.0714,28700,28408,33208,14830,75063,4254,25058,,24382,7607,19,047
"Des Moines County, Iowa",39600,19313,20287,35758,2351,58,318,0,96,1019,25,994,39600,38407,1193,0.4452,0.0192,28234,29984,30456,13679,12746,16052,21682,-666666666,14191,6618,19,057
"Fayette County, Iowa",19929,9998,9931,19017,405,9,131,0,60,307,54,253,19929,19467,462,0.4459,0.0226,28069,28834,29014,16172,8615,,27094,-666666666,18702,9304,19,065
"Harrison County, Iowa",14143,6989,7154,13771,31,63,40,16,23,199,5,194,14143,13910,233,0.4022,0.0143,30209,30440,30602,19532,23994,15494,43250,,41230,18156,19,085
"Kossuth County, Iowa",15075,7547,7528,14621,167,26,82,0,67,112,11,101,15075,14713,362,0.4098,0.0170,29963,30353,30577,18196,18117,5638,23028,-666666666,18210,14364,19,109
"Mills County, Iowa",14957,7516,7441,14444,130,135,40,0,84,124,0,124,14957,14509,448,0.4151,0.0208,32867,33456,33705,21121,13898,18308,17620,-666666666,14888,17093,19,129
"Monona County, Iowa",8796,4283,4513,8512,24,181,0,0,4,75,0,75,8796,8626,170,0.4618,0.0299,27862,28239,28483,15725,24967,12603,-666666666,-666666666,,24265,19,133
"Muscatine County, Iowa",42950,21476,21474,39263,1008,79,398,11,887,1304,125,1179,42950,35309,7641,0.4153,0.0201,28137,28849,31226,16224,28358,37111,22442,,20592,12939,19,139
"Osceola County, Iowa",6115,3091,3024,5784,77,13,11,5,137,88,31,57,6115,5636,479,0.4015,0.0235,28843,29441,30335,14230,27036,14877,,,15453,16182,19,143
"Polk County, Iowa",474274,233599,240675,399979,31076,1365,21508,423,6312,13611,940,12671,474274,435188,39086,0.4437,0.0069,34474,37203,38732,18032,18127,16655,26396,31548,18784,13527,19,153
"Webster County, Iowa",36757,18972,17785,33673,1739,125,486,6,172,556,25,531,36757,35014,1743,0.4431,0.0148,25243,25982,26641,12457,10652,12980,49502,,26725,6873,19,187
"Story County, Iowa",96922,50484,46438,83892,1828,217,7477,25,608,2875,167,2708,96922,93663,3259,0.4643,0.0118,28034,29546,29853,20944,18161,15495,20260,,33597,10289,19,169
"Woodbury County, Iowa",102398,50496,51902,88238,3578,1973,2962,267,2408,2972,450,2522,102398,85857,16541,0.4363,0.0126,27430,29214,31574,14925,15718,16989,22491,22325,18398,8183,19,193
"Black Hawk County, Iowa",133009,65309,67700,111684,12103,622,3081,398,2093,3028,201,2827,133009,127271,5738,0.4616,0.0122,29100,30821,31090,20127,16237,14626,43805,10576,21693,12571,19,013
"Grundy County, Iowa",12341,6108,6233,12131,69,14,44,0,0,83,3,80,12341,12186,155,0.4225,0.0208,35443,35691,35921,17955,,,20664,-666666666,-666666666,25466,19,075
"Jackson County, Iowa",19395,9712,9683,18776,99,7,80,131,30,272,0,272,19395,19119,276,0.4267,0.0153,29207,29845,29948,19671,18289,,8696,12363,,5458,19,097
"Jones County, Iowa",20568,10585,9983,19628,504,6,226,0,0,204,19,185,20568,20178,390,0.4308,0.0225,28879,29739,30041,11567,12282,,9170,-666666666,-666666666,9793,19,105
"Lee County, Iowa",34541,17371,17170,32362,883,82,206,0,179,829,52,777,34541,33309,1232,0.4250,0.0191,25968,26525,26799,23619,13082,28472,34780,-666666666,44599,11510,19,111
"Mitchell County, Iowa",10631,5282,5349,10387,9,69,53,0,13,100,30,70,10631,10485,146,0.4127,0.0288,28898,29217,29002,40632,,18933,33832,-666666666,,3693,19,131
"Warren County, Iowa",49361,24118,25243,47483,229,76,280,159,330,804,42,762,49361,48028,1333,0.4044,0.0147,34570,35122,35373,20582,19345,8143,39369,10124,27545,14847,19,181
"Sac County, Iowa",9868,4818,5050,9613,64,0,8,0,63,120,14,106,9868,9585,283,0.4152,0.0195,30750,31132,31660,9145,15302,-666666666,,-666666666,12514,16555,19,161
"Plymouth County, Iowa",25039,12288,12751,23729,178,112,134,16,569,301,9,292,25039,23795,1244,0.3995,0.0209,32028,32940,33450,15654,9066,29000,11351,11794,15169,16957,19,149
"Clay County, Iowa",16313,8051,8262,15558,108,5,89,3,178,372,5,367,16313,15746,567,0.4223,0.0209,27811,28331,28689,16199,28408,,,,22496,12894,19,041
"Clinton County, Iowa",47218,23126,24092,44275,1262,171,343,2,158,1007,48,959,47218,45775,1443,0.4241,0.0134,27942,28919,29369,11471,14451,34416,11212,,20433,7684,19,045
"Smith County, Kansas",3663,1809,1854,3539,8,19,9,0,0,88,2,86,3663,3587,76,0.4650,0.0264,28598,29259,29163,31053,,27542,,-666666666,-666666666,5863,20,183
"Grant County, Kansas",7616,3988,3628,6388,0,0,19,0,1085,124,71,53,7616,4018,3598,0.4092,0.0366,25788,27142,32176,18816,-666666666,-666666666,,-666666666,18434,21248,20,067
"Kingman County, Kansas",7470,3749,3721,7232,21,42,1,0,6,168,0,168,7470,7216,254,0.4398,0.0365,33203,33152,33845,14151,188043,,,-666666666,,21564,20,095
"Butler County, Kansas",66468,33539,32929,61941,1563,511,765,31,138,1519,140,1379,66468,63326,3142,0.4110,0.0137,28759,29309,29448,25607,10311,29839,44486,,17468,16876,20,015
"Nemaha County, Kansas",10104,5119,4985,9795,56,50,16,1,24,162,0,162,10104,9900,204,0.4369,0.0298,29687,30173,30374,16211,27225,14480,16938,,12663,9796,20,131
"Pottawatomie County, Kansas",23545,11746,11799,22232,164,336,230,0,127,456,21,435,23545,22307,1238,0.3944,0.0196,28070,28625,29333,15263,28057,13497,32446,-666666666,14854,13256,20,149
"Cherokee County, Kansas",20331,9998,10333,18379,125,499,87,72,60,1109,0,1109,20331,19819,512,0.4057,0.0178,21635,22067,22219,13728,19732,19051,,13508,16302,18296,20,021
"Lincoln County, Kansas",3097,1585,1512,3026,23,0,0,0,0,48,0,48,3097,2999,98,0.4166,0.0387,25851,26321,26768,12960,8409,-666666666,-666666666,-666666666,-666666666,,20,105
"Sumner County, Kansas",23208,11581,11627,21908,258,326,54,0,139,523,18,505,23208,21963,1245,0.4219,0.0142,26328,27076,27386,21106,8872,19120,,-666666666,27046,10199,20,191
"Trego County, Kansas",2858,1450,1408,2750,3,23,38,0,7,37,0,37,2858,2800,58,0.3655,0.0274,33555,32030,32528,5105,,,,-666666666,,,20,195
"Wilson County, Kansas",8780,4318,4462,8300,49,57,2,0,14,358,0,358,8780,8513,267,0.4692,0.0335,26523,27259,27556,12343,17904,21684,,-666666666,,12159,20,205
"Woodson County, Kansas",3170,1583,1587,2970,34,16,0,0,5,145,4,141,3170,3140,30,0.4356,0.0296,21123,22046,22084,15877,,8413,-666666666,-666666666,,9043,20,207
"Ness County, Kansas",2955,1493,1462,2830,21,6,10,0,79,9,2,7,2955,2655,300,0.4710,0.0424,31912,32506,34169,13041,32671,,,-666666666,13529,15489,20,135
"Osborne County, Kansas",3603,1807,1796,3465,14,14,10,0,24,76,8,68,3603,3529,74,0.4543,0.0360,28748,29146,29501,7985,,61879,,-666666666,,20162,20,141
"Bourbon County, Kansas",14702,7243,7459,13610,473,71,133,0,13,402,0,402,14702,14312,390,0.4628,0.0345,22822,23065,23431,8782,28582,25051,16754,-666666666,,9999,20,011
"Hamilton County, Kansas",2616,1353,1263,2336,96,0,0,0,128,56,8,48,2616,1679,937,0.3759,0.0380,20723,21304,25920,11766,21877,-666666666,-666666666,-666666666,15185,7161,20,075
"Kiowa County, Kansas",2526,1234,1292,2373,30,22,30,0,18,53,0,53,2526,2362,164,0.4042,0.0451,25623,26751,27585,11275,5807,5050,14383,-666666666,9111,6868,20,097
"Shawnee County, Kansas",178284,86327,91957,147172,14754,1570,2519,103,4358,7808,671,7137,178284,156548,21736,0.4436,0.0101,29979,32176,34020,16065,18520,23987,38935,,19711,14633,20,177
"Sherman County, Kansas",5966,3003,2963,5415,43,46,39,0,320,103,35,68,5966,5243,723,0.3563,0.0339,23687,25028,26177,11396,4386,,,-666666666,12305,3695,20,181
"Thomas County, Kansas",7824,3816,4008,7380,143,57,55,4,102,83,43,40,7824,7353,471,0.4449,0.0383,27127,28212,28867,11811,5343,11940,8462,,17177,4318,20,193
"Montgomery County, Kansas",32970,16410,16560,28011,1674,1068,346,41,325,1505,47,1458,32970,30835,2135,0.4420,0.0247,24103,25134,25793,13208,14907,19828,22465,,6673,22720,20,125
"Morris County, Kansas",5566,2753,2813,5345,6,6,37,0,16,156,3,153,5566,5303,263,0.4229,0.0255,27499,28196,28669,16454,,,11638,-666666666,,11149,20,127
"Rawlins County, Kansas",2509,1286,1223,2340,10,22,5,0,102,30,4,26,2509,2339,170,0.4132,0.0239,27840,27945,28356,14934,,92945,,-666666666,14388,16470,20,153
"Rooks County, Kansas",5118,2469,2649,4928,44,13,10,8,17,98,7,91,5118,4987,131,0.3985,0.0190,25072,25490,25774,19703,1448,3869,,,63971,13330,20,163
"Clark County, Kansas",2053,1037,1016,1929,12,25,16,0,5,66,0,66,2053,1881,172,0.3962,0.0319,27896,28184,29189,17545,,,19388,-666666666,,22724,20,025
"Ellsworth County, Kansas",6293,3654,2639,5622,287,56,37,0,132,159,21,138,6293,5913,380,0.4168,0.0276,25161,26054,26689,11270,18993,5889,19135,-666666666,15470,20970,20,053
"Harper County, Kansas",5673,2884,2789,5452,12,144,12,0,14,39,0,39,5673,5318,355,0.4356,0.0272,26105,26430,27401,12196,,22874,,-666666666,29357,4138,20,077
"Russell County, Kansas",6977,3452,3525,6635,107,7,0,46,12,170,21,149,6977,6760,217,0.3837,0.0385,26300,27152,27579,8671,14586,35243,-666666666,7467,,6788,20,167
"Lyon County, Kansas",33299,16260,17039,29806,768,209,712,0,418,1386,142,1244,33299,26301,6998,0.4750,0.0341,26322,27595,29253,20621,19780,12263,11852,-666666666,27816,11675,20,111
"Pawnee County, Kansas",6709,3769,2940,5989,350,60,4,0,158,148,0,148,6709,6185,524,0.3939,0.0323,22925,24586,25457,9493,9005,16000,,-666666666,9959,5461,20,145
"Allen County, Kansas",12630,6281,6349,11818,188,35,76,9,32,472,26,446,12630,12192,438,0.4337,0.0247,23454,24150,24448,15661,14453,24171,7276,,,12412,20,001
"Comanche County, Kansas",1780,912,868,1739,0,0,0,0,16,25,0,25,1780,1657,123,0.4109,0.0383,30171,30148,30045,31503,-666666666,-666666666,-666666666,-666666666,,31876,20,033
"Elk County, Kansas",2562,1258,1304,2399,6,46,18,0,4,89,0,89,2562,2451,111,0.4297,0.0355,22437,22820,20539,65094,,44078,,-666666666,,3719,20,049
"Gove County, Kansas",2619,1298,1321,2502,17,15,28,0,0,57,6,51,2619,2528,91,0.4226,0.0300,28247,28893,28996,21324,,,5300,-666666666,-666666666,20230,20,063
"Harvey County, Kansas",34555,17200,17355,32131,665,234,250,83,304,888,63,825,34555,30477,4078,0.4011,0.0173,27305,27969,29605,15235,13722,11647,28455,21516,29336,17105,20,079
"Hodgeman County, Kansas",1842,941,901,1776,0,5,35,0,4,22,0,22,1842,1684,158,0.4001,0.0308,28514,28997,30182,15689,-666666666,,23131,-666666666,,7423,20,083
"Kearny County, Kansas",3932,1934,1998,3595,69,19,13,0,178,58,2,56,3932,2700,1232,0.4557,0.0502,23593,24554,29148,12658,9500,,,-666666666,16434,11488,20,093
"Stafford County, Kansas",4214,2157,2057,4010,25,43,12,0,60,64,4,60,4214,3654,560,0.4240,0.0287,26922,27607,29491,13383,18492,19440,,-666666666,11467,11114,20,185
"McPherson County, Kansas",28630,14159,14471,27257,329,157,163,6,120,598,36,562,28630,27454,1176,0.4152,0.0166,30234,30540,31101,19648,16633,18964,31079,,50064,22814,20,113
"Osage County, Kansas",15882,7968,7914,15241,95,34,32,0,17,463,8,455,15882,15386,496,0.4120,0.0242,27026,27537,27854,15498,22105,20203,47169,-666666666,18153,10623,20,139
"Greeley County, Kansas",1200,581,619,1070,8,7,0,0,94,21,11,10,1200,924,276,0.3500,0.0376,23668,24953,26129,16037,,,-666666666,-666666666,12943,,20,071
"Coffey County, Kansas",8296,4195,4101,7927,51,65,23,0,16,214,12,202,8296,8077,219,0.4156,0.0193,32112,31698,31797,23915,33094,20749,9596,-666666666,70394,50203,20,031
"Crawford County, Kansas",39108,19527,19581,35719,866,182,787,0,302,1252,12,1240,39108,36962,2146,0.4652,0.0194,22461,23468,24083,11166,15045,21414,9066,-666666666,10144,10413,20,037
"Ellis County, Kansas",28878,14394,14484,26904,399,55,307,43,205,965,341,624,28878,27238,1640,0.4855,0.0387,29810,30887,31568,12502,14598,35162,22632,,15907,11768,20,051
"Greenwood County, Kansas",6156,3106,3050,5861,19,9,8,0,25,234,0,234,6156,5923,233,0.4660,0.0339,27639,28485,28937,13265,10242,31544,,-666666666,7024,10041,20,073
"Labette County, Kansas",20367,10070,10297,18099,856,212,62,0,92,1046,0,1046,20367,19459,908,0.4113,0.0190,23524,24798,25066,16276,13181,24874,,-666666666,16857,11251,20,099
"Linn County, Kansas",9635,4800,4835,9211,62,86,51,0,20,205,10,195,9635,9383,252,0.4509,0.0241,25771,26173,26440,14158,15939,10457,26496,-666666666,17525,17743,20,107
"Sedgwick County, Kansas",512064,253201,258863,400828,45888,5077,22209,226,16451,21385,1690,19695,512064,438537,73527,0.4554,0.0065,28673,31338,33598,15388,18859,20658,27970,26520,15871,12288,20,173
"Seward County, Kansas",22692,11601,11091,13044,1173,160,656,0,6951,708,488,220,22692,9065,13627,0.4103,0.0226,20352,23493,31930,14026,23402,15733,25693,-666666666,14663,9371,20,175
"Republic County, Kansas",4686,2271,2415,4576,16,17,30,0,0,47,0,47,4686,4599,87,0.4314,0.0380,28901,29320,29478,21146,,19882,,-666666666,-666666666,,20,157
"Graham County, Kansas",2545,1290,1255,2319,100,5,25,0,0,96,8,88,2545,2468,77,0.4176,0.0310,26685,27327,28079,2501,24821,,11768,-666666666,-666666666,17792,20,065
"Johnson County, Kansas",585502,286987,298515,505128,27360,1517,28749,245,5541,16962,1053,15909,585502,541446,44056,0.4522,0.0072,44986,47069,48924,21608,29774,40128,44020,23268,19450,18228,20,091
"Douglas County, Kansas",119319,59067,60252,98478,5047,2935,6229,27,1337,5266,452,4814,119319,111963,7356,0.4714,0.0143,30315,32470,32985,21780,20995,17806,23785,,30660,13705,20,045
"Sheridan County, Kansas",2506,1275,1231,2456,11,5,0,0,25,9,0,9,2506,2386,120,0.4180,0.0300,31526,31850,32413,17065,7627,,-666666666,-666666666,13980,12256,20,179
"Miami County, Kansas",33127,16384,16743,31621,459,278,159,0,146,464,0,464,33127,32096,1031,0.4164,0.0223,33349,34087,34611,14914,16580,22563,25176,-666666666,14460,14819,20,121
"Gray County, Kansas",6037,3025,3012,5856,51,30,7,34,4,55,0,55,6037,5087,950,0.3873,0.0325,28878,29081,30828,19305,,,,,,36336,20,069
"Wallace County, Kansas",1575,790,785,1491,4,6,0,0,32,42,12,30,1575,1492,83,0.4177,0.0431,28938,29721,29812,17902,,,-666666666,-666666666,,16829,20,199
"Stevens County, Kansas",5686,2882,2804,5034,37,15,11,0,343,246,138,108,5686,3637,2049,0.4340,0.0499,24359,25575,30347,13958,41043,,,-666666666,11457,15274,20,189
"Washington County, Kansas",5525,2844,2681,5329,16,6,0,0,41,133,8,125,5525,5336,189,0.4277,0.0363,27718,28157,28606,11984,,,-666666666,-666666666,16039,16619,20,201
"Chautauqua County, Kansas",3367,1757,1610,2934,20,208,0,0,0,205,0,205,3367,3331,36,0.4662,0.0363,24496,25564,25742,,,18060,-666666666,-666666666,-666666666,17120,20,019
"Morton County, Kansas",2838,1449,1389,2601,26,3,18,0,82,108,7,101,2838,2184,654,0.4175,0.0286,23370,23161,25756,17240,18369,,,-666666666,42561,13252,20,129
"Reno County, Kansas",63101,31775,31326,57847,1788,614,352,6,693,1801,149,1652,63101,57213,5888,0.4330,0.0160,26190,27101,28044,16080,14137,18716,46586,,18868,10310,20,155
"Cloud County, Kansas",9060,4523,4537,8639,161,12,3,0,85,160,0,160,9060,8771,289,0.4340,0.0428,26515,25951,26497,11108,73906,45725,,-666666666,27465,7748,20,029
"Scott County, Kansas",4949,2460,2489,4672,0,5,70,0,145,57,22,35,4949,4064,885,0.3426,0.0326,31132,30756,34229,18271,-666666666,,,-666666666,48751,45219,20,171
"Doniphan County, Kansas",7736,3960,3776,7122,427,70,7,0,10,100,0,100,7736,7521,215,0.4301,0.0244,25297,26616,26708,17790,9768,16420,5371,-666666666,30590,4729,20,043
"Haskell County, Kansas",4047,2006,2041,3632,0,22,10,1,306,76,0,76,4047,2828,1219,0.4437,0.0509,25417,26658,29860,16745,-666666666,10118,,,15979,8850,20,081
"Lane County, Kansas",1642,850,792,1590,1,29,0,5,15,2,0,2,1642,1545,97,0.4313,0.0428,28366,28863,29758,10736,,20555,-666666666,,,,20,101
"Neosho County, Kansas",16125,7923,8202,15270,198,49,65,6,87,450,0,450,16125,15314,811,0.4513,0.0338,23934,24535,24960,15953,16422,10204,3943,,21117,12076,20,133
"Brown County, Kansas",9664,4685,4979,8291,122,780,52,10,32,377,0,377,9664,9249,415,0.4271,0.0348,25306,26906,27234,13953,21004,15517,26333,,5584,13478,20,013
"Phillips County, Kansas",5408,2648,2760,5226,40,14,25,5,0,98,4,94,5408,5225,183,0.4020,0.0344,27140,27579,27981,14680,3325,10543,6072,,-666666666,21660,20,147
"Riley County, Kansas",75296,39909,35387,61926,4751,330,3752,172,1236,3129,295,2834,75296,69064,6232,0.4754,0.0166,26883,28478,29047,17451,25524,20532,19987,25615,9222,13374,20,161
"Decatur County, Kansas",2881,1419,1462,2817,4,26,4,0,7,23,1,22,2881,2800,81,0.4392,0.0431,30208,30514,30990,11860,,24542,,-666666666,,14917,20,039
"Jefferson County, Kansas",18888,9581,9307,18048,128,129,2,0,73,508,37,471,18888,18394,494,0.3655,0.0151,29258,29730,29898,19217,22611,21150,,-666666666,21144,17296,20,087
"Butler County, Kentucky",12745,6412,6333,12351,46,26,26,4,134,158,5,153,12745,12337,408,0.4487,0.0318,22597,22867,23219,6052,11485,,,,,19054,21,031
"Edmonson County, Kentucky",12122,6093,6029,11584,185,34,11,0,1,307,22,285,12122,12028,94,0.4268,0.0287,21459,21759,21799,12019,10803,48197,,-666666666,,12870,21,061
"Harrison County, Kentucky",18668,9146,9522,17812,361,0,0,3,120,372,11,361,18668,18223,445,0.4305,0.0281,23851,24164,24461,11599,19416,-666666666,-666666666,,15397,16045,21,097
"Bracken County, Kentucky",8306,4183,4123,8038,3,14,46,0,95,110,0,110,8306,8158,148,0.4433,0.0287,23480,24054,24107,9391,,,,-666666666,,,21,023
"Lyon County, Kentucky",8186,4496,3690,7635,369,29,9,4,19,121,16,105,8186,7946,240,0.4459,0.0340,26621,28031,28467,10584,6517,15859,,,1295,4764,21,143
"Elliott County, Kentucky",7517,4285,3232,7233,252,6,0,0,11,15,0,15,7517,7495,22,0.4495,0.0329,14461,15017,15018,,335,,-666666666,-666666666,,,21,063
"Jefferson County, Kentucky",767154,370844,396310,551540,164685,1436,21319,376,7381,20417,1337,19080,767154,727037,40117,0.4770,0.0046,31980,36350,37250,20351,20227,24215,31939,29881,18361,14290,21,111
"Larue County, Kentucky",14156,7027,7129,13144,507,9,64,0,271,161,10,151,14156,13697,459,0.4218,0.0308,21939,22594,22700,10940,17537,,7252,-666666666,7581,13028,21,123
"Mason County, Kentucky",17153,8485,8668,15553,934,6,149,6,59,446,10,436,17153,16838,315,0.5079,0.0350,25658,26724,26767,22477,17420,,30505,,12419,6463,21,161
"Mercer County, Kentucky",21516,10597,10919,20002,848,45,174,10,137,300,14,286,21516,20882,634,0.4312,0.0225,25745,26641,27154,5599,15775,,24602,,9501,4906,21,167
"Robertson County, Kentucky",2143,1147,996,2123,16,0,0,0,0,4,0,4,2143,2130,13,0.4812,0.0472,23467,23386,23354,,,-666666666,-666666666,-666666666,-666666666,,21,201
"Russell County, Kentucky",17760,8688,9072,16798,136,24,91,0,524,187,0,187,17760,17103,657,0.4376,0.0197,19149,19462,19544,9467,17965,,41542,-666666666,9681,8840,21,207
"Washington County, Kentucky",12019,5865,6154,10732,624,0,103,0,256,304,65,239,12019,11480,539,0.4261,0.0195,24570,25839,26062,9349,18249,-666666666,31739,-666666666,6838,5252,21,229
"Ballard County, Kentucky",8090,3992,4098,7549,336,41,32,0,9,123,30,93,8090,7987,103,0.4617,0.0350,25571,26530,26607,7010,15120,3412,6816,-666666666,,8870,21,007
"Barren County, Kentucky",43680,21165,22515,40451,1643,50,141,0,235,1160,150,1010,43680,42318,1362,0.4345,0.0203,20832,21282,21468,13838,18156,,,-666666666,16549,9332,21,009
"Green County, Kentucky",11023,5393,5630,10467,143,310,9,0,0,94,5,89,11023,10971,52,0.5065,0.0611,24098,24899,25001,,15503,7028,,-666666666,-666666666,6038,21,087
"Hancock County, Kentucky",8719,4494,4225,8408,122,12,64,0,0,113,20,93,8719,8589,130,0.3713,0.0160,23523,23797,23966,4817,23077,,,-666666666,-666666666,8091,21,091
"Martin County, Kentucky",11919,6583,5336,11142,636,21,0,10,9,101,9,92,11919,11721,198,0.4491,0.0328,15492,16144,16225,8543,5854,,-666666666,,,7904,21,159
"Hardin County, Kentucky",108095,53723,54372,86022,12403,326,2281,380,1361,5322,140,5182,108095,101941,6154,0.4393,0.0136,27666,28474,28598,21444,27634,23437,37120,18730,17740,14066,21,093
"McLean County, Kentucky",9331,4602,4729,9104,47,18,20,0,11,131,0,131,9331,9203,128,0.4201,0.0242,24557,25016,25234,7509,12762,,8275,-666666666,,3385,21,149
"Ohio County, Kentucky",24071,11960,12111,23422,225,8,67,0,118,231,0,231,24071,23255,816,0.4957,0.0710,24231,24593,25064,9897,14229,,6064,-666666666,13565,8330,21,183
"Powell County, Kentucky",12321,6048,6273,11923,29,53,71,6,17,222,0,222,12321,12124,197,0.4515,0.0397,20397,20249,20383,5378,,18713,,,,32787,21,197
"Webster County, Kentucky",13155,6457,6698,11960,542,9,4,8,294,338,72,266,13155,12436,719,0.4602,0.0311,21880,22608,22913,11020,19612,,,,12322,7494,21,233
"Caldwell County, Kentucky",12727,6168,6559,11743,840,0,0,0,0,144,0,144,12727,12506,221,0.5086,0.0491,28500,29315,29687,11871,17418,-666666666,-666666666,-666666666,-666666666,26712,21,033
"Casey County, Kentucky",15796,7738,8058,15369,112,44,35,0,25,211,29,182,15796,15337,459,0.4523,0.0231,18285,18497,18717,10093,11705,,20657,-666666666,,6974,21,045
"Christian County, Kentucky",72263,38411,33852,51543,15316,467,1123,314,813,2687,218,2469,72263,66663,5600,0.4557,0.0208,21770,23358,23803,17042,17097,13152,55913,9935,14816,8662,21,047
"Grayson County, Kentucky",26178,13073,13105,25076,273,106,61,0,312,350,82,268,26178,25804,374,0.4470,0.0211,20721,20428,20450,37571,45377,9140,,-666666666,38642,9949,21,085
"Henry County, Kentucky",15814,7813,8001,14758,456,38,115,18,199,230,7,223,15814,15303,511,0.4308,0.0353,24519,25111,25533,5347,14934,20516,28724,,9418,19065,21,103
"Hopkins County, Kentucky",45664,22219,23445,41081,2907,163,290,4,203,1016,95,921,45664,44732,932,0.4491,0.0143,24190,24679,24762,17690,23263,26528,32060,,22346,4820,21,107
"Jackson County, Kentucky",13373,6655,6718,13316,13,2,0,0,0,42,0,42,13373,13360,13,0.4579,0.0282,17692,17701,17683,,,,-666666666,-666666666,-666666666,10402,21,109
"Laurel County, Kentucky",60180,29412,30768,58374,560,228,113,0,44,861,201,660,60180,59254,926,0.4690,0.0199,21039,21340,21322,18798,10561,7614,19242,-666666666,19907,11284,21,125
"Marshall County, Kentucky",31166,15341,15825,30450,197,58,104,0,24,333,88,245,31166,30678,488,0.4372,0.0251,27994,28208,28329,16778,37649,14943,17032,-666666666,56171,6382,21,157
"Meade County, Kentucky",28326,14352,13974,25978,970,216,217,0,190,755,43,712,28326,27258,1068,0.4140,0.0329,28078,28575,28716,19619,31734,22956,13192,-666666666,19014,14295,21,163
"Montgomery County, Kentucky",27759,13541,14218,26310,816,85,15,21,142,370,1,369,27759,27007,752,0.4390,0.0294,21877,22310,22600,8132,17347,,,,11570,7218,21,173
"Nicholas County, Kentucky",7100,3369,3731,6854,90,20,0,0,48,88,8,80,7100,6979,121,0.4552,0.0412,22472,22977,21849,80593,12396,,-666666666,-666666666,,,21,181
"Oldham County, Kentucky",65374,34328,31046,59622,2433,136,975,17,559,1632,51,1581,65374,62810,2564,0.4321,0.0148,40779,41384,42013,22823,28103,24012,59427,,24051,34017,21,185
"Owen County, Kentucky",10741,5304,5437,10316,174,25,0,17,155,54,0,54,10741,10450,291,0.4660,0.0359,23045,23683,23926,7463,8309,,-666666666,,,,21,187
"Rockcastle County, Kentucky",16827,8170,8657,16504,25,186,0,0,4,108,21,87,16827,16679,148,0.4525,0.0167,19913,20098,20156,10959,6860,12611,-666666666,-666666666,,6933,21,203
"Scott County, Kentucky",53517,26516,27001,47156,2569,133,559,0,1446,1654,191,1463,53517,51176,2341,0.4154,0.0142,31505,32916,33018,15598,26267,33750,25376,-666666666,12494,17908,21,209
"Warren County, Kentucky",126427,61873,64554,103136,11418,394,4820,354,2759,3546,524,3022,126427,119760,6667,0.4769,0.0154,27322,29652,30062,15076,19692,9188,18956,9248,13270,10245,21,227
"Allen County, Kentucky",20794,10339,10455,19821,311,0,85,0,265,312,135,177,20794,20366,428,0.4379,0.0355,21262,21446,21431,8952,36025,-666666666,12191,-666666666,11057,6024,21,003
"Bourbon County, Kentucky",20144,9670,10474,18216,1435,0,89,0,290,114,0,114,20144,18762,1382,0.4526,0.0277,27477,28641,29654,12424,17872,-666666666,12852,-666666666,11207,15321,21,017
"Boyd County, Kentucky",48091,23958,24133,45435,1234,47,133,15,124,1103,38,1065,48091,47241,850,0.4855,0.0209,25467,25607,25589,20689,17173,3845,63094,,,28021,21,019
"Bullitt County, Kentucky",79466,39627,39839,76302,615,139,517,80,420,1393,26,1367,79466,77987,1479,0.3863,0.0124,27423,27606,27762,15115,31601,32351,30203,,11865,19516,21,029
"Crittenden County, Kentucky",9083,4593,4490,8772,109,29,0,0,79,94,0,94,9083,8979,104,0.4595,0.0369,24011,24282,24318,16386,18250,,-666666666,-666666666,14815,19182,21,055
"Fayette County, Kentucky",318734,156453,162281,240264,45876,810,11602,168,8555,11459,1255,10204,318734,295880,22854,0.4947,0.0075,32965,37380,38367,16985,18532,15220,33476,21717,12716,14181,21,067
"Fulton County, Kentucky",6210,3102,3108,4483,1550,22,7,0,32,116,14,102,6210,6093,117,0.4807,0.0293,19043,20353,20655,6510,16269,18591,,-666666666,,6009,21,075
"Johnson County, Kentucky",22843,11200,11643,22236,112,20,353,0,25,97,36,61,22843,22754,89,0.4966,0.0360,21089,21172,21172,28271,11504,,21512,-666666666,,5797,21,115
"Menifee County, Kentucky",6405,3421,2984,6369,4,0,8,0,0,24,0,24,6405,6405,0,0.4163,0.0253,19825,19853,19853,-666666666,,-666666666,,-666666666,-666666666,,21,165
"Clay County, Kentucky",20621,10827,9794,19309,696,70,0,30,160,356,63,293,20621,20062,559,0.4947,0.0305,15063,15287,15415,7294,12912,22560,-666666666,,5153,11383,21,051
"Morgan County, Kentucky",13285,7425,5860,12445,443,14,158,36,29,160,0,160,13285,13159,126,0.4619,0.0343,17307,17970,17971,,,,18759,,,8317,21,175
"Perry County, Kentucky",26917,13273,13644,25840,306,29,323,69,74,276,34,242,26917,26646,271,0.5073,0.0294,20140,20362,20401,9346,24720,,5994,26855,,8603,21,193
"Wolfe County, Kentucky",7223,3596,3627,7138,8,30,3,0,3,41,0,41,7223,7200,23,0.4718,0.0302,14113,14223,14193,,,,,-666666666,,3659,21,237
"Bell County, Kentucky",27188,13325,13863,25920,783,41,32,0,31,381,7,374,27188,26909,279,0.4975,0.0315,15279,15563,15679,5108,8512,11895,,-666666666,,9617,21,013
"Breathitt County, Kentucky",13116,6577,6539,12779,146,24,28,0,50,89,0,89,13116,12976,140,0.5253,0.0264,17729,17745,17867,,3948,,,-666666666,,20930,21,025
"Graves County, Kentucky",37294,18348,18946,33724,1633,44,168,101,608,1016,121,895,37294,34892,2402,0.4691,0.0279,23189,24736,25047,12335,10612,21055,10395,9463,6616,5559,21,083
"Hart County, Kentucky",18627,9166,9461,17386,776,102,92,0,12,259,0,259,18627,18284,343,0.4621,0.0326,20421,19838,19919,15514,36011,28044,37193,-666666666,,4842,21,099
"Wayne County, Kentucky",20609,10154,10455,19533,471,0,67,0,196,342,0,342,20609,20126,483,0.4693,0.0350,19130,19480,19703,4614,16983,-666666666,22475,-666666666,,9668,21,231
"Marion County, Kentucky",19232,9751,9481,17218,1423,26,45,68,166,286,25,261,19232,18713,519,0.4454,0.0270,21659,22350,22599,12364,16680,6227,15340,,16611,7054,21,155
"Trigg County, Kentucky",14344,7077,7267,12960,1253,0,51,0,0,80,0,80,14344,14041,303,0.4175,0.0350,26893,27913,28167,17035,17817,-666666666,21755,-666666666,-666666666,7074,21,221
"Boone County, Kentucky",129095,64061,65034,117202,3941,130,2911,0,1717,3194,21,3173,129095,123756,5339,0.4115,0.0120,34433,35071,35494,19675,27373,126451,50122,-666666666,10021,14804,21,015
"Leslie County, Kentucky",10472,5067,5405,10229,6,0,44,0,72,121,0,121,10472,10399,73,0.4809,0.0390,15691,15384,15384,,,-666666666,124818,-666666666,,11990,21,131
"Knox County, Kentucky",31467,15330,16137,30444,392,261,124,0,9,237,0,237,31467,31100,367,0.5115,0.0333,17498,17842,17853,14402,12282,6822,4255,-666666666,,1316,21,121
"Lawrence County, Kentucky",15783,7898,7885,15389,87,5,67,0,15,220,18,202,15783,15614,169,0.5010,0.0323,18199,18385,18371,17066,8089,,,-666666666,,10635,21,127
"Livingston County, Kentucky",9263,4626,4637,9020,64,11,13,1,4,150,4,146,9263,9098,165,0.4905,0.0680,27338,27822,28220,6547,,,,,,,21,139
"Pike County, Kentucky",60483,29507,30976,58969,540,105,322,0,104,443,69,374,60483,59930,553,0.5090,0.0189,21646,21737,21619,27535,12007,2362,36669,-666666666,7445,18393,21,195
"Shelby County, Kentucky",46786,22613,24173,40987,2949,0,416,37,951,1446,79,1367,46786,42318,4468,0.4588,0.0165,30932,32399,34213,14036,24570,-666666666,37198,,16885,10219,21,211
"Anderson County, Kentucky",22214,10873,11341,21159,566,0,71,18,59,341,21,320,22214,21831,383,0.4073,0.0245,26339,26945,26973,23788,12631,-666666666,,,,14683,21,005
"Breckinridge County, Kentucky",20080,10088,9992,19164,369,36,71,0,96,344,0,344,20080,19791,289,0.4250,0.0191,22521,22852,22933,13335,17167,,36013,-666666666,10145,10465,21,027
"Franklin County, Kentucky",50296,24390,25906,41527,4779,81,920,20,997,1972,227,1745,50296,48678,1618,0.3896,0.0116,28801,30795,30917,17423,21794,33077,27800,,16974,9585,21,073
"Kenton County, Kentucky",164688,81430,83258,148317,7422,239,2034,29,2570,4077,151,3926,164688,159529,5159,0.4485,0.0105,31811,33443,33576,15840,17831,31124,31758,,8567,12794,21,117
"Madison County, Kentucky",89700,43737,45963,81957,3835,330,898,7,584,2089,207,1882,89700,87562,2138,0.4587,0.0155,24553,25188,25358,16150,17995,19955,33294,,17861,10615,21,151
"Magoffin County, Kentucky",12666,6348,6318,12657,5,4,0,0,0,0,0,0,12666,12620,46,0.4943,0.0437,18233,18242,18255,14715,,,-666666666,-666666666,-666666666,-666666666,21,153
"Owsley County, Kentucky",4463,1947,2516,4382,62,4,3,0,8,4,0,4,4463,4447,16,0.5419,0.0572,17766,17944,18007,,,,,-666666666,,,21,189
"Simpson County, Kentucky",18063,8926,9137,15469,1781,109,143,0,245,316,117,199,18063,17637,426,0.4316,0.0224,23991,25445,25495,8851,17917,12398,9532,-666666666,6926,10820,21,213
"Taylor County, Kentucky",25500,12525,12975,23200,999,0,273,0,85,943,18,925,25500,24893,607,0.4751,0.0324,20966,21678,21666,13051,14565,-666666666,42963,-666666666,2940,5484,21,217
"Todd County, Kentucky",12350,6049,6301,10848,986,4,0,0,293,219,0,219,12350,11872,478,0.4927,0.0660,23188,24460,24762,14619,14524,,-666666666,-666666666,14804,10630,21,219
"Carlisle County, Kentucky",4841,2344,2497,4615,65,70,27,0,24,40,0,40,4841,4736,105,0.4914,0.0524,24943,25812,25882,16091,9305,,,-666666666,,12970,21,039
"Clinton County, Kentucky",10211,5084,5127,9971,43,0,19,0,83,95,61,34,10211,9922,289,0.5176,0.0426,20235,20507,20718,6712,384,-666666666,,-666666666,12552,4353,21,053
"Gallatin County, Kentucky",8703,4473,4230,8134,158,0,6,0,244,161,15,146,8703,8236,467,0.3958,0.0230,23043,23629,24057,11076,15497,-666666666,,-666666666,14118,12057,21,077
"Garrard County, Kentucky",17328,8475,8853,16656,192,70,24,0,45,341,18,323,17328,16938,390,0.4325,0.0270,25751,26047,26393,9893,27929,42654,,-666666666,,8387,21,079
"Fleming County, Kentucky",14479,7146,7333,13930,235,9,26,0,118,161,44,117,14479,14293,186,0.4652,0.0305,23482,23549,23537,22039,29719,,,-666666666,26007,10404,21,069
"Campbell County, Kentucky",92267,45124,47143,86527,2951,68,938,20,500,1263,33,1230,92267,90415,1852,0.4587,0.0134,32225,33279,33474,18387,14389,27069,27094,,13317,13822,21,037
"Vermilion Parish, Louisiana",59867,29121,30746,48733,8841,265,1264,0,210,554,22,532,59867,57807,2060,0.4433,0.0155,24546,27221,27582,17681,12739,12854,14292,-666666666,16411,9652,22,113
"St. Charles Parish, Louisiana",52724,26121,26603,36775,13967,201,558,0,677,546,124,422,52724,49562,3162,0.4316,0.0159,31567,35725,36094,29373,21924,15437,19099,-666666666,29836,18996,22,089
"Concordia Parish, Louisiana",20021,10210,9811,11579,8230,15,36,26,110,25,0,25,20021,19741,280,0.5174,0.0375,19172,25597,25530,25905,10262,,,,17868,,22,029
"Tensas Parish, Louisiana",4666,2296,2370,2093,2543,0,4,0,9,17,0,17,4666,4545,121,0.4785,0.0295,14569,19654,20445,6129,10506,-666666666,,-666666666,,,22,107
"St. James Parish, Louisiana",21357,10266,11091,10345,10622,22,24,26,123,195,133,62,21357,21014,343,0.4477,0.0191,25830,31171,31371,12254,21161,,,,6685,5088,22,093
"Grant Parish, Louisiana",22348,12658,9690,17551,3733,73,46,0,434,511,259,252,22348,21232,1116,0.4357,0.0219,18082,21082,21384,6892,7687,,4876,-666666666,6146,4866,22,043
"Jefferson Parish, Louisiana",435300,211175,224125,273395,116621,1694,18131,39,15996,9424,1685,7739,435300,372778,62522,0.4698,0.0066,29776,35148,37633,20263,19568,29075,29889,23574,18133,19948,22,051
"Bienville Parish, Louisiana",13668,6523,7145,7449,5884,6,19,0,153,157,2,155,13668,13642,26,0.5024,0.0310,20866,26792,26805,13250,14257,,6495,-666666666,,5940,22,013
"Bossier Parish, Louisiana",126131,62349,63782,90948,28131,641,2100,246,1239,2826,483,2343,126131,117869,8262,0.4399,0.0130,27924,31249,32276,18042,18846,23261,23147,22525,18265,20594,22,015
"Cameron Parish, Louisiana",6868,3357,3511,6408,290,34,27,0,88,21,21,0,6868,6465,403,0.4234,0.0426,29000,29957,31100,7420,12933,,,-666666666,,,22,023
"East Feliciana Parish, Louisiana",19499,10715,8784,10562,8588,93,51,0,66,139,4,135,19499,19186,313,0.4508,0.0275,20927,27892,28263,16208,12585,3041,,-666666666,,29340,22,037
"St. John the Baptist Parish, Louisiana",43446,21308,22138,17206,24192,0,463,0,595,990,298,692,43446,40892,2554,0.4534,0.0259,25942,32010,33217,19983,21450,-666666666,24725,-666666666,10417,40166,22,095
"Plaquemines Parish, Louisiana",23373,11617,11756,15871,4786,308,850,8,610,940,35,905,23373,21721,1652,0.4699,0.0283,26818,30860,31262,18705,19279,30131,24422,,11930,7714,22,075
"Ouachita Parish, Louisiana",156075,74853,81222,93224,58507,271,1643,45,635,1750,317,1433,156075,152646,3429,0.5067,0.0119,23663,29925,30244,17902,13842,24986,31049,,25475,10647,22,073
"Rapides Parish, Louisiana",131546,63681,67865,83774,41846,865,1801,16,642,2602,244,2358,131546,127483,4063,0.4761,0.0101,24478,28318,28743,16591,16984,18687,30449,,16448,20372,22,079
"Washington Parish, Louisiana",46457,22963,23494,31134,13987,139,69,6,322,800,16,784,46457,45435,1022,0.4773,0.0224,18971,21883,22156,9735,13020,22047,26352,,9626,12211,22,117
"St. Landry Parish, Louisiana",83449,40151,43298,46910,34320,138,210,0,485,1386,74,1312,83449,81687,1762,0.5146,0.0169,19647,25010,25360,13961,13081,25720,2384,-666666666,12361,5312,22,097
"Tangipahoa Parish, Louisiana",130504,63237,67267,87582,38593,348,985,12,459,2525,155,2370,130504,125021,5483,0.4627,0.0117,24004,28478,29184,17217,14901,26759,14075,,23784,11359,22,105
"Acadia Parish, Louisiana",62568,30491,32077,49471,11139,20,42,10,544,1342,47,1295,62568,61008,1560,0.4787,0.0155,22784,25559,25829,13459,12642,21460,,,12945,9491,22,001
"St. Mary Parish, Louisiana",51734,25607,26127,31169,16158,646,753,11,995,2002,86,1916,51734,48151,3583,0.4598,0.0135,22364,26072,27001,16049,16664,24413,14320,,24887,11845,22,101
"West Carroll Parish, Louisiana",11180,5704,5476,8992,1800,39,0,10,231,108,0,108,11180,10786,394,0.5079,0.0435,22922,26044,24800,44691,9619,9841,-666666666,,5873,28031,22,123
"St. Tammany Parish, Louisiana",252093,122347,129746,209123,29803,1434,4093,94,2562,4984,662,4322,252093,238236,13857,0.4642,0.0091,34201,36643,37396,20671,22027,17564,38233,2595,18304,14745,22,103
"Union Parish, Louisiana",22475,11132,11343,16026,5594,14,19,39,418,365,43,322,22475,21428,1047,0.4849,0.0295,22979,27604,28209,9997,11735,,,,9320,5918,22,111
"Caldwell Parish, Louisiana",9996,5277,4719,8211,1671,50,12,0,19,33,0,33,9996,9679,317,0.5328,0.0467,20574,22950,23406,11113,9505,8308,,-666666666,,,22,021
"Lafayette Parish, Louisiana",240091,117169,122922,167347,62139,407,4392,0,1507,4299,312,3987,240091,229053,11038,0.4883,0.0098,30988,36629,37652,18597,17407,44552,27087,-666666666,15848,15711,22,055
"Caddo Parish, Louisiana",248361,117828,130533,115209,121444,1050,3110,81,2445,5022,857,4165,248361,241405,6956,0.5192,0.0120,25902,36222,36527,23250,16578,25154,34281,22189,18547,13238,22,017
"East Carroll Parish, Louisiana",7225,4373,2852,2105,5051,0,0,0,8,61,3,58,7225,7198,27,0.6647,0.1267,17698,36342,36621,,10075,-666666666,-666666666,-666666666,,,22,035
"Ascension Parish, Louisiana",121176,59998,61178,88396,26398,57,1281,40,1506,3498,89,3409,121176,114573,6603,0.4212,0.0132,32961,37126,38055,20993,22567,24444,27750,,20184,14097,22,005
"Iberia Parish, Louisiana",72691,35508,37183,44409,23053,71,1952,0,1207,1999,36,1963,72691,69640,3051,0.4588,0.0174,23156,27886,28210,17864,14510,38461,32824,-666666666,18689,10494,22,045
"St. Bernard Parish, Louisiana",45694,22402,23292,31838,10445,172,1076,37,862,1264,192,1072,45694,41119,4575,0.4376,0.0125,21217,23929,24441,17781,15155,19231,14608,5365,15784,13047,22,087
"St. Helena Parish, Louisiana",10411,5039,5372,4583,5626,108,43,0,35,16,0,16,10411,10375,36,0.5066,0.0684,23224,34819,34822,,13986,,29047,-666666666,,,22,091
"West Baton Rouge Parish, Louisiana",25860,12863,12997,15008,10320,33,41,0,188,270,0,270,25860,25074,786,0.4356,0.0287,28482,34243,34035,29997,20255,,,-666666666,18813,19604,22,121
"De Soto Parish, Louisiana",27216,13172,14044,16367,9728,302,46,16,171,586,125,461,27216,26439,777,0.4960,0.0176,24796,31188,31391,22790,15384,9575,45578,,24997,7524,22,031
"Red River Parish, Louisiana",8618,4067,4551,4938,3364,0,2,12,70,232,41,191,8618,8432,186,0.5457,0.0551,22626,30988,30996,9309,11998,-666666666,,,,3337,22,081
"Livingston Parish, Louisiana",138111,67836,70275,125734,8323,333,637,17,846,2221,24,2197,138111,133163,4948,0.4258,0.0158,28995,30057,30360,18992,18810,38729,27952,,10389,12965,22,063
"Natchitoches Parish, Louisiana",38963,18622,20341,20896,15775,415,268,0,885,724,53,671,38963,38087,876,0.5486,0.0218,18570,23405,23624,14744,12902,19042,13787,-666666666,11891,12196,22,069
"Orleans Parish, Louisiana",389648,185377,204271,132423,232789,632,11294,98,5297,7115,741,6374,389648,368245,21403,0.5706,0.0057,30177,52053,54249,27213,18032,27346,32990,17971,20469,23598,22,071
"Catahoula Parish, Louisiana",9893,5214,4679,6564,3210,19,10,0,68,22,8,14,9893,9730,163,0.4745,0.0242,21962,27237,27296,6252,11669,,,-666666666,,,22,025
"Calcasieu Parish, Louisiana",200182,97603,102579,140575,49884,687,2741,6,1747,4542,282,4260,200182,193419,6763,0.4663,0.0106,27368,31212,31497,20161,18424,27762,25836,,13775,12760,22,019
"Franklin Parish, Louisiana",20322,9981,10341,13322,6713,10,18,5,9,245,46,199,20322,20216,106,0.4891,0.0229,19785,24659,24812,1082,10700,,,,,3984,22,041
"Assumption Parish, Louisiana",22714,11005,11709,15439,6807,83,39,0,92,254,56,198,22714,22055,659,0.5025,0.0340,26238,31128,31540,18899,15048,12971,,-666666666,16805,36285,22,007
"Jackson Parish, Louisiana",15926,8080,7846,10901,4771,12,87,0,106,49,8,41,15926,15669,257,0.4806,0.0204,20942,24345,24608,12722,13244,13117,6460,-666666666,,,22,049
"Richland Parish, Louisiana",20474,9952,10522,12652,7286,0,153,0,110,273,49,224,20474,20035,439,0.4893,0.0194,20128,23730,23955,22411,13064,-666666666,34481,-666666666,14385,35988,22,083
"St. Martin Parish, Louisiana",53752,26452,27300,35555,15737,287,534,0,573,1066,33,1033,53752,52173,1579,0.4643,0.0215,24732,29258,29690,17064,16154,16260,8825,-666666666,23258,11459,22,099
"Winn Parish, Louisiana",14494,7733,6761,9618,4583,26,0,0,95,172,0,172,14494,14202,292,0.4845,0.0258,20162,25502,25622,16795,8946,4765,-666666666,-666666666,13185,26637,22,127
"East Baton Rouge Parish, Louisiana",444094,212778,231316,210236,204036,857,13946,117,6564,8338,263,8075,444094,426182,17912,0.5020,0.0085,31073,42467,43020,25553,20385,31174,29938,13580,16085,19273,22,033
"Allen Parish, Louisiana",25661,14638,11023,18903,4878,540,167,0,420,753,113,640,25661,24158,1503,0.4686,0.0285,20203,24036,24703,3949,10106,12005,12093,-666666666,2400,6998,22,003
"Madison Parish, Louisiana",11472,5708,5764,4074,7301,8,0,0,57,32,0,32,11472,11235,237,0.5051,0.0210,15795,23930,24443,14787,11135,,-666666666,-666666666,23146,,22,065
"Oxford County, Maine",57325,28316,29009,55192,256,172,273,4,96,1332,17,1315,57325,56575,750,0.4152,0.0095,23770,24159,24171,20916,12136,21566,14855,,15072,12333,23,017
"Waldo County, Maine",39418,19347,20071,38039,231,182,195,0,88,683,10,673,39418,38890,528,0.4431,0.0200,28860,29174,29231,32320,12452,18272,12625,-666666666,90986,16411,23,027
"Penobscot County, Maine",151748,75196,76552,143791,1370,1731,1581,63,341,2871,136,2735,151748,149742,2006,0.4540,0.0108,27289,27637,27528,28844,16673,16522,45136,18457,13465,13412,23,019
"Androscoggin County, Maine",107444,52514,54930,98333,2260,249,812,4,224,5562,301,5261,107444,105464,1980,0.4252,0.0125,27231,28620,28715,15985,9442,10844,16561,,21105,12423,23,001
"Aroostook County, Maine",68269,33745,34524,64865,665,1249,293,10,124,1063,66,997,68269,67468,801,0.4598,0.0102,24571,24843,24854,23530,28883,11400,43112,11970,36241,14364,23,003
"Cumberland County, Maine",290944,141276,149668,267511,8481,547,6145,16,1033,7211,350,6861,290944,284985,5959,0.4543,0.0081,38644,40210,40437,23421,13283,33196,28773,,26000,21026,23,005
"Knox County, Maine",39823,19701,20122,38386,232,136,215,0,16,838,41,797,39823,39231,592,0.4340,0.0211,31612,31995,32172,16837,31445,50890,21959,-666666666,8963,13871,23,013
"York County, Maine",203102,99029,104073,194369,1823,845,2606,31,341,3087,39,3048,203102,199724,3378,0.4328,0.0086,35052,35647,35850,22700,23162,22052,25872,28265,27232,16825,23,031
"Franklin County, Maine",30019,14651,15368,28993,84,119,114,31,62,616,63,553,30019,29633,386,0.4309,0.0146,26030,26545,26554,22358,20146,25429,9259,,30402,4945,23,007
"Somerset County, Maine",50710,25085,25625,49017,300,224,155,0,26,988,32,956,50710,50180,530,0.4440,0.0145,23557,23722,23776,17811,17615,8503,30785,-666666666,12465,19735,23,025
"Worcester County, Maryland",51564,25283,26281,42778,6754,109,685,54,142,1042,19,1023,51564,49799,1765,0.4559,0.0180,35666,37900,38446,24374,20381,30229,55474,38576,37973,30109,24,047
"Baltimore city, Maryland",614700,288691,326009,187152,383918,1585,15898,215,10607,15325,1424,13901,614700,583197,31503,0.5130,0.0047,29700,47244,49682,21423,21351,24120,39229,25470,19264,22589,24,510
"Talbot County, Maryland",37211,17626,19585,30828,4110,53,514,20,367,1319,127,1192,37211,34799,2412,0.5266,0.0241,47302,52260,54434,18869,24817,38887,35210,,19260,14654,24,041
"Harford County, Maryland",251025,122763,128262,198188,34080,447,6750,30,3620,7910,710,7200,251025,239956,11069,0.4150,0.0068,39365,41855,42258,27155,30896,40837,40125,,25701,19081,24,025
"Howard County, Maryland",315327,154285,161042,182836,58856,715,55913,58,3913,13036,1215,11821,315327,294127,21200,0.4038,0.0065,52586,59637,62103,33053,41208,30911,49513,74778,28378,26602,24,027
"Anne Arundel County, Maryland",567696,281176,286520,416185,93526,997,21314,369,13315,21990,1652,20338,567696,525056,42640,0.4112,0.0059,44979,49769,51006,26341,34203,39657,39055,20041,21028,21038,24,003
"Baltimore County, Maryland",827625,392421,435204,508001,234809,2262,49327,749,9565,22912,2370,20542,827625,784141,43484,0.4500,0.0049,38580,44086,45183,22213,30996,26368,32198,18945,18208,18320,24,005
"Calvert County, Maryland",91082,45307,45775,73931,10730,122,1723,38,598,3940,151,3789,91082,87655,3427,0.3757,0.0115,43504,45775,45972,34027,35491,20820,38093,,29174,28068,24,009
"Garrett County, Maryland",29376,14561,14815,28445,228,50,114,8,38,493,43,450,29376,29045,331,0.4380,0.0168,27980,28568,28596,10060,4207,25830,19732,,,9023,24,023
"Montgomery County, Maryland",1040133,502389,537744,559927,189800,3068,152812,502,89343,44681,8865,35816,1040133,839826,200307,0.4624,0.0031,52828,66857,74340,26014,35060,33887,49936,38537,19647,30205,24,031
"Carroll County, Maryland",167522,82841,84681,153788,5631,362,2998,85,1344,3314,285,3029,167522,161890,5632,0.3992,0.0098,40667,41671,42100,24714,29775,41858,38608,29773,23195,21647,24,013
"Queen Anne's County, Maryland",49355,24426,24929,44131,3346,43,462,55,514,804,41,763,49355,47484,1871,0.4102,0.0150,42077,43542,44257,23507,33274,20207,22706,86900,16687,23784,24,035
"St. Mary's County, Maryland",111531,55552,55979,87631,16081,146,3071,13,804,3785,69,3716,111531,106010,5521,0.4007,0.0115,39254,42088,42592,30529,27194,117536,45863,,24533,19757,24,037
"Charles County, Maryland",157671,76071,81600,71681,70047,849,4899,64,1150,8981,486,8495,157671,148914,8757,0.3813,0.0080,39696,44336,44782,34197,36833,50627,40930,44472,35971,23724,24,017
"Dorchester County, Maryland",32261,15335,16926,21159,8845,31,335,0,595,1296,72,1224,32261,30546,1715,0.4789,0.0212,30135,35077,35339,22486,21663,23106,20558,-666666666,21372,13926,24,019
"Washington County, Maryland",149811,76098,73713,123859,15803,358,2697,132,1441,5521,382,5139,149811,142656,7155,0.4462,0.0108,29802,32415,32861,18691,16300,44006,30311,32327,18041,11671,24,043
"Wicomico County, Maryland",102172,48535,53637,68527,26494,173,3264,37,1063,2614,185,2429,102172,96974,5198,0.4368,0.0122,27622,30968,31824,17831,20014,19088,32244,,18695,14865,24,045
"Cecil County, Maryland",102517,51149,51368,90454,6869,165,1480,32,976,2541,82,2459,102517,98131,4386,0.4066,0.0108,32976,34423,34932,19873,24028,16577,22779,33450,25148,15644,24,015
"Caroline County, Maryland",32875,16021,16854,26432,4600,132,218,10,708,775,23,752,32875,30571,2304,0.4331,0.0175,27866,29933,30973,11503,20425,18082,30817,,12494,16455,24,011
"Suffolk County, Massachusetts",791766,382830,408936,437431,177748,2357,69435,257,54071,50467,5607,44860,791766,612064,179702,0.5365,0.0051,40190,52625,58942,21105,24422,20347,32781,7602,19060,21874,25,025
"Barnstable County, Massachusetts",213690,102176,111514,196442,6341,1137,3228,166,2116,4260,799,3461,213690,207462,6228,0.4589,0.0094,42578,44154,44591,24365,22860,30652,32971,22506,27586,17961,25,001
"Dukes County, Massachusetts",17313,8475,8838,15319,680,127,64,0,318,805,41,764,17313,16707,606,0.5020,0.0306,43822,47205,47939,18260,26725,10365,3248,-666666666,23371,10467,25,007
"Middlesex County, Massachusetts",1595192,779666,815526,1233271,84021,2958,186123,603,42335,45881,6062,39819,1595192,1469659,125533,0.4680,0.0032,49669,53463,55163,25170,28530,27740,46894,56208,21689,24786,25,017
"Berkshire County, Massachusetts",127328,61603,65725,115566,3741,425,2177,56,2267,3096,255,2841,127328,121489,5839,0.4645,0.0094,34287,35928,36233,19488,15968,14304,27763,22952,18556,14221,25,003
"Essex County, Massachusetts",781024,376475,404549,625582,31317,1884,26897,115,72694,22535,3559,18976,781024,622050,158974,0.4840,0.0043,40697,44807,47967,18595,27361,17694,43540,14434,17563,18438,25,009
"Bristol County, Massachusetts",558905,270624,288281,472579,22640,426,12603,203,33851,16603,4491,12112,558905,515863,43042,0.4563,0.0048,34226,36484,37018,15880,24957,20429,35190,19619,17333,16825,25,005
"Hampden County, Massachusetts",469116,226555,242561,380944,41166,1280,11052,87,21501,13086,2413,10673,469116,353637,115479,0.4704,0.0062,29020,31413,36162,14260,20884,15516,24938,19428,14070,14337,25,013
"Plymouth County, Massachusetts",512135,249126,263009,427155,48168,680,6541,227,17359,12005,2828,9177,512135,492659,19476,0.4494,0.0050,41343,44754,45202,22929,23974,31062,38988,48883,21156,20607,25,023
"Franklin County, Massachusetts",70935,34601,36334,66044,1074,219,1165,65,768,1600,212,1388,70935,68169,2766,0.4533,0.0159,34202,35383,35748,18072,13592,26494,23784,,15892,17484,25,011
"Norfolk County, Massachusetts",698249,335338,362911,547590,47581,880,75060,248,10544,16346,2188,14158,698249,667886,30363,0.4774,0.0046,52036,55869,56256,39933,33503,45069,44537,32353,33186,24845,25,021
"Hampshire County, Massachusetts",161159,75426,85733,141795,4488,272,8428,63,1450,4663,568,4095,161159,152277,8882,0.4621,0.0105,33605,35339,36033,19245,18585,15590,25004,17644,19023,16686,25,015
"Nantucket County, Massachusetts",11101,5650,5451,9722,776,35,107,7,62,392,139,253,11101,10596,505,0.4775,0.0353,51270,55062,55812,26393,21257,,22783,,18327,32102,25,019
"Monroe County, Michigan",149699,73914,75785,141260,3553,449,930,10,762,2735,94,2641,149699,144438,5261,0.4128,0.0068,30295,30914,31258,20262,19615,23321,32123,,17121,16409,26,115
"Allegan County, Michigan",115250,57586,57664,107953,1701,558,781,23,1833,2401,400,2001,115250,106858,8392,0.4053,0.0098,28073,28649,29287,16840,15071,25453,38609,,16266,17862,26,005
"Hillsdale County, Michigan",45830,22798,23032,44312,349,179,173,0,160,657,27,630,45830,44796,1034,0.4344,0.0136,24749,25201,25430,13327,6724,15696,14812,-666666666,15304,11250,26,059
"Alger County, Michigan",9194,5104,4090,7807,692,320,14,0,13,348,25,323,9194,9057,137,0.4146,0.0229,21773,23614,23733,13810,1709,26170,,-666666666,,16303,26,003
"Oceana County, Michigan",26417,13412,13005,24991,287,288,64,1,383,403,82,321,26417,22504,3913,0.4224,0.0186,23018,23467,25145,13087,9457,18828,29509,,15817,13437,26,127
"Leelanau County, Michigan",21639,10742,10897,20075,93,649,146,3,152,521,20,501,21639,20701,938,0.4642,0.0211,38074,39580,40310,14514,14731,20553,21750,,15305,17498,26,089
"Clare County, Michigan",30616,15159,15457,29477,186,163,111,0,83,596,61,535,30616,30024,592,0.4513,0.0202,21717,21996,22145,10784,9596,32332,17795,-666666666,17283,10143,26,035
"Keweenaw County, Michigan",2130,1111,1019,2076,33,0,2,0,0,19,0,19,2130,2118,12,0.4421,0.0431,31830,32146,32178,12925,18861,-666666666,,-666666666,-666666666,22226,26,083
"Isabella County, Michigan",70775,34371,36404,62114,1868,2395,1191,8,513,2686,126,2560,70775,68022,2753,0.4803,0.0099,23164,23408,23655,13990,15500,26748,23899,,51578,13805,26,073
"Ottawa County, Michigan",284034,140285,143749,253873,4237,868,7574,57,9741,7684,1485,6199,284034,256584,27450,0.4144,0.0074,30558,31957,32781,17639,16503,22108,28375,,17378,12102,26,139
"Tuscola County, Michigan",53250,26732,26518,51297,629,166,181,4,110,863,104,759,53250,51471,1779,0.4181,0.0113,24968,25394,25676,15618,9348,16723,39299,,24780,9623,26,157
"Alpena County, Michigan",28612,14095,14517,27720,149,152,141,20,31,399,35,364,28612,28230,382,0.4391,0.0155,25115,25448,25555,14137,8582,13032,36194,7305,18710,10189,26,007
"Ionia County, Michigan",64176,34053,30123,59051,2940,204,257,6,344,1374,230,1144,64176,61144,3032,0.3950,0.0108,23956,25091,25409,16736,7199,12090,32586,,15814,13267,26,067
"Midland County, Michigan",83389,40980,42409,77905,1168,380,1907,63,391,1575,297,1278,83389,81177,2212,0.4743,0.0141,34497,35006,35081,26630,18733,20581,44255,29089,21416,16006,26,111
"Berrien County, Michigan",154807,75737,79070,121688,22829,619,3095,38,1809,4729,474,4255,154807,146467,8340,0.4807,0.0074,29311,32701,33584,15057,14446,24909,36629,7187,17101,14475,26,021
"Oscoda County, Michigan",8277,4251,4026,8018,53,52,4,4,18,128,0,128,8277,8151,126,0.4396,0.0418,23526,23731,23861,11068,13479,12617,,,,21688,26,135
"Crawford County, Michigan",13836,7060,6776,13291,84,70,123,0,75,193,8,185,13836,13571,265,0.4070,0.0236,24884,25288,25484,10742,16808,31087,18172,-666666666,10859,8017,26,039
"Clinton County, Michigan",77896,38528,39368,73107,1360,138,1224,0,193,1874,138,1736,77896,74390,3506,0.4221,0.0115,33568,34446,34943,23479,21264,26378,28202,-666666666,27993,12858,26,037
"Gratiot County, Michigan",41067,21961,19106,37353,2313,211,156,23,126,885,184,701,41067,38613,2454,0.4575,0.0143,22027,23478,23937,15075,2986,27255,12867,43126,17758,10978,26,057
"Huron County, Michigan",31543,15692,15851,30648,124,77,184,0,104,406,52,354,31543,30802,741,0.4335,0.0106,27130,27406,27614,16599,17868,20758,29321,-666666666,25406,9739,26,063
"Lenawee County, Michigan",98474,49815,48659,91413,2640,492,284,15,1003,2627,361,2266,98474,90690,7784,0.4170,0.0127,26958,27532,28159,18609,14588,23672,48271,,17470,21468,26,091
"Mason County, Michigan",28884,14310,14574,27449,277,221,186,0,120,631,208,423,28884,27570,1314,0.4694,0.0296,28812,29519,30094,14551,7164,21192,14508,-666666666,11221,17807,26,105
"Montcalm County, Michigan",63209,32595,30614,59734,1390,316,253,41,314,1161,226,935,63209,61012,2197,0.4196,0.0119,23018,23250,23418,16160,15781,21997,55134,7193,15279,15705,26,117
"St. Joseph County, Michigan",60897,30259,30638,55466,1338,213,304,30,1617,1929,72,1857,60897,56187,4710,0.4224,0.0147,25136,26139,26884,12321,16397,11645,28682,,14227,12487,26,149
"St. Clair County, Michigan",159566,79300,80266,149216,3393,275,1082,38,937,4625,369,4256,159566,154285,5281,0.4327,0.0082,29356,30065,30389,17831,21273,18739,30550,13895,27301,13301,26,147
"Washtenaw County, Michigan",365961,181376,184585,269777,43099,1202,33165,189,2635,15894,699,15195,365961,348962,16999,0.4826,0.0054,39486,43111,43806,26832,23697,25738,40940,16108,23381,21724,26,161
"Arenac County, Michigan",15165,7681,7484,14597,89,190,55,0,20,214,18,196,15165,14864,301,0.4209,0.0153,23374,23637,23717,16608,4999,22266,40340,-666666666,,8783,26,011
"Cass County, Michigan",51460,25789,25671,45663,2549,577,434,21,549,1667,100,1567,51460,49511,1949,0.4473,0.0200,29923,31218,31681,15926,23539,25503,23582,,19311,11258,26,027
"Iron County, Michigan",11212,5595,5617,10776,57,176,65,0,7,131,34,97,11212,10991,221,0.4334,0.0212,24876,25053,25280,12161,15625,31466,10632,-666666666,,11521,26,071
"Roscommon County, Michigan",23877,11857,12020,23074,36,219,75,0,28,445,12,433,23877,23453,424,0.4339,0.0242,23862,24211,24407,15808,5342,11092,19379,-666666666,63768,11744,26,143
"Wayne County, Michigan",1761382,847648,913734,937396,685098,5566,57380,481,33543,41918,4271,37647,1761382,1658180,103202,0.4974,0.0031,25976,32412,33491,16382,17842,23802,32165,17017,14540,16062,26,163
"Branch County, Michigan",43584,22485,21099,40923,990,180,283,17,484,707,88,619,43584,41565,2019,0.4117,0.0154,24249,24968,25403,14271,7438,22833,27136,,18475,9867,26,023
"Jackson County, Michigan",158913,81205,77708,138852,12687,694,1352,41,946,4341,221,4120,158913,153390,5523,0.4439,0.0120,26942,28689,28968,17695,14111,15415,40050,9559,12985,9524,26,075
"Mackinac County, Michigan",10817,5463,5354,8063,300,1822,78,14,12,528,21,507,10817,10632,185,0.4406,0.0191,28941,32141,32182,21116,11166,18823,22809,,,26096,26,097
"Antrim County, Michigan",23177,11515,11662,22256,86,176,73,0,200,386,7,379,23177,22660,517,0.4675,0.0235,30920,31513,31703,13166,10405,17445,25736,-666666666,8230,20175,26,009
"Houghton County, Michigan",36360,19668,16692,33819,275,104,1082,29,191,860,61,799,36360,35788,572,0.4724,0.0199,22866,22997,23099,37699,47454,18338,25874,,10213,10018,26,061
"Iosco County, Michigan",25247,12578,12669,24185,172,200,173,10,50,457,25,432,25247,24710,537,0.4217,0.0193,25075,25314,25412,21734,22097,32405,15986,,25176,13938,26,069
"Lake County, Michigan",11763,6000,5763,10220,939,117,27,11,26,423,24,399,11763,11452,311,0.4397,0.0148,19012,19824,20040,10817,15562,24764,17604,,14054,6340,26,085
"Montmorency County, Michigan",9261,4665,4596,8958,32,82,7,1,15,166,16,150,9261,9143,118,0.3979,0.0209,23930,24284,24343,10797,21472,15167,,,17667,9836,26,119
"Presque Isle County, Michigan",12797,6386,6411,12353,71,42,60,0,50,221,17,204,12797,12629,168,0.4280,0.0208,26503,26204,26341,15135,6177,21979,145005,-666666666,51048,12881,26,141
"Kalamazoo County, Michigan",261573,128025,133548,212284,28440,689,6385,69,1510,12196,838,11358,261573,248980,12593,0.4673,0.0080,30555,32983,33519,19237,19464,16227,34230,35564,19750,14348,26,077
"Mecosta County, Michigan",43264,21844,21420,40305,1250,166,332,7,129,1075,34,1041,43264,42306,958,0.4559,0.0164,23182,23798,23941,16017,12707,17473,19920,,7196,16026,26,107
"Marquette County, Michigan",66939,33703,33236,62426,1130,558,654,33,102,2036,146,1890,66939,65938,1001,0.4330,0.0135,26290,27058,27241,10194,7351,18837,26970,32355,10242,15794,26,103
"Newaygo County, Michigan",48142,24149,23993,44687,657,417,160,0,1391,830,58,772,48142,45350,2792,0.4397,0.0157,24005,24508,24664,12994,12740,56729,23596,-666666666,10225,12557,26,123
"Osceola County, Michigan",23232,11738,11494,22347,256,195,70,0,25,339,27,312,23232,22814,418,0.4300,0.0123,22142,22621,22643,18851,6142,13955,18587,-666666666,18260,8392,26,133
"Otsego County, Michigan",24397,12061,12336,23330,133,104,106,0,22,702,32,670,24397,23985,412,0.4143,0.0174,26829,26630,26828,10046,17185,106726,41142,-666666666,,21925,26,137
"Calhoun County, Michigan",134473,65782,68691,110011,14321,939,3095,20,646,5441,514,4927,134473,127588,6885,0.4435,0.0080,25652,27652,28272,15295,16610,19138,24877,,18058,11285,26,025
"Cheboygan County, Michigan",25458,12720,12738,23741,220,431,101,0,22,943,22,921,25458,25107,351,0.4220,0.0119,25876,26704,26859,11114,5048,21255,18121,-666666666,6668,13283,26,031
"Luce County, Michigan",6364,3743,2621,5066,485,361,17,2,29,404,30,374,6364,6166,198,0.3926,0.0258,20745,22796,23094,6531,4691,19543,20594,,4969,16386,26,095
"Kent County, Michigan",643140,316734,326406,513126,62203,2649,19311,222,21205,24424,2980,21444,643140,575961,67179,0.4578,0.0059,31005,34322,35785,14874,17931,19476,28004,42541,14840,12188,26,081
"Macomb County, Michigan",868704,422835,445869,707875,99265,2525,33769,346,5005,19919,1583,18336,868704,846492,22212,0.4255,0.0045,31104,33109,33253,24992,22381,19966,26501,16964,19562,15713,26,099
"Bay County, Michigan",104786,51486,53300,99253,1779,410,631,0,367,2346,74,2272,104786,99283,5503,0.4387,0.0119,26644,27208,27708,16984,15242,28764,35237,-666666666,16278,10343,26,017
"Saginaw County, Michigan",192778,93581,99197,144402,35973,577,2451,12,3221,6142,857,5285,192778,176627,16151,0.4644,0.0100,26625,29547,30334,17447,15873,23445,63859,,19750,9878,26,145
"Shiawassee County, Michigan",68493,33801,34692,66193,396,174,196,18,159,1357,84,1273,68493,66498,1995,0.4041,0.0118,27398,27727,27828,23411,15264,21738,22253,,26256,16846,26,155
"Baraga County, Michigan",8507,4720,3787,6246,861,775,42,2,36,545,13,532,8507,8375,132,0.4528,0.0268,20698,24007,24169,9117,762,23007,13657,,24492,11163,26,013
"Charlevoix County, Michigan",26219,12907,13312,24945,140,388,110,22,83,531,78,453,26219,25715,504,0.4700,0.0163,32559,33270,33534,14687,28144,16695,31419,,12301,16255,26,029
"Eaton County, Michigan",109155,53353,55802,94291,7225,533,2535,43,1548,2980,245,2735,109155,103362,5793,0.4149,0.0111,31982,33046,33437,24927,25735,21087,32360,23984,18363,22276,26,045
"Delta County, Michigan",36190,17998,18192,33957,106,688,153,7,48,1231,99,1132,36190,35729,461,0.4378,0.0167,26852,27598,27679,16773,7701,20631,40428,,17852,10175,26,041
"Gogebic County, Michigan",15414,8324,7090,13942,701,414,54,23,29,251,48,203,15414,15207,207,0.4870,0.0293,24325,26061,26223,8486,4300,12480,12231,,9290,9713,26,053
"Emmet County, Michigan",33039,16307,16732,30478,229,958,185,30,112,1047,29,1018,33039,32507,532,0.4594,0.0126,32455,33544,33523,30580,19071,18265,45439,10310,25094,15782,26,047
"Woodruff County, Arkansas",6660,3051,3609,4633,1845,0,91,6,0,85,0,85,6660,6648,12,0.4949,0.0325,21276,24276,24302,,14288,-666666666,,,-666666666,10859,05,147
"Cleburne County, Arkansas",25230,12472,12758,24473,140,273,152,0,42,150,6,144,25230,24612,618,0.4582,0.0279,26620,26954,27263,14872,6071,13207,,-666666666,21252,20523,05,023
"Cleveland County, Arkansas",8226,4138,4088,7106,924,13,3,0,0,180,6,174,8226,8072,154,0.4418,0.0249,23538,25227,25634,,14135,8015,,-666666666,-666666666,6624,05,025
"Jackson County, Arkansas",17225,8512,8713,13516,2143,17,7,7,98,1437,10,1427,17225,16740,485,0.5031,0.0382,19848,22205,22478,8315,11027,,,,15108,11552,05,067
"Hempstead County, Arkansas",22018,10494,11524,13067,6713,51,17,50,1663,457,0,457,22018,19232,2786,0.4257,0.0257,20168,23807,25086,9154,16458,27953,,,10159,8492,05,057
"Sharp County, Arkansas",17043,8335,8708,16216,119,96,19,0,51,542,71,471,17043,16670,373,0.4758,0.0778,20721,20931,21010,15969,11823,13697,186484,-666666666,13898,12476,05,135
"Stone County, Arkansas",12446,6209,6237,12024,9,63,14,0,2,334,0,334,12446,12210,236,0.4595,0.0340,20496,20956,21049,15974,,19529,,-666666666,,5354,05,137
"Washington County, Arkansas",228529,114181,114348,177357,8149,2207,5696,5039,22411,7670,893,6777,228529,190477,38052,0.4967,0.0140,27823,31179,32506,14705,16133,19620,28414,9905,14223,16076,05,143
"Baxter County, Arkansas",41219,19992,21227,39814,74,130,172,13,301,715,3,712,41219,40292,927,0.4539,0.0293,26004,26132,26248,17967,11951,18315,18163,,26115,23630,05,005
"Ashley County, Arkansas",20537,10013,10524,14737,5273,50,47,0,305,125,13,112,20537,19440,1097,0.4760,0.0408,22052,25924,26815,11798,11753,,,-666666666,17441,7741,05,003
"Craighead County, Arkansas",105701,51528,54173,83979,14622,480,1328,200,2352,2740,124,2616,105701,100448,5253,0.4930,0.0173,26432,29024,29567,16438,17089,6771,24446,,18806,9103,05,031
"Greene County, Arkansas",44623,21912,22711,42566,720,105,129,40,305,758,92,666,44623,43379,1244,0.4170,0.0192,22874,23424,23705,10522,10436,17711,7329,,13581,11374,05,055
"Lafayette County, Arkansas",6915,3381,3534,4196,2533,21,35,0,63,67,0,67,6915,6743,172,0.5762,0.0541,26005,33602,34285,16526,14248,,30657,-666666666,,15552,05,073
"Perry County, Arkansas",10322,5184,5138,9578,196,63,0,0,193,292,33,259,10322,10025,297,0.4031,0.0246,21699,22056,22035,12442,9143,51948,-666666666,-666666666,8498,20621,05,105
"Phillips County, Arkansas",19034,9006,10028,6893,11921,6,11,0,29,174,21,153,19034,18691,343,0.4925,0.0237,18402,27278,28048,11772,13407,,,-666666666,,4587,05,107
"Poinsett County, Arkansas",24054,11734,12320,21306,1149,54,12,0,153,1380,19,1361,24054,23347,707,0.4161,0.0192,19413,20436,20575,9622,12214,20078,,-666666666,7299,10906,05,111
"Sevier County, Arkansas",17193,8607,8586,10858,874,364,61,50,4698,288,36,252,17193,11490,5703,0.4221,0.0355,20627,24753,26048,12392,14370,17721,12133,1256,12773,21021,05,133
"Yell County, Arkansas",21573,10782,10791,16956,542,116,241,0,3433,285,70,215,21573,17259,4314,0.4501,0.0306,21584,23357,23918,13736,15129,10126,19791,-666666666,14515,19679,05,149
"Calhoun County, Arkansas",5202,2607,2595,3962,1125,7,0,10,10,88,0,88,5202,4996,206,0.4266,0.0239,24509,27348,28382,7090,16522,,-666666666,,,2693,05,013
"Clark County, Arkansas",22385,10628,11757,15939,5374,86,156,8,506,316,17,299,22385,21335,1050,0.4509,0.0164,21571,23824,24195,10757,16754,21170,25697,,8904,8794,05,019
"Bradley County, Arkansas",10948,5214,5734,7158,3176,127,0,0,463,24,12,12,10948,9294,1654,0.4603,0.0203,22411,26542,29335,10720,15216,1480,-666666666,-666666666,14563,,05,011
"Monroe County, Arkansas",7249,3316,3933,4058,2897,36,31,0,42,185,25,160,7249,7050,199,0.4699,0.0226,22274,26576,26296,25659,17476,,,-666666666,,12557,05,095
"Polk County, Arkansas",20163,9828,10335,18538,91,331,157,0,468,578,36,542,20163,18844,1319,0.4377,0.0210,20176,20648,21162,12297,8690,13504,21413,-666666666,16506,13282,05,113
"Ouachita County, Arkansas",24106,11327,12779,13655,9904,48,15,0,31,453,37,416,24106,23560,546,0.4770,0.0228,21520,26099,26383,15100,15649,16658,50253,-666666666,,12489,05,103
"Newton County, Arkansas",7848,3932,3916,7435,2,205,18,0,0,188,20,168,7848,7775,73,0.4312,0.0314,18907,18703,18818,4793,,22784,,-666666666,-666666666,23746,05,101
"Little River County, Arkansas",12417,6090,6327,9128,2762,143,44,0,51,289,0,289,12417,12310,107,0.4643,0.0365,26216,28076,28186,15026,20799,40745,28693,-666666666,20349,12715,05,081
"Carroll County, Arkansas",27887,13897,13990,25826,335,188,334,208,417,579,32,547,27887,23705,4182,0.4572,0.0374,24185,24820,27104,10641,5058,61649,11684,5256,13166,16705,05,015
"Miller County, Arkansas",43759,21476,22283,30846,10844,477,180,34,513,865,63,802,43759,42354,1405,0.4662,0.0192,22938,25883,25950,13907,16718,15866,17273,,8350,9744,05,091
"Lake County, California",64148,31879,32269,49463,1562,2426,661,30,8048,1958,314,1644,64148,51318,12830,0.4796,0.0157,25404,28500,29197,15672,17001,15755,19591,18780,13256,17847,06,033
"Mariposa County, California",17540,8920,8620,15579,166,397,243,54,396,705,29,676,17540,15631,1909,0.4349,0.0284,29776,30240,31822,17329,26847,18277,15117,18665,35312,29482,06,043
"Yuba County, California",75493,38468,37025,56344,2432,1079,5104,343,4126,6065,651,5414,75493,54503,20990,0.4276,0.0142,23867,25569,28572,16140,28340,16528,20331,20278,19324,13828,06,115
"Contra Costa County, California",1133247,553701,579546,648325,97333,5529,185065,5585,112976,78434,14088,64346,1133247,845146,288101,0.4703,0.0036,45524,53705,61487,24019,32908,30648,47715,26525,21806,24953,06,013
"Lassen County, California",31185,20671,10514,25672,2738,877,437,205,590,666,97,569,31185,25351,5834,0.4231,0.0180,21897,24551,29845,3770,3369,17709,15282,9814,6329,23125,06,035
"Santa Barbara County, California",443738,222208,221530,344026,8626,4389,23863,814,42024,19996,4055,15941,443738,243678,200060,0.4798,0.0055,34229,37254,51184,18158,25755,20007,33168,48820,18764,22146,06,083
"Sonoma County, California",501317,245196,256121,375519,7960,4854,20087,1636,63422,27839,6031,21808,501317,368332,132985,0.4578,0.0075,39929,45366,49394,20533,29309,29471,35809,24495,18193,24845,06,097
"Imperial County, California",180216,92250,87966,115817,4591,1801,2684,419,47362,7542,3399,4143,180216,29197,151019,0.4768,0.0133,17590,18957,31264,15518,13017,17178,39446,22204,14018,13865,06,025
"Mono County, California",14174,7341,6833,12017,105,527,339,0,801,385,70,315,14174,10308,3866,0.3701,0.0296,33421,35709,41647,16192,25061,20488,27649,-666666666,12591,30402,06,051
"Alameda County, California",1643700,807171,836529,681725,177135,10712,486434,13768,169771,104155,20044,84111,1643700,1274639,369061,0.4624,0.0033,44283,54820,63006,24666,32288,30187,45468,29513,22822,28564,06,001
"Sacramento County, California",1510023,737742,772281,875793,149064,10340,235474,16715,115072,107565,17250,90315,1510023,1162998,347025,0.4583,0.0041,31311,36562,40750,20275,24643,24368,29180,23205,18973,17596,06,067
"Napa County, California",140530,70082,70448,102711,2867,1198,11373,272,16738,5371,1164,4207,140530,92843,47687,0.4719,0.0093,42677,48258,57724,21764,31301,29102,40393,21086,18883,25120,06,055
"Monterey County, California",433212,220967,212245,256709,11200,3221,24342,2011,117386,18343,3699,14644,433212,180624,252588,0.4619,0.0065,28836,35020,51488,16797,24456,19105,34819,29200,15821,21970,06,053
"Sierra County, California",2930,1542,1388,2890,6,25,0,0,0,9,0,9,2930,2606,324,0.4269,0.0428,31972,32115,34379,14096,6267,25280,-666666666,-666666666,-666666666,21689,06,091
"San Diego County, California",3302833,1661931,1640902,2335447,166412,20980,390418,13903,205307,170366,29046,141320,3302833,2195908,1106925,0.4630,0.0029,36156,38997,48852,20418,28252,28270,37840,31310,19926,22007,06,073
"Yolo County, California",214977,104375,110602,145778,5834,1247,29612,984,17774,13748,1959,11789,214977,147168,67809,0.4931,0.0092,32598,36410,43672,19770,24300,23536,30226,23321,19240,19568,06,113
"Humboldt County, California",135768,67666,68102,108784,1585,6797,4160,436,5778,8228,373,7855,135768,120408,15360,0.4754,0.0148,26747,28527,29410,17617,19596,16970,16498,32214,18950,23027,06,023
"Alpine County, California",1146,612,534,723,9,311,8,8,0,87,0,87,1146,1041,105,0.4967,0.0771,29041,37607,38744,10077,,13598,,,-666666666,20105,06,003
"Mendocino County, California",87422,43439,43983,73121,531,3591,1689,170,4020,4300,277,4023,87422,65743,21679,0.4736,0.0179,27395,29749,33871,14162,20908,18234,20600,26325,13728,11310,06,045
"Santa Cruz County, California",273765,135727,138038,208476,2596,1375,12601,316,35546,12855,2358,10497,273765,182089,91676,0.4826,0.0066,39001,43753,51498,19151,36330,29477,36086,14327,17752,25713,06,087
"Los Angeles County, California",10098052,4976788,5121264,5186859,823987,70527,1469968,27929,2121102,397680,113303,284377,10098052,5204449,4893603,0.5022,0.0012,32469,38948,56862,18930,28448,23067,36091,23627,17611,24436,06,037
"Riverside County, California",2383286,1186188,1197098,1450134,153545,19281,152130,6843,495241,106112,29644,76468,2383286,1228769,1154517,0.4547,0.0036,27142,31148,39602,17909,26061,23494,29699,24943,17085,18025,06,065
"Santa Clara County, California",1922200,970469,951731,865460,48058,9303,689176,7541,205997,96665,19085,77580,1922200,1426745,495455,0.4652,0.0025,52451,61003,73957,25265,38412,26479,55716,37395,21772,28648,06,085
"Marin County, California",260295,127113,133182,203342,5709,737,15000,584,22262,12661,1867,10794,260295,218960,41335,0.5158,0.0070,69275,78664,82482,27304,41829,27436,58694,12452,18393,37928,06,041
"Siskiyou County, California",43540,21706,21834,36971,632,1469,678,149,719,2922,268,2654,43540,38204,5336,0.4880,0.0324,28130,28753,30110,14385,110915,15165,13751,21460,15807,15567,06,093
"Shasta County, California",179085,87859,91226,155840,2209,4704,5427,191,3415,7299,910,6389,179085,161480,17605,0.4603,0.0084,27983,29142,29930,18684,27025,18842,25178,16608,17833,16533,06,089
"Del Norte County, California",27424,14575,12849,20958,785,2024,977,17,968,1695,232,1463,27424,22084,5340,0.4857,0.0312,22832,23373,26701,9947,30318,22590,28460,,19336,11870,06,015
"San Luis Obispo County, California",281455,142769,138686,242078,5265,1900,10234,258,11581,10139,1605,8534,281455,218453,63002,0.4538,0.0077,35832,37803,41617,21302,19984,33557,29991,22341,19506,22318,06,079
"Glenn County, California",27897,14171,13726,23127,255,670,820,51,2416,558,21,537,27897,16393,11504,0.4548,0.0200,21736,22954,28248,14091,19805,15069,22192,14588,14731,10494,06,021
"Butte County, California",227075,112513,114562,186095,3477,2885,10151,427,9890,14150,1691,12459,227075,190717,36358,0.4893,0.0089,27537,29804,31372,17419,18490,20317,18276,34957,18538,14127,06,007
"Plumas County, California",18699,9423,9276,16654,194,428,200,41,464,718,64,654,18699,17070,1629,0.4549,0.0422,32710,34252,34663,24863,12042,30297,8793,,16101,23218,06,063
"Kern County, California",883053,452646,430407,663592,48179,9488,41842,1698,87118,31136,8956,22180,883053,417211,465842,0.4645,0.0061,22553,23613,34119,15011,16832,17859,29577,15356,17289,15929,06,029
"Orange County, California",3164182,1562429,1601753,1950902,54732,14466,635672,9442,370679,128289,25794,102495,3164182,2083987,1080195,0.4700,0.0031,39590,45083,56190,21458,36210,30439,38376,36884,18589,25435,06,059
"Calaveras County, California",45235,22434,22801,41375,302,492,568,126,547,1825,82,1743,45235,39938,5297,0.4464,0.0212,32494,33706,34929,22240,22196,26858,27788,6606,13706,17111,06,009
"Sutter County, California",95872,47789,48083,66752,2006,936,14635,569,4435,6539,856,5683,95872,66518,29354,0.4466,0.0145,26070,28563,34599,15980,29502,18877,22845,18892,18266,13732,06,101
"San Mateo County, California",765935,377851,388084,391024,17849,2922,215337,10504,85574,42725,7445,35280,765935,576933,189002,0.4852,0.0043,57375,69579,80849,26957,39344,38363,56917,26159,22967,33406,06,081
"Tuolumne County, California",53932,28102,25830,47189,926,997,749,134,1432,2505,468,2037,53932,47405,6527,0.4881,0.0258,33685,35800,36594,22780,11036,17930,22029,38569,18253,20528,06,109
"San Joaquin County, California",732212,364612,367600,411958,52023,4725,112997,4463,71360,74686,8971,65715,732212,430956,301256,0.4546,0.0055,26145,29878,38292,17545,22060,22008,25800,17942,17656,17783,06,077
"Amador County, California",37829,20302,17527,32989,790,305,499,73,1374,1799,188,1611,37829,32697,5132,0.4437,0.0249,30100,32145,33381,18901,3145,20746,39007,29537,13031,16616,06,005
"Phillips County, Colorado",4318,2295,2023,4158,12,11,15,0,38,84,0,84,4318,3374,944,0.4573,0.0493,29236,28831,32462,15163,,,,-666666666,12832,30193,08,095
"Archuleta County, Colorado",12908,6546,6362,10810,249,192,133,0,1372,152,30,122,12908,10537,2371,0.4486,0.0331,31035,33587,34942,16000,35261,23041,7650,-666666666,14308,24172,08,007
"Denver County, Colorado",693417,347188,346229,530278,64881,6833,26143,1033,39531,24718,4371,20347,693417,483558,209859,0.4958,0.0056,41196,46048,57106,19859,24294,21556,36145,41236,20675,25066,08,031
"Kiowa County, Colorado",1449,750,699,1333,17,0,0,0,5,94,0,94,1449,1371,78,0.4383,0.0521,24012,24767,25577,10101,,-666666666,-666666666,-666666666,,13685,08,061
"Huerfano County, Colorado",6583,3305,3278,6199,38,115,0,0,114,117,9,108,6583,4309,2274,0.4314,0.0281,25636,25775,27331,22516,3034,29634,-666666666,-666666666,27056,20334,08,055
"Baca County, Colorado",3563,1755,1808,3377,35,57,0,4,19,71,7,64,3563,3182,381,0.4396,0.0278,23862,24226,25297,15045,10797,25777,-666666666,,25842,12287,08,009
"Chaffee County, Colorado",19164,10268,8896,17857,366,42,153,0,129,617,120,497,19164,17229,1935,0.4266,0.0206,29365,30732,32248,14751,901,,17236,-666666666,27221,12154,08,015
"Gilpin County, Colorado",5924,3169,2755,5566,15,171,0,0,69,103,0,103,5924,5376,548,0.4241,0.0760,48460,49845,47068,70510,,31556,-666666666,-666666666,,18038,08,047
"Kit Carson County, Colorado",7635,4158,3477,6885,195,33,25,38,382,77,49,28,7635,6169,1466,0.4691,0.0917,27471,29238,31735,14682,3763,24594,13944,,14314,9439,08,063
"Garfield County, Colorado",58538,29779,28759,51120,234,404,542,9,5195,1034,143,891,58538,42051,16487,0.4008,0.0166,32491,33857,38647,17246,20840,40446,37168,,18811,31000,08,045
"Gunnison County, Colorado",16537,8983,7554,15748,103,162,83,22,70,349,7,342,16537,15005,1532,0.4182,0.0182,30127,30805,32119,16858,11373,31590,,,4454,12548,08,051
"Jefferson County, Colorado",570427,283919,286508,517644,6639,4162,16243,257,10200,15282,2984,12298,570427,483274,87153,0.4337,0.0049,41930,43001,45984,24493,35540,27429,36929,48457,29175,26104,08,059
"Mineral County, Colorado",823,402,421,728,18,9,5,0,44,19,16,3,823,744,79,0.3541,0.0391,35229,38243,38592,13181,,,,-666666666,12939,,08,079
"Ouray County, Colorado",4722,2312,2410,4599,0,50,21,4,3,45,0,45,4722,4521,201,0.4413,0.0334,36138,36578,37034,26971,-666666666,38070,,,,4700,08,091
"Rio Blanco County, Colorado",6465,3291,3174,6038,25,39,6,16,23,318,50,268,6465,5815,650,0.4170,0.0355,27057,27508,28694,17405,40748,42415,,,29309,10708,08,103
"Sedgwick County, Colorado",2350,1162,1188,2165,30,17,36,0,47,55,23,32,2350,2031,319,0.4462,0.0359,25048,24883,25543,18567,,30371,34200,-666666666,21721,5485,08,115
"Conejos County, Colorado",8142,4082,4060,7349,36,207,10,16,390,134,57,77,8142,3827,4315,0.4614,0.0337,19545,19880,23872,16416,,16301,12440,13238,19178,13742,08,021
"Costilla County, Colorado",3687,1941,1746,3343,17,80,55,0,80,112,10,102,3687,1380,2307,0.5076,0.0351,20715,20879,28162,17059,,10194,19878,-666666666,28651,19932,08,023
"Adams County, Colorado",497115,250704,246411,410132,16494,6264,19268,598,24925,19434,3494,15940,497115,299836,197279,0.4075,0.0065,28897,30302,37662,18679,23151,23520,24841,36946,19101,22192,08,001
"Eagle County, Colorado",54357,28804,25553,48258,525,155,424,43,3968,984,101,883,54357,38217,16140,0.4335,0.0258,41064,43666,50661,20342,24390,17979,46061,,16611,22774,08,037
"Lake County, Colorado",7585,4176,3409,6532,8,44,95,31,745,130,0,130,7585,5239,2346,0.4349,0.0429,28062,30435,33869,16835,,,26166,,12879,,08,065
"Moffat County, Colorado",13060,6698,6362,12330,150,104,0,28,99,349,38,311,13060,11077,1983,0.4298,0.0263,27845,28537,30993,13887,14973,22133,-666666666,,22522,13393,08,081
"Pitkin County, Colorado",17909,9408,8501,16316,297,22,270,0,749,255,33,222,17909,16132,1777,0.5466,0.0450,56180,59588,61395,27791,10052,,11871,-666666666,20729,42971,08,097
"Cheyenne County, Colorado",2039,964,1075,1916,2,3,47,3,3,65,8,57,2039,1692,347,0.4233,0.0350,25234,25843,28515,13104,,,27847,,,7865,08,017
"Crowley County, Colorado",5630,3526,2104,4978,206,85,19,0,94,248,83,165,5630,3883,1747,0.4185,0.0293,14988,15308,17169,12794,40,3718,29505,-666666666,10120,25579,08,025
"Dolores County, Colorado",1841,989,852,1780,0,13,0,0,1,47,0,47,1841,1733,108,0.4295,0.0404,24505,24856,25573,13434,-666666666,,-666666666,-666666666,,,08,033
"Jackson County, Colorado",1296,631,665,1211,0,0,0,0,80,5,0,5,1296,1042,254,0.3796,0.0428,25467,26826,28574,12730,-666666666,-666666666,-666666666,-666666666,4723,,08,057
"Larimer County, Colorado",338161,168615,169546,309269,3275,2322,7505,309,4949,10532,1521,9011,338161,299838,38323,0.4497,0.0078,35390,36453,38080,20175,22466,21995,34434,13658,18562,20389,08,069
"Montezuma County, Colorado",25909,12760,13149,21054,52,3248,57,10,939,549,92,457,25909,22687,3222,0.4247,0.0168,25161,26987,28479,14215,16523,17012,18063,,14610,23183,08,083
"San Miguel County, Colorado",7968,4215,3753,7617,16,42,101,0,60,132,0,132,7968,7148,820,0.5273,0.0463,45396,46233,48764,23802,8038,58090,49835,-666666666,6390,11954,08,113
"Boulder County, Colorado",321030,161355,159675,284719,2827,1715,14979,185,6698,9907,1358,8549,321030,276764,44266,0.4802,0.0074,43831,45590,48979,20962,34698,21778,36884,86326,21344,24610,08,013
"Las Animas County, Colorado",14179,7452,6727,12117,121,506,104,0,662,669,157,512,14179,8216,5963,0.4616,0.0239,25118,25663,30096,19812,,18792,25557,-666666666,33911,15159,08,071
"Yuma County, Colorado",10069,5019,5050,9353,238,51,0,0,305,122,43,79,10069,7758,2311,0.4244,0.0336,25846,26826,30501,11451,9175,27912,-666666666,-666666666,12310,16157,08,125
"Routt County, Colorado",24874,12915,11959,23601,193,150,259,5,416,250,31,219,24874,23134,1740,0.4530,0.0244,40727,42038,43383,18295,27420,11723,20058,,8007,20634,08,107
"Summit County, Colorado",30429,16684,13745,27530,285,75,150,130,1666,593,35,558,30429,26077,4352,0.4098,0.0277,38310,39563,40943,23806,51035,84624,10533,123,21234,31535,08,117
"Clear Creek County, Colorado",9379,4816,4563,8880,103,30,98,7,4,257,6,251,9379,8761,618,0.4127,0.0399,40655,41575,42457,29489,17339,58587,32955,,,17991,08,019
"Delta County, Colorado",30346,15235,15111,28768,291,329,310,0,281,367,40,327,30346,25751,4595,0.4669,0.0237,24886,25312,27761,11616,6363,13622,17977,-666666666,22990,23559,08,029
"Pueblo County, Colorado",164685,80962,83723,131054,3535,6141,1497,65,15887,6506,1488,5018,164685,94048,70637,0.4572,0.0103,24257,25717,29224,18484,17206,17019,28138,22609,19084,17265,08,101
"Morgan County, Colorado",28257,14112,14145,24964,954,112,166,37,1036,988,527,461,28257,18110,10147,0.4014,0.0193,24189,24877,29704,15777,22628,17044,12733,,20305,15397,08,087
"Park County, Colorado",17392,9172,8220,16467,49,291,157,19,89,320,0,320,17392,16341,1051,0.4082,0.0426,35939,35702,36581,39442,18578,4353,39906,,248744,17888,08,093
"Mesa County, Colorado",149998,74027,75971,141076,1033,1283,1409,410,1694,3093,601,2492,149998,128369,21629,0.4413,0.0099,28518,28981,30768,17840,27416,21998,29396,20335,21761,14833,08,077
"Prowers County, Colorado",12052,6035,6017,11429,134,160,41,0,126,162,3,159,12052,7520,4532,0.4334,0.0238,21612,22087,26451,14599,7337,14349,8449,-666666666,19757,11849,08,099
"El Paso County, Colorado",688153,347478,340675,547369,43282,4622,19250,2722,30293,40615,6712,33903,688153,572489,115664,0.4340,0.0039,32348,34879,36761,20282,25057,22279,30278,26114,21312,16791,08,041
"Washington County, Colorado",4840,2510,2330,4636,67,14,22,0,45,56,5,51,4840,4366,474,0.4135,0.0272,26680,27254,28664,13765,5351,,,-666666666,22496,17471,08,121
"Arapahoe County, Colorado",636671,314672,321999,455987,67821,4184,37326,1426,40961,28966,5177,23789,636671,515316,121355,0.4589,0.0045,38972,44344,48174,20846,27883,23696,33197,26600,18082,20175,08,005
"Broomfield County, Colorado",66120,32789,33331,57355,770,353,4324,0,906,2412,355,2057,66120,58051,8069,0.4303,0.0146,47016,47756,49726,33229,50387,38018,49648,-666666666,20938,34743,08,014
"New Haven County, Connecticut",859339,414311,445028,634586,113737,1540,34161,219,47728,27368,6623,20745,859339,707978,151361,0.4688,0.0043,36678,41007,44144,19758,23921,27877,41291,47892,18412,15807,09,009
"Tolland County, Connecticut",151269,75821,75448,133656,4621,67,7037,0,2254,3634,327,3307,151269,143183,8086,0.4315,0.0123,39668,41611,42274,22273,22155,45730,32245,-666666666,20087,16894,09,013
"Hartford County, Connecticut",894730,434650,460080,639528,122103,2945,46577,356,53568,29653,7094,22559,894730,736945,157785,0.4716,0.0041,39260,44661,48138,19747,25092,19409,42308,39340,17492,17635,09,003
"Windham County, Connecticut",116538,57560,58978,103567,2644,711,1614,23,3893,4086,186,3900,116538,103170,13368,0.4151,0.0099,31106,32880,33965,15879,17129,15369,20449,,14436,18045,09,015
"Middlesex County, Connecticut",163368,79676,83692,144844,8654,264,5020,8,1321,3257,322,2935,163368,153533,9835,0.4427,0.0088,45293,47072,47770,29864,31587,21561,40452,,22728,21249,09,007
"New Castle County, Delaware",555133,268870,286263,358183,138608,1434,30593,182,12286,13847,1554,12293,555133,501062,54071,0.4586,0.0063,35847,39909,42022,20005,27090,32134,44223,25191,17958,16324,10,003
"Sussex County, Delaware",219540,106429,113111,180762,26992,878,2621,236,3385,4666,427,4239,219540,199476,20064,0.4496,0.0090,33983,36919,38524,20393,19952,30754,32632,17205,16676,16170,10,005
"District of Columbia, District of Columbia",684498,324881,359617,280469,321317,1993,26718,340,33518,20143,2631,17512,684498,609722,74776,0.5283,0.0048,53321,84555,88632,39076,28977,26473,64071,60410,25706,40966,11,001
"Okaloosa County, Florida",200737,101745,98992,157460,19666,1032,6055,333,6857,9334,671,8663,200737,182619,18118,0.4303,0.0092,31901,34528,35260,20074,24613,13669,26890,15095,18890,18362,12,091
"Taylor County, Florida",22098,12414,9684,16497,4877,75,80,34,356,179,3,176,22098,21161,937,0.4179,0.0272,16919,20003,20545,5097,7916,14916,15589,,5129,6077,12,123
"Washington County, Florida",24566,13231,11335,19777,3803,308,149,112,53,364,9,355,24566,23679,887,0.4401,0.0245,18112,19911,20182,10921,9233,7638,26295,27065,22189,15310,12,133
"Duval County, Florida",924229,448163,476066,557139,273829,2138,43026,687,16064,31346,3063,28283,924229,838045,86184,0.4728,0.0074,30012,35481,37070,21748,20390,27455,33371,20324,22293,16590,12,031
"Bradford County, Florida",26979,14841,12138,20935,5353,104,158,0,84,345,20,325,26979,25911,1068,0.4403,0.0318,20481,23174,23641,12466,10908,4382,23804,-666666666,11804,11003,12,007
"Brevard County, Florida",576808,282023,294785,476767,58100,1942,14050,492,7757,17700,1915,15785,576808,519113,57695,0.4550,0.0069,30987,33172,34275,21499,19208,28590,29071,32930,18598,17956,12,009
"Clay County, Florida",207291,102225,105066,165931,21318,205,6083,100,4121,9533,951,8582,207291,187254,20037,0.4191,0.0119,29138,30859,31395,21884,24792,30918,29247,32294,22140,11779,12,019
"Lafayette County, Florida",8744,5066,3678,6916,1407,13,0,187,15,206,19,187,8744,7481,1263,0.4750,0.0453,19870,21565,24757,11455,5819,,-666666666,34708,16973,44243,12,067
"Lake County, Florida",335362,162402,172960,278353,35268,1416,6588,201,5404,8132,1131,7001,335362,285301,50061,0.4272,0.0084,27052,28807,30459,19078,17034,37161,27449,28794,18106,14255,12,069
"Nassau County, Florida",80578,39956,40622,73061,4886,274,821,0,524,1012,32,980,80578,77321,3257,0.4544,0.0180,35335,36510,36832,26029,24012,14415,47149,-666666666,18173,10100,12,089
"Pinellas County, Florida",957875,459766,498109,782632,98432,2693,31851,960,13170,28137,3405,24732,957875,867516,90359,0.4857,0.0046,33478,36181,37470,22439,19992,35287,30353,24782,21710,14643,12,103
"Polk County, Florida",668671,327706,340965,520186,101690,2189,11358,314,16184,16750,2738,14012,668671,524713,143958,0.4423,0.0064,23812,25751,28753,15420,16063,26511,31290,59783,15701,12387,12,105
"St. Lucie County, Florida",305591,149385,156206,223755,61325,1063,5775,269,6315,7089,1892,5197,305591,248930,56661,0.4475,0.0098,25736,28070,31060,17220,18527,17466,26366,6258,22684,18611,12,111
"Glades County, Florida",13363,7303,6060,10627,1861,532,54,0,101,188,28,160,13363,10573,2790,0.4324,0.0302,21020,20402,23176,11952,11900,69312,,-666666666,17162,13720,12,043
"Hendry County, Florida",40127,21437,18690,32150,4621,773,324,0,1129,1130,175,955,40127,18908,21219,0.4736,0.0333,18900,19476,26113,14743,13871,41595,21847,-666666666,20347,5252,12,051
"Indian River County, Florida",150984,72290,78694,130147,13617,411,1949,58,1897,2905,156,2749,150984,132472,18512,0.5283,0.0180,35172,38184,40630,19466,14829,24301,33682,,12341,13581,12,061
"Jackson County, Florida",48472,26784,21688,33431,13140,312,155,58,364,1012,89,923,48472,46158,2314,0.4463,0.0207,18882,21700,22323,8809,12835,14774,19163,,3343,11943,12,063
"Palm Beach County, Florida",1446277,701207,745070,1070496,268489,2402,38879,592,35122,30297,6140,24157,1446277,1130261,316016,0.5221,0.0040,37998,43933,51321,21931,18715,26654,34514,25312,21906,23452,12,099
"St. Johns County, Florida",235503,114660,120843,208720,12731,852,6556,175,1465,5004,509,4495,235503,219754,15749,0.4655,0.0093,41393,43376,44297,28196,21901,27792,41180,14131,15252,19478,12,109
"Seminole County, Florida",455086,219935,235151,351484,53080,954,19964,312,14384,14908,2108,12800,455086,360918,94168,0.4600,0.0070,33419,36123,39161,22737,23804,29702,34037,16891,18513,18041,12,117
"Miami-Dade County, Florida",2715516,1318627,1396889,2041796,481976,4668,43289,751,100332,42704,13558,29146,2715516,869870,1845646,0.5249,0.0031,26838,29261,50332,24307,17158,22496,34681,30570,22225,23511,12,086
"Bay County, Florida",182482,90768,91714,148220,20018,1129,4113,55,2027,6920,338,6582,182482,171029,11453,0.4509,0.0101,28017,30173,30539,22310,19567,17450,21746,11102,15589,15519,12,005
"Flagler County, Florida",107139,51187,55952,88531,11328,167,2701,14,2339,2059,269,1790,107139,96311,10828,0.4240,0.0138,27689,29003,29932,19044,22937,23113,28562,,16752,9169,12,035
"Franklin County, Florida",11736,6714,5022,9476,1615,24,53,63,311,194,19,175,11736,11097,639,0.5018,0.0373,25037,28444,29404,6842,11059,,27634,,,14345,12,037
"Hamilton County, Florida",14269,8281,5988,8649,4923,83,22,0,369,223,20,203,14269,12937,1332,0.4713,0.0350,15097,19064,19746,8877,9606,8495,,-666666666,3747,4887,12,047
"Liberty County, Florida",8365,5110,3255,6750,1257,90,20,0,89,159,0,159,8365,7881,484,0.4288,0.0359,17197,19124,19974,4545,9566,2017,14315,-666666666,11866,7662,12,077
"Sumter County, Florida",120999,60725,60274,107444,9029,371,1086,44,1385,1640,432,1208,120999,114158,6841,0.4278,0.0146,33629,36389,37308,13244,11313,18580,18983,,7898,11387,12,119
"Gadsden County, Florida",46017,21785,24232,19100,25658,74,280,15,383,507,20,487,46017,41358,4659,0.4394,0.0161,20158,26324,28894,16400,15628,8531,33420,,14042,16461,12,039
"Holmes County, Florida",19430,10484,8946,17275,1330,216,151,71,76,311,23,288,19430,18897,533,0.4474,0.0209,18574,19599,19781,9541,7500,12895,15169,8875,,20739,12,059
"Lee County, Florida",718679,351918,366761,609126,61829,1330,11381,421,21706,12886,2460,10426,718679,569563,149116,0.4805,0.0072,31924,34141,38323,17272,17970,27154,32946,19155,18855,16097,12,071
"Marion County, Florida",348371,167211,181160,285189,43886,976,5349,268,3747,8956,1373,7583,348371,303980,44391,0.4481,0.0101,24570,25761,26999,17577,17038,15270,41889,24500,18839,16607,12,083
"Collier County, Florida",363922,179336,184586,320642,25356,1012,4508,21,7707,4676,636,4040,363922,263861,100061,0.5223,0.0083,43256,46488,57848,17335,15971,23684,37908,,16412,23276,12,021
"Orange County, Florida",1321194,648446,672748,844074,277193,2888,68133,1012,83429,44465,10712,33753,1321194,912870,408324,0.4868,0.0055,28859,33172,40330,19966,19532,19031,31730,15368,18394,21321,12,095
"Pasco County, Florida",510593,248572,262021,447358,28461,1789,12871,335,6877,12902,2209,10693,510593,436314,74279,0.4517,0.0061,27786,28219,29400,20914,24788,22504,35848,27851,20754,15803,12,101
"Highlands County, Florida",102101,49727,52374,81423,9380,248,1508,15,6997,2530,362,2168,102101,82096,20005,0.4803,0.0320,23722,25813,27578,13747,17472,14271,29700,,10101,14754,12,055
"Suwannee County, Florida",43924,22230,21694,36387,5788,66,59,32,337,1255,48,1207,43924,39962,3962,0.4715,0.0469,21755,23661,24712,11866,12718,1168,8227,,15566,12115,12,121
"DeSoto County, Florida",36399,20657,15742,30464,4420,86,194,46,687,502,131,371,36399,25047,11352,0.4526,0.0259,18311,19514,23163,12650,10780,42035,23700,8602,14911,11065,12,027
"Calhoun County, Florida",14444,8048,6396,11598,1812,157,117,0,300,460,36,424,14444,13607,837,0.4523,0.0498,18921,20792,21408,6412,9175,19307,18330,-666666666,7183,17821,12,013
"Columbia County, Florida",69105,35683,33422,53246,12256,220,625,60,701,1997,429,1568,69105,64985,4120,0.4695,0.0220,23901,26612,27262,14113,15096,23651,25351,,9893,10379,12,023
"Dixie County, Florida",16437,9218,7219,14240,1364,38,16,21,239,519,0,519,16437,15790,647,0.4751,0.0442,20527,22695,22923,10516,5036,,19006,,1907,10473,12,029
"Putnam County, Florida",72766,35841,36925,58172,11707,212,415,8,483,1769,148,1621,72766,65579,7187,0.4599,0.0174,19976,21903,22829,13158,11356,13770,20930,,20879,13993,12,107
"Union County, Florida",15239,9919,5320,11229,3335,111,85,4,197,278,10,268,15239,14399,840,0.4736,0.0854,15475,18670,19031,9498,6527,10095,26344,,3017,1636,12,125
"Manatee County, Florida",373853,180595,193258,319715,32349,965,7751,250,5790,7033,1006,6027,373853,313338,60515,0.4693,0.0086,32070,34182,37606,16518,17886,26345,32964,15473,15590,15248,12,081
"Levy County, Florida",39961,19364,20597,35008,3465,118,251,0,56,1063,79,984,39961,36692,3269,0.4544,0.0301,22025,22774,23714,13158,17421,28951,19275,-666666666,28146,11941,12,075
"Baker County, Florida",27785,14753,13032,23033,3810,67,206,9,262,398,0,398,27785,27111,674,0.4414,0.0366,24070,26478,26852,8158,12011,,16878,,17630,11797,12,003
"Volusia County, Florida",527634,257275,270359,434732,56984,2132,9351,168,13873,10394,1265,9129,527634,457052,70582,0.4617,0.0072,27272,29134,30710,17350,17325,21092,26830,70477,18083,17154,12,127
"Leon County, Florida",288102,136894,151208,177852,89444,578,10107,81,2725,7315,715,6600,288102,270052,18050,0.4894,0.0087,29754,35741,36743,22582,18465,19287,36041,28922,19324,18256,12,073
"Madison County, Florida",18474,9829,8645,10651,7158,70,194,2,272,127,23,104,18474,17508,966,0.4998,0.0338,19223,23920,24662,12024,12831,17604,7506,,15067,13254,12,079
"Escambia County, Florida",311522,154520,157002,212230,68361,1505,9886,406,3500,15634,1127,14507,311522,294229,17293,0.4383,0.0075,26730,31246,31590,21280,17138,29220,20770,28971,16984,13014,12,033
"Hernando County, Florida",182696,87747,94949,163329,9307,561,2316,25,2866,4292,495,3797,182696,159189,23507,0.4280,0.0113,24551,25226,26240,18181,19320,25783,30033,,16513,12609,12,053
"Calhoun County, Georgia",6428,3875,2553,2180,3919,0,34,0,214,81,16,65,6428,6129,299,0.4947,0.0484,13927,19614,20205,5401,11490,-666666666,,-666666666,5625,,13,037
"Macon County, Georgia",13480,7342,6138,4705,8171,27,63,1,342,171,5,166,13480,12911,569,0.4729,0.0321,15924,22887,24140,5237,12199,,67768,,5334,7005,13,193
"Bleckley County, Georgia",12775,5937,6838,8903,3590,9,28,0,226,19,0,19,12775,12415,360,0.4450,0.0309,18519,22721,22801,6743,9075,,,-666666666,,,13,023
"Bibb County, Georgia",153490,72065,81425,62851,83068,275,3019,63,1020,3194,427,2767,153490,148567,4923,0.5221,0.0137,24409,34611,35329,19090,17210,16328,31902,,11596,8884,13,021
"Marion County, Georgia",8484,4203,4281,5288,2576,14,89,36,371,110,0,110,8484,7881,603,0.4385,0.0379,22478,24001,23894,24036,20144,,,,19963,32211,13,197
"Schley County, Georgia",5211,2546,2665,3454,1558,0,0,0,150,49,3,46,5211,4943,268,0.4679,0.0367,20585,24489,24523,13798,13159,-666666666,-666666666,-666666666,9869,14296,13,249
"Dooly County, Georgia",13905,7529,6376,6277,6824,8,15,0,538,243,75,168,13905,12947,958,0.4669,0.0377,20259,27809,28712,12726,14318,,,-666666666,14621,3949,13,093
"Franklin County, Georgia",22514,10853,11661,19338,2150,16,198,0,505,307,2,305,22514,21511,1003,0.4927,0.0355,21686,22896,22786,20065,15576,,9286,-666666666,13331,9628,13,119
"Effingham County, Georgia",58689,29215,29474,48093,7955,75,552,24,664,1326,17,1309,58689,56206,2483,0.4263,0.0524,29795,31523,32152,18246,22157,30940,44642,,15001,13525,13,103
"Lamar County, Georgia",18513,8959,9554,12186,5392,19,149,0,149,618,0,618,18513,18075,438,0.4788,0.0308,20874,25300,25296,11749,13294,,13903,-666666666,6936,4406,13,171
"Emanuel County, Georgia",22499,11105,11394,13935,7698,11,63,0,332,460,43,417,22499,21496,1003,0.4680,0.0272,17981,21226,21631,11802,13090,,,-666666666,14613,6263,13,107
"Quitman County, Georgia",2276,1081,1195,882,1192,0,138,5,0,59,0,59,2276,2270,6,0.4580,0.0505,19371,21506,21654,,19055,-666666666,12382,,-666666666,5414,13,239
"Jasper County, Georgia",13784,6682,7102,10380,2881,8,36,0,343,136,0,136,13784,13245,539,0.4199,0.0231,19999,21193,21519,9090,17465,,19225,-666666666,11853,3396,13,159
"Johnson County, Georgia",9730,5318,4412,6281,3256,0,19,0,0,174,35,139,9730,9501,229,0.4361,0.0234,20773,24213,24858,3370,15022,-666666666,,-666666666,-666666666,,13,167
"Liberty County, Georgia",62108,31550,30558,28881,25503,285,1324,322,2039,3754,621,3133,62108,54263,7845,0.3993,0.0140,21430,22863,23588,18175,21329,18255,19516,14803,20054,13326,13,179
"Mitchell County, Georgia",22432,11683,10749,11106,10461,48,101,8,187,521,9,512,22432,21416,1016,0.4672,0.0492,17514,20915,22130,5931,14239,,8698,,10512,16186,13,205
"Seminole County, Georgia",8437,4027,4410,5215,2790,0,67,0,154,211,1,210,8437,8177,260,0.5647,0.0999,26358,26109,26090,8598,29424,-666666666,14931,-666666666,4158,11775,13,253
"Tift County, Georgia",40510,19509,21001,26243,12200,36,589,14,1037,391,27,364,40510,35849,4661,0.4615,0.0186,22072,26440,28506,12585,13413,27944,28646,,11264,15370,13,277
"Twiggs County, Georgia",8284,4068,4216,4605,3510,0,9,0,0,160,0,160,8284,8244,40,0.4918,0.0303,19465,20935,21074,,17934,-666666666,,-666666666,-666666666,10123,13,289
"Polk County, Georgia",41621,20415,21206,32159,5091,201,155,24,3071,920,0,920,41621,36158,5463,0.4879,0.0493,23233,24658,25701,11845,23432,,18266,,13515,10086,13,233
"Talbot County, Georgia",6378,3032,3346,2622,3687,2,33,0,9,25,0,25,6378,6330,48,0.4579,0.0389,20785,26914,26984,18708,16346,,16167,-666666666,,43316,13,263
"Taylor County, Georgia",8193,3946,4247,4692,3150,0,124,0,180,47,7,40,8193,7985,208,0.4630,0.0311,19068,23131,23131,7551,14599,-666666666,,-666666666,8726,,13,269
"Terrell County, Georgia",8859,4228,4631,3262,5272,10,203,0,44,68,2,66,8859,8617,242,0.4633,0.0237,19330,29069,28550,27059,13964,,7378,-666666666,25416,,13,273
"Thomas County, Georgia",44730,21219,23511,26869,16302,51,75,16,408,1009,36,973,44730,43079,1651,0.5078,0.0239,25542,32146,32891,13603,15946,11557,12283,,13329,11777,13,275
"Toombs County, Georgia",27048,12491,14557,16920,6968,4,247,0,2370,539,78,461,27048,23915,3133,0.5548,0.0857,23416,25631,26021,10678,23462,,30643,-666666666,10085,8729,13,279
"Wilkinson County, Georgia",9078,4349,4729,5355,3567,10,0,6,45,95,0,95,9078,8827,251,0.4885,0.0310,21403,24365,24670,16957,17581,9240,-666666666,,17907,2200,13,319
"Ben Hill County, Georgia",17154,8047,9107,10375,6286,0,18,9,277,189,22,167,17154,16112,1042,0.4607,0.0292,17563,20772,21820,11565,11650,-666666666,,,25502,28073,13,017
"Burke County, Georgia",22550,10697,11853,10934,10958,5,68,0,351,234,139,95,22550,21847,703,0.4486,0.0193,21334,28598,29047,14899,14339,,10122,-666666666,16667,19738,13,033
"Catoosa County, Georgia",66299,31991,34308,61318,1558,220,953,24,752,1474,27,1447,66299,64357,1942,0.4156,0.0183,26915,27574,27698,20057,23429,12077,18083,,20513,14552,13,047
"Chattahoochee County, Georgia",10767,7172,3595,7510,2263,37,391,35,193,338,52,286,10767,9114,1653,0.4753,0.1025,23651,24740,25573,19455,22169,9143,21827,19420,13653,19208,13,053
"Chattooga County, Georgia",24817,12865,11952,21407,2507,29,130,0,404,340,40,300,24817,23587,1230,0.4602,0.0348,18209,19722,20173,8802,8500,,20802,-666666666,9170,4618,13,055
"Columbia County, Georgia",147295,71970,75325,109501,24575,436,5995,0,1742,5046,330,4716,147295,137814,9481,0.4081,0.0120,32509,34210,35027,21140,28663,26207,34244,-666666666,16078,18489,13,073
"Decatur County, Georgia",26833,12907,13926,14060,11165,19,90,0,1295,204,22,182,26833,25256,1577,0.5091,0.0258,20397,26057,26705,9766,14527,,43458,-666666666,8082,19795,13,087
"Floyd County, Georgia",96824,46810,50014,75735,13861,177,1540,0,3551,1960,343,1617,96824,86402,10422,0.4768,0.0163,25058,27355,28692,13334,16288,15797,41174,-666666666,12719,8882,13,115
"Forsyth County, Georgia",219880,109258,110622,178874,7301,415,26049,95,2573,4573,630,3943,219880,199005,20875,0.4037,0.0076,41585,41625,43786,21278,34450,34780,47304,9626,26605,28525,13,117
"Habersham County, Georgia",44289,20962,23327,38359,1358,45,907,248,2414,958,33,925,44289,37888,6401,0.4307,0.0144,22018,23440,24636,11477,15572,13991,21962,5533,8911,11901,13,137
"Lowndes County, Georgia",114582,55959,58623,66261,41718,335,2114,91,1764,2299,148,2151,114582,108237,6345,0.5310,0.0222,23077,27449,28100,14645,16636,21702,37553,20046,9156,11648,13,185
"Meriwether County, Georgia",21113,10221,10892,12062,8169,30,132,0,297,423,12,411,21113,20664,449,0.4608,0.0292,20060,24556,24455,17308,15018,,12668,-666666666,2064,5399,13,199
"Monroe County, Georgia",27010,13600,13410,19829,6302,52,251,0,326,250,0,250,27010,26379,631,0.5408,0.0533,34669,35842,36249,18133,16429,,44225,-666666666,330887,11285,13,207
"Sumter County, Georgia",30352,14359,15993,12924,15974,23,359,0,582,490,85,405,30352,28708,1644,0.4792,0.0190,20191,27760,28727,12855,14560,17326,19669,-666666666,7854,19323,13,261
"Taliaferro County, Georgia",1665,847,818,568,1085,0,8,0,0,4,0,4,1665,1639,26,0.4814,0.0770,19897,21108,21617,7281,19483,-666666666,,-666666666,-666666666,,13,265
"Baker County, Georgia",3189,1521,1668,1810,1236,7,95,20,21,0,0,0,3189,3055,134,0.4744,0.0409,22864,26812,26645,27153,17129,,18439,,,-666666666,13,007
"Butts County, Georgia",23750,12661,11089,16289,6858,10,105,60,185,243,51,192,23750,22999,751,0.4747,0.0517,22360,26362,26247,26551,12687,,42770,,10757,30577,13,035
"Candler County, Georgia",10827,5363,5464,7355,2572,69,247,0,300,284,158,126,10827,9575,1252,0.5137,0.0518,18718,20794,22022,8811,16199,36633,6646,-666666666,8646,4536,13,043
"Carroll County, Georgia",116022,56448,59574,87288,21996,977,872,108,2549,2232,175,2057,116022,108179,7843,0.4466,0.0146,24155,26392,26978,16311,18824,11159,20643,37522,13125,8219,13,045
"Crawford County, Georgia",12344,6299,6045,9181,2978,0,25,0,21,139,26,113,12344,12184,160,0.4397,0.0294,21102,22693,22860,18237,15952,-666666666,,-666666666,,25182,13,079
"Crisp County, Georgia",22846,10849,11997,12104,9974,0,220,30,85,433,42,391,22846,22097,749,0.5504,0.0431,21581,29231,30135,14088,13162,-666666666,7343,,,7902,13,081
"Coweta County, Georgia",140516,68430,72086,107831,24730,307,2702,34,1591,3321,109,3212,140516,130954,9562,0.4278,0.0141,32542,35197,35707,27397,22968,14302,34439,,31591,17758,13,077
"Cobb County, Georgia",745057,360270,384787,441978,203874,1737,39150,472,35405,22441,3727,18714,745057,649438,95619,0.4518,0.0053,38268,44603,47376,20302,29036,26859,43823,20257,16921,22597,13,067
"Dade County, Georgia",16227,7932,8295,15407,103,0,268,24,37,388,31,357,16227,15867,360,0.4495,0.0268,24028,24401,24436,12695,8543,-666666666,30274,,7200,12068,13,083
"Walton County, Georgia",90132,43775,46357,70380,15327,178,1064,17,1698,1468,250,1218,90132,86348,3784,0.4277,0.0130,26545,29219,29702,14851,16717,18610,16592,22888,21393,15131,13,297
"Brooks County, Georgia",15622,7608,8014,9618,5358,0,128,7,133,378,0,378,15622,14726,896,0.5321,0.0412,23421,26114,27764,8862,19837,-666666666,11702,,22639,10409,13,027
"Dodge County, Georgia",20919,10972,9947,14102,5868,2,79,0,282,586,0,586,20919,20195,724,0.4665,0.0256,18921,23212,23532,14806,9851,,,-666666666,17127,9140,13,091
"Elbert County, Georgia",19212,9188,10024,13085,5889,0,42,0,106,90,0,90,19212,18137,1075,0.4838,0.0402,22593,25400,26495,10231,16902,-666666666,,-666666666,,10132,13,105
"Fayette County, Georgia",111369,54055,57314,75542,24316,276,5034,118,2481,3602,605,2997,111369,103388,7981,0.4337,0.0137,42126,45826,46934,25612,37823,18016,35374,20132,20525,20461,13,113
"Jenkins County, Georgia",8827,4055,4772,5363,2955,127,109,0,201,72,0,72,8827,8080,747,0.4413,0.0464,16089,19356,20341,7364,11731,,11533,-666666666,,,13,165
"Newton County, Georgia",106497,50598,55899,54326,46869,323,1145,84,1002,2748,417,2331,106497,100764,5733,0.4384,0.0192,24426,27215,27988,14822,22037,16306,29091,,17560,11376,13,217
"Pickens County, Georgia",30832,15233,15599,27688,409,225,136,13,107,2254,0,2254,30832,29887,945,0.4275,0.0263,30567,31348,31403,27625,23985,37438,21204,,19656,22494,13,227
"Colquitt County, Georgia",45606,22554,23052,29397,10491,246,385,9,4227,851,313,538,45606,36944,8662,0.4732,0.0187,19173,22858,24442,11565,12944,7147,13037,,11105,15117,13,071
"Dawson County, Georgia",23861,11774,12087,22979,230,12,148,0,105,387,55,332,23861,22819,1042,0.4358,0.0266,32646,33198,33939,14103,20889,,30501,-666666666,13290,12704,13,085
"Clayton County, Georgia",278666,130748,147918,47590,192765,571,14586,127,15787,7240,1211,6029,278666,241963,36703,0.4175,0.0111,20419,21520,25859,13966,21005,15186,20976,,13337,12662,13,063
"Hall County, Georgia",195961,97518,98443,166426,14540,472,3348,35,6857,4283,679,3604,195961,140808,55153,0.4486,0.0094,27625,29317,34958,14816,18237,26960,27555,,15442,13517,13,139
"Heard County, Georgia",11677,5747,5930,10145,1085,2,58,20,37,330,40,290,11677,11365,312,0.4098,0.0265,21796,22716,23125,7417,18354,,18086,,,6230,13,149
"Hancock County, Georgia",8535,5193,3342,2094,6178,0,74,14,122,53,0,53,8535,8371,164,0.4923,0.0577,16713,33155,33248,4629,11784,-666666666,3326,,,,13,141
"McDuffie County, Georgia",21498,9999,11499,11746,8692,0,97,195,407,361,9,352,21498,20861,637,0.4714,0.0284,21384,25625,25904,10592,17038,-666666666,53061,,6923,4134,13,189
"Morgan County, Georgia",18235,8783,9452,13482,4258,37,5,0,191,262,1,261,18235,17648,587,0.4544,0.0280,30587,34655,35324,12773,19301,,,-666666666,9505,24416,13,211
"Dougherty County, Georgia",91049,42144,48905,24556,62847,194,849,38,1064,1501,18,1483,91049,88562,2487,0.4948,0.0132,21180,35106,35786,16701,16003,22449,25478,14937,14583,12338,13,095
"Fannin County, Georgia",24925,12086,12839,24160,79,88,165,28,78,327,3,324,24925,24360,565,0.4519,0.0281,26665,27081,27290,17413,7487,12507,11009,,15888,15980,13,111
"Houston County, Georgia",151682,73756,77926,92943,46232,629,4392,13,1898,5575,1007,4568,151682,141706,9976,0.4368,0.0134,28196,31867,32735,19819,22821,15015,29810,,21134,14154,13,153
"Laurens County, Georgia",47418,22497,24921,28020,17645,44,535,7,822,345,57,288,47418,46177,1241,0.4952,0.0163,20655,24048,24111,19641,15576,,31922,,12242,9459,13,175
"Spalding County, Georgia",64719,31395,33324,40745,21697,282,627,19,292,1057,66,991,64719,61859,2860,0.4503,0.0213,22166,26625,27340,15894,13770,26501,40206,,15024,13111,13,255
"Telfair County, Georgia",16115,9346,6769,8651,6725,9,17,0,604,109,23,86,16115,14222,1893,0.4343,0.0307,15200,19369,21084,1189,10770,,,-666666666,,30125,13,271
"Union County, Georgia",22775,11048,11727,22076,148,151,173,0,25,202,21,181,22775,22047,728,0.4698,0.0344,27282,27623,28081,13824,17945,,26412,-666666666,,9043,13,291
"Washington County, Georgia",20461,10361,10100,9123,10845,10,124,0,106,253,11,242,20461,19965,496,0.4620,0.0250,19579,26615,27516,7047,13843,,34337,-666666666,8583,9872,13,303
"White County, Georgia",28928,14128,14800,27274,417,162,169,1,366,539,293,246,28928,28019,909,0.4260,0.0302,25617,26473,26588,14573,13517,24472,13702,,,9840,13,311
"Paulding County, Georgia",155840,76195,79645,117516,29448,468,1570,61,2617,4160,455,3705,155840,146349,9491,0.3858,0.0137,27855,29843,29785,23725,22978,22701,24852,,17957,14424,13,223
"Pike County, Georgia",18082,8876,9206,15903,1811,0,69,0,74,225,0,225,18082,17803,279,0.4545,0.0363,26737,28011,28196,11828,15329,-666666666,77645,-666666666,13524,17269,13,231
"Richmond County, Georgia",201463,97272,104191,76073,113881,515,3762,436,2137,4659,468,4191,201463,191704,9759,0.4761,0.0130,22045,28624,29340,17601,17816,13360,24616,21161,19936,17950,13,245
"Tattnall County, Georgia",25353,14888,10465,15157,7403,85,63,5,2169,471,270,201,25353,22574,2779,0.4679,0.0237,17553,23474,23710,10199,8434,8506,18697,,9982,6874,13,267
"Berrien County, Georgia",19025,9299,9726,16067,2273,91,34,0,233,327,32,295,19025,18100,925,0.4471,0.0208,18611,20044,20175,12539,11756,8235,22365,-666666666,12871,2466,13,019
"Walker County, Georgia",68824,34082,34742,63382,2817,109,518,9,476,1513,362,1151,68824,67385,1439,0.4598,0.0180,23311,24020,24078,12770,16774,28923,24871,,10907,8857,13,295
"Gwinnett County, Georgia",902298,441051,461247,448155,245748,3509,102858,269,74969,26790,4737,22053,902298,713690,188608,0.4300,0.0048,29474,35173,40281,16793,26319,16238,26445,19436,15066,16862,13,135
"Barrow County, Georgia",76887,37771,39116,61173,8841,134,2811,6,2167,1755,278,1477,76887,68875,8012,0.3943,0.0134,23638,25078,25901,18021,19035,22958,15722,30500,20854,12755,13,013
"Charlton County, Georgia",12983,7522,5461,8684,3358,245,107,16,236,337,68,269,12983,11880,1103,0.4360,0.0234,19341,22262,22973,15422,14160,6767,9144,,20286,7840,13,049
"Clinch County, Georgia",6743,3427,3316,4439,1862,4,29,0,313,96,2,94,6743,6398,345,0.5444,0.0398,16538,19892,20017,3097,11641,,,-666666666,3142,5455,13,065
"Bartow County, Georgia",103620,51332,52288,87027,11113,258,1032,2,2202,1986,337,1649,103620,94989,8631,0.4303,0.0165,25712,26834,27812,14146,20639,21256,29305,,13899,16770,13,015
"Douglas County, Georgia",141840,67726,74114,67261,65482,168,2253,1,3632,3043,366,2677,141840,128469,13371,0.4071,0.0114,26621,28419,30264,14845,25126,17929,36459,,17894,22643,13,097
"Grady County, Georgia",24926,12176,12750,16529,7163,133,141,91,222,647,10,637,24926,22152,2774,0.4705,0.0263,22442,24904,27471,8536,16555,23604,38947,,10292,15246,13,131
"Jeff Davis County, Georgia",14991,7408,7583,11392,2465,0,39,0,768,327,239,88,14991,13237,1754,0.4429,0.0363,18042,19452,20146,9786,13487,-666666666,,-666666666,11992,5487,13,161
"Montgomery County, Georgia",9036,4633,4403,6156,2374,20,32,0,392,62,3,59,9036,8447,589,0.5234,0.0758,22317,27368,28079,10336,12130,,,-666666666,8413,13227,13,209
"Oglethorpe County, Georgia",14784,7396,7388,11610,2623,24,64,0,229,234,6,228,14784,14137,647,0.4137,0.0203,23027,24718,25178,10630,17536,20033,18080,-666666666,8072,17005,13,221
"Randolph County, Georgia",7087,3493,3594,2492,4406,0,0,0,78,111,0,111,7087,6991,96,0.5508,0.1086,19356,28488,28653,7953,14856,-666666666,-666666666,-666666666,,,13,243
"Rockdale County, Georgia",89011,41944,47067,35556,47414,112,1743,319,1512,2355,287,2068,89011,79973,9038,0.4209,0.0111,26367,29247,32302,14887,25386,51470,27615,,13782,11869,13,247
"Ware County, Georgia",35599,17753,17846,22986,10621,178,403,33,899,479,24,455,35599,34139,1460,0.4574,0.0235,20457,23954,24055,16058,14322,9759,11811,,17454,5352,13,299
"Wayne County, Georgia",29767,15051,14716,22340,5935,44,141,0,513,794,166,628,29767,27914,1853,0.4679,0.0279,21067,23770,24468,8902,12385,,27352,-666666666,13429,14704,13,305
"Wheeler County, Georgia",7939,5007,2932,4516,3379,36,0,0,0,8,0,8,7939,7838,101,0.4435,0.0315,12292,16175,16412,,7237,,-666666666,-666666666,-666666666,,13,309
"Wilcox County, Georgia",8846,5242,3604,5556,3122,26,0,0,75,67,0,67,8846,8447,399,0.4481,0.0363,14829,19801,20580,14133,5779,12812,-666666666,-666666666,31833,5925,13,315
"Baldwin County, Georgia",45286,22759,22527,24371,19060,140,690,0,352,673,88,585,45286,44289,997,0.4897,0.0269,20305,24483,24666,12270,15012,34940,32577,-666666666,5676,10919,13,009
"Bulloch County, Georgia",74782,36777,38005,49030,21072,260,1054,186,950,2230,419,1811,74782,71888,2894,0.4773,0.0150,21207,24664,24907,12243,14951,1967,35961,,8791,6190,13,031
"Clarke County, Georgia",124602,59248,65354,78342,34354,168,5048,83,3320,3287,240,3047,124602,111330,13272,0.5271,0.0124,22589,26448,28349,12010,16587,30965,15757,21361,10370,15767,13,059
"Echols County, Georgia",3994,1973,2021,2946,143,82,0,0,662,161,75,86,3994,3010,984,0.5039,0.0609,22883,20734,21586,12751,120927,16921,-666666666,-666666666,12847,19437,13,101
"Glynn County, Georgia",83974,39419,44555,57000,21957,360,1076,57,1481,2043,263,1780,83974,78396,5578,0.5042,0.0215,31493,37979,39529,15958,17671,13538,22211,52277,16748,17233,13,127
"Haralson County, Georgia",28956,14041,14915,26752,1347,91,219,0,56,491,48,443,28956,28501,455,0.4509,0.0307,24444,24690,24555,30602,20876,83745,36255,-666666666,,6931,13,143
"Jefferson County, Georgia",15772,7605,8167,6826,8515,20,18,0,273,120,62,58,15772,15196,576,0.4742,0.0349,18764,24020,24504,8295,14982,19375,,-666666666,5792,19304,13,163
"Jones County, Georgia",28548,13874,14674,20790,7082,56,213,0,10,397,13,384,28548,28103,445,0.4248,0.0253,25725,27605,27379,41535,20405,29230,20893,-666666666,,23999,13,169
"Murray County, Georgia",39557,19522,20035,38261,424,46,152,0,340,334,0,334,39557,33720,5837,0.4054,0.0236,20618,20809,22005,13484,14896,23261,20703,-666666666,11752,14530,13,213
"Muscogee County, Georgia",196670,96279,100391,86552,90001,811,4817,329,5471,8689,1837,6852,196670,181812,14858,0.4916,0.0104,25318,32481,33282,19295,19620,29344,32160,23227,17159,14047,13,215
"Rabun County, Georgia",16457,8107,8350,15119,393,91,170,1,544,139,25,114,16457,15126,1331,0.5261,0.0451,28312,29989,29468,27484,9700,,10391,,7000,16389,13,241
"Stewart County, Georgia",6042,3894,2148,1590,3269,14,148,0,874,147,83,64,6042,5002,1040,0.5029,0.0368,16359,29501,29617,11428,12294,,10522,-666666666,8513,18105,13,259
"Treutlen County, Georgia",6777,3573,3204,4900,1840,0,0,0,15,22,0,22,6777,6655,122,0.5227,0.0672,23907,24391,24595,12089,22694,-666666666,-666666666,-666666666,,31073,13,283
"Irwin County, Georgia",9268,4758,4510,6318,2759,13,36,0,22,120,22,98,9268,9133,135,0.4842,0.0384,18406,21573,21569,20725,11922,,10131,-666666666,,,13,155
"Atkinson County, Georgia",8265,4208,4057,5967,1484,60,0,0,725,29,27,2,8265,6234,2031,0.4765,0.0513,18565,20944,23956,8754,15487,4208,-666666666,-666666666,7088,3397,13,003
"Bacon County, Georgia",11228,5564,5664,9073,1714,0,30,25,88,298,69,229,11228,10288,940,0.4588,0.0485,19634,21733,23040,9317,11190,-666666666,12167,,16498,7626,13,005
"Brantley County, Georgia",18561,9103,9458,17399,655,35,183,3,14,272,49,223,18561,18169,392,0.4420,0.0265,18904,18962,19073,9240,15067,,,,7393,6592,13,025
"Washington County, Idaho",10025,4966,5059,8693,17,96,47,0,840,332,95,237,10025,8307,1718,0.4448,0.0288,21414,22420,23381,14083,,12077,26289,-666666666,15647,12736,16,087
"Cassia County, Idaho",23615,12039,11576,21998,46,281,138,24,844,284,38,246,23615,17198,6417,0.4133,0.0211,21547,21719,24483,15059,9707,11958,14399,12671,23632,17699,16,031
"Gem County, Idaho",17052,8354,8698,15358,0,322,114,2,807,449,39,410,17052,15634,1418,0.4184,0.0320,20776,21706,21951,11862,-666666666,14568,11810,,13620,8608,16,045
"Valley County, Idaho",10401,5486,4915,10285,9,26,24,0,1,56,0,56,10401,10211,190,0.4714,0.0625,30838,30939,31172,17842,,,56321,-666666666,,9995,16,085
"Adams County, Idaho",4019,2093,1926,3852,11,50,0,8,4,94,0,94,4019,3878,141,0.4228,0.0305,25143,25665,26087,13800,,22434,-666666666,,,8118,16,003
"Nez Perce County, Idaho",40155,19758,20397,36020,104,2449,320,41,144,1077,45,1032,40155,38608,1547,0.4138,0.0142,27753,29093,29235,19515,37007,17269,14501,,15194,12157,16,069
"Kootenai County, Idaho",153605,75890,77715,144715,610,2170,1219,229,726,3936,331,3605,153605,146687,6918,0.4420,0.0131,29429,29956,30223,22106,12982,24110,21564,11090,50749,15121,16,055
"Lewis County, Idaho",3845,1911,1934,3352,9,280,54,1,27,122,23,99,3845,3674,171,0.4586,0.0307,24052,25567,25963,13215,,9325,23522,,14604,19105,16,061
"Butte County, Idaho",2602,1342,1260,2581,4,1,0,0,16,0,0,0,2602,2531,71,0.4672,0.0364,25941,25824,26196,18286,,,-666666666,-666666666,,-666666666,16,023
"Twin Falls County, Idaho",83666,41204,42462,76995,591,773,1512,68,2374,1353,112,1241,83666,70164,13502,0.4312,0.0226,24222,24660,26012,17424,10149,20045,16831,18381,27113,11268,16,083
"Owyhee County, Idaho",11455,5874,5581,9483,50,369,18,0,1145,390,153,237,11455,8407,3048,0.4761,0.0404,21935,23807,26825,10668,,15320,21289,-666666666,11523,16047,16,073
"Boise County, Idaho",7163,3780,3383,6769,16,81,84,5,13,195,5,190,7163,6853,310,0.4139,0.0281,30660,30841,31226,31706,,30777,53154,,,17319,16,015
"Caribou County, Idaho",6918,3543,3375,6611,0,12,7,0,131,157,1,156,6918,6531,387,0.4100,0.0301,26908,27422,27820,18288,-666666666,,,-666666666,20998,13166,16,029
"Ada County, Idaho",446052,223367,222685,404644,6204,2525,11956,908,6445,13370,1348,12022,446052,410214,35838,0.4659,0.0086,33352,34127,35148,21034,20360,28514,28248,36599,31762,21960,16,001
"Bannock County, Idaho",85065,42300,42765,76402,568,2552,1405,174,1271,2693,350,2343,85065,77874,7191,0.4473,0.0199,24555,25236,25831,15665,15885,13284,19516,9110,42621,12863,16,005
"Bingham County, Idaho",45551,22746,22805,37653,122,2969,348,2,3052,1405,271,1134,45551,37365,8186,0.3951,0.0150,21322,22815,23796,14101,,12624,23791,,15561,13379,16,011
"Camas County, Idaho",886,433,453,884,0,0,0,0,0,2,0,2,886,878,8,0.5543,0.0482,30803,30808,30951,,-666666666,-666666666,-666666666,-666666666,-666666666,,16,025
"Canyon County, Idaho",212230,104902,107328,180454,715,2425,1839,497,18536,7764,2236,5528,212230,158873,53357,0.4100,0.0105,20807,21951,23602,13618,12311,17253,21594,16682,14186,12001,16,027
"Jefferson County, Idaho",27969,14295,13674,25759,24,158,142,14,1307,565,128,437,27969,25028,2941,0.3723,0.0196,22934,23740,24492,11468,,23073,,24200,12219,10877,16,051
"Latah County, Idaho",39239,19894,19345,35993,386,469,1010,10,340,1031,35,996,39239,37549,1690,0.4688,0.0149,25623,26809,27273,11909,20051,15837,9973,,11289,10652,16,057
"Payette County, Idaho",23041,11470,11571,20919,78,157,175,0,907,805,147,658,23041,19078,3963,0.4321,0.0257,25002,25933,27467,16093,,15978,9288,-666666666,20019,12930,16,075
"Benewah County, Idaho",9086,4607,4479,7893,6,867,32,22,10,256,0,256,9086,8765,321,0.4253,0.0286,23502,24999,25351,8298,,11152,72591,13045,,13974,16,009
"Clark County, Idaho",1077,570,507,912,7,96,0,0,48,14,10,4,1077,572,505,0.3549,0.0354,16181,17161,22195,11556,,10888,-666666666,-666666666,10525,,16,033
"Elmore County, Idaho",26433,13858,12575,22911,687,372,687,132,617,1027,67,960,26433,22027,4406,0.4138,0.0300,23547,24142,26050,14367,27505,18053,30645,22094,18373,8166,16,039
"Fremont County, Idaho",12965,6766,6199,12253,40,39,19,41,278,295,45,250,12965,11337,1628,0.3859,0.0353,21782,22248,23753,10412,4403,,,8902,12838,17919,16,043
"Shoshone County, Idaho",12526,6267,6259,11743,55,325,28,0,48,327,39,288,12526,12087,439,0.4508,0.0501,24204,24775,25078,17983,28716,9567,12450,-666666666,64327,12592,16,079
"Idaho County, Idaho",16337,8537,7800,15256,33,577,80,12,90,289,73,216,16337,15797,540,0.4223,0.0210,21584,21949,21913,20329,5712,14823,13598,,24177,19774,16,049
"Hawaii County, Hawaii",197658,98276,99382,66145,1342,849,44504,24600,3515,56703,958,55745,197658,172644,25014,0.4742,0.0139,29253,39283,40986,16258,29192,32551,32029,20711,19010,19667,15,001
"Maui County, Hawaii",165281,82437,82844,58707,968,236,48190,18272,2257,36651,831,35820,165281,146699,18582,0.4430,0.0117,33792,46842,50405,21462,23704,38095,31198,22068,28179,22728,15,009
"Kauai County, Hawaii",71377,35375,36002,23219,482,392,24275,6436,408,16165,337,15828,71377,63575,7802,0.4206,0.0133,31674,41800,43616,20119,37603,30890,31538,22223,19542,21242,15,007
"Kalawao County, Hawaii",75,38,37,16,2,2,21,19,0,15,0,15,75,73,2,0.3589,0.0755,47709,58144,58144,,,,34490,52037,-666666666,39993,15,005
"Jersey County, Illinois",22069,10841,11228,21350,105,23,47,0,31,513,57,456,22069,21767,302,0.4090,0.0152,28924,29447,29538,22902,8575,,11321,-666666666,52535,11715,17,083
"Putnam County, Illinois",5746,2959,2787,5572,34,0,25,0,20,95,10,85,5746,5438,308,0.4115,0.0332,34144,34527,34165,40245,6609,-666666666,18844,-666666666,33440,25726,17,155
"De Witt County, Illinois",16042,8015,8027,15425,76,13,4,10,196,318,0,318,16042,15612,430,0.4021,0.0226,29402,30012,30373,7894,5092,33662,24325,28130,9298,17928,17,039
"Fayette County, Illinois",21724,11580,10144,20354,1043,49,107,0,43,128,29,99,21724,21316,408,0.4366,0.0201,22260,23303,23674,3948,2490,38422,22297,-666666666,,12739,17,051
"Lee County, Illinois",34527,18326,16201,31228,1769,92,210,62,422,744,285,459,34527,32450,2077,0.4344,0.0173,29249,31033,31951,10983,5786,28965,55197,73602,14374,7594,17,103
"Logan County, Illinois",29207,14183,15024,25806,1849,44,218,2,299,989,72,917,29207,28207,1000,0.4073,0.0161,27187,29852,30135,11207,1883,13100,22317,,4613,13508,17,107
"Macoupin County, Illinois",45719,22602,23117,44291,422,82,213,3,100,608,45,563,45719,45183,536,0.4213,0.0127,28050,28424,28447,18155,18417,10732,29083,,10539,12497,17,117
"Richland County, Illinois",15881,7809,8072,15311,141,52,162,0,90,125,9,116,15881,15617,264,0.4361,0.0194,26038,26518,26740,10105,5204,17410,16409,-666666666,,10924,17,159
"Saline County, Illinois",24231,11962,12269,22485,683,40,187,47,96,693,16,677,24231,23801,430,0.4732,0.0224,23690,24768,24863,14409,12509,,10552,12200,7747,6418,17,165
"Washington County, Illinois",14155,7108,7047,13683,117,18,34,8,100,195,24,171,14155,13954,201,0.4220,0.0301,32394,32926,33039,18553,27175,,34041,,11543,11609,17,189
"Montgomery County, Illinois",29009,15145,13864,27074,1458,45,32,13,97,290,30,260,29009,28505,504,0.4325,0.0179,24816,26130,26254,15293,3028,44016,38534,,10056,12658,17,135
"Whiteside County, Illinois",56396,27799,28597,52677,986,76,312,44,1131,1170,274,896,56396,49709,6687,0.4306,0.0163,29167,29670,30903,17568,14783,21783,53307,,27406,14219,17,195
"Adams County, Illinois",66427,32481,33946,61819,2712,278,540,42,109,927,43,884,66427,65406,1021,0.4548,0.0153,29347,30198,30371,16722,16887,14226,40071,,9910,9360,17,001
"Clinton County, Illinois",37628,19551,18077,35227,1311,104,220,0,219,547,113,434,37628,36462,1166,0.4191,0.0207,31240,32388,32827,16735,11295,18038,29517,-666666666,34014,7191,17,027
"DeKalb County, Illinois",104200,51580,52620,87832,8033,62,2580,0,3213,2480,203,2277,104200,92778,11422,0.4353,0.0103,28073,30535,31528,17843,13781,11245,22550,-666666666,15113,10123,17,037
"Edwards County, Illinois",6507,3231,3276,6313,45,34,24,0,0,91,0,91,6507,6417,90,0.4141,0.0257,26908,27538,27627,3351,,,24479,-666666666,-666666666,7091,17,047
"Jasper County, Illinois",9598,4809,4789,9347,97,16,4,0,35,99,8,91,9598,9574,24,0.4112,0.0250,25536,25587,25619,29225,8194,96344,,-666666666,68397,11620,17,079
"Jefferson County, Illinois",38169,19567,18602,33448,3201,44,449,0,94,933,49,884,38169,37200,969,0.4579,0.0167,25770,26890,27295,8134,14828,25525,57519,-666666666,12460,9198,17,081
"Will County, Illinois",688697,341816,346881,505669,77224,1892,36761,217,46671,20263,4057,16206,688697,571175,117522,0.4111,0.0050,35259,38142,40416,20874,27734,24406,43105,31069,19674,14732,17,197
"Williamson County, Illinois",67299,33607,33692,61474,2843,164,744,7,488,1579,132,1447,67299,65550,1749,0.4456,0.0155,26756,27351,27562,14827,21914,26539,37351,,11303,12224,17,199
"Douglas County, Illinois",19714,9748,9966,18989,105,110,144,18,134,214,60,154,19714,18290,1424,0.4355,0.0305,27871,28340,28977,18144,3064,9031,25510,,34360,5930,17,041
"Fulton County, Illinois",35418,18496,16922,33391,1317,116,49,23,120,402,23,379,35418,34375,1043,0.4330,0.0159,25538,26416,26807,13368,6157,49750,13798,,30822,9936,17,057
"Greene County, Illinois",13218,6668,6550,12817,194,40,25,0,3,139,6,133,13218,13132,86,0.4345,0.0326,23946,24419,24536,3512,2002,31568,,-666666666,,11844,17,061
"Hardin County, Illinois",4009,1976,2033,3826,112,11,1,0,14,45,22,23,4009,3940,69,0.5009,0.0872,25795,26915,27084,6596,846,,,-666666666,,,17,069
"Henry County, Illinois",49464,24536,24928,46523,856,102,274,0,906,803,54,749,49464,46691,2773,0.4212,0.0122,29014,29988,30295,18117,11865,27630,15441,-666666666,10992,15998,17,073
"Knox County, Illinois",50999,25743,25256,43826,4570,162,509,0,981,951,113,838,50999,48124,2875,0.4519,0.0151,24681,26921,27447,12356,9363,20893,24445,-666666666,11817,9127,17,095
"Lake County, Illinois",703619,351343,352276,543635,47489,1760,53001,397,38273,19064,3722,15342,703619,553029,150590,0.4870,0.0043,44287,48315,55397,18936,26642,22390,47087,42634,19350,17721,17,097
"Massac County, Illinois",14430,6794,7636,13127,901,7,22,0,0,373,44,329,14430,14026,404,0.4359,0.0280,23768,24525,24800,13799,18634,,,-666666666,-666666666,10209,17,127
"Scott County, Illinois",5047,2460,2587,4956,8,15,9,10,5,44,11,33,5047,4985,62,0.4337,0.0374,27218,27488,27774,4298,,,,,,6205,17,171
"Cass County, Illinois",12665,6353,6312,11382,590,17,47,44,435,150,50,100,12665,10291,2374,0.4215,0.0266,26245,27409,30366,13435,13845,,24640,,21680,8209,17,017
"LaSalle County, Illinois",110401,55400,55001,102932,2787,266,860,21,1823,1712,268,1444,110401,99928,10473,0.4307,0.0098,29093,30194,31271,17865,10723,9280,19192,,19717,10729,17,099
"Hancock County, Illinois",18112,9008,9104,17645,148,3,69,0,19,228,20,208,18112,17844,268,0.4120,0.0173,26880,27236,27486,7317,12145,,22225,-666666666,26011,10531,17,067
"Grundy County, Illinois",50509,25241,25268,47316,735,35,411,17,1197,798,135,663,50509,45632,4877,0.3925,0.0124,33308,34132,35215,18663,20527,31774,48370,,17782,12495,17,063
"Kankakee County, Illinois",111061,54615,56446,88554,16716,230,1054,22,2336,2149,254,1895,111061,99744,11317,0.4326,0.0086,27164,29835,31198,15801,15997,13647,48233,,13557,10032,17,091
"DuPage County, Illinois",931743,457178,474565,721721,44287,2037,108727,426,29750,24795,4787,20008,931743,799739,132004,0.4530,0.0033,43982,46817,50393,22234,29855,22535,43017,28047,20852,20741,17,043
"Sangamon County, Illinois",197661,94876,102785,161828,25260,230,3868,96,1290,5089,181,4908,197661,193212,4449,0.4627,0.0087,34548,38053,38120,26692,16926,23754,40668,41559,16256,10899,17,167
"Menard County, Illinois",12367,6043,6324,12017,58,16,65,38,9,164,0,164,12367,12182,185,0.4011,0.0250,34495,34812,35052,19505,18419,,54051,,,20996,17,129
"Stephenson County, Illinois",45433,21986,23447,39059,4469,52,366,0,203,1284,39,1245,45433,43708,1725,0.4446,0.0161,27453,29127,29778,11695,16905,,47269,-666666666,18493,9427,17,177
"Cook County, Illinois",5223719,2534640,2689079,2957561,1230494,14583,376115,1909,508792,134265,35564,98701,5223719,3909487,1314232,0.5069,0.0021,35575,44156,51983,19352,22577,25767,39779,32312,17616,23050,17,031
"Ogle County, Illinois",51328,25614,25714,48328,501,178,292,23,1169,837,57,780,51328,46220,5108,0.4099,0.0136,30595,31251,32255,18043,22157,14707,18729,,18788,22145,17,141
"Morgan County, Illinois",34426,17298,17128,31072,2369,73,261,1,47,603,58,545,34426,33610,816,0.4355,0.0156,26295,27854,28308,6406,12158,12927,17947,,3764,8541,17,137
"White County, Illinois",14025,6882,7143,13729,101,11,51,4,2,127,0,127,14025,13827,198,0.4198,0.0244,25859,25981,26203,10029,18196,18645,41486,,,13926,17,193
"Woodford County, Illinois",38817,19343,19474,37567,250,14,204,0,143,639,62,577,38817,38122,695,0.4220,0.0223,35104,35652,35684,28264,16479,24407,32120,-666666666,27564,13044,17,203
"Henderson County, Illinois",6884,3369,3515,6730,5,16,48,0,0,85,7,78,6884,6767,117,0.4066,0.0517,28401,28653,28924,15065,,,9298,-666666666,-666666666,20972,17,071
"McHenry County, Illinois",307789,153382,154407,284366,4473,298,8338,69,4557,5688,600,5088,307789,268463,39326,0.4062,0.0072,38047,38904,41199,21468,24423,30699,39929,,21446,16774,17,111
"McLean County, Illinois",173219,84245,88974,143774,14618,296,8910,13,1691,3917,473,3444,173219,164879,8340,0.4645,0.0098,33665,35027,35789,17230,18519,31936,46579,,23060,15572,17,113
"Perry County, Illinois",21384,11767,9617,18870,1918,22,130,0,116,328,29,299,21384,20727,657,0.4686,0.0421,24511,27084,27699,5893,1772,,26080,-666666666,27846,8683,17,145
"Pike County, Illinois",15754,7815,7939,15249,243,43,43,0,36,140,3,137,15754,15559,195,0.4355,0.0130,24162,24695,24874,8033,4815,13681,17221,-666666666,7664,9264,17,149
"Rock Island County, Illinois",145275,71596,73679,117544,14645,474,3715,58,3358,5481,1248,4233,145275,126816,18459,0.4353,0.0110,28595,31005,32673,17494,18255,28939,23844,60778,18725,13421,17,161
"St. Clair County, Illinois",263463,127237,136226,168903,79351,444,3751,62,3694,7258,482,6776,263463,252956,10507,0.4706,0.0102,29541,35240,35697,21344,19077,30645,32065,42073,21322,14026,17,163
"Wabash County, Illinois",11573,5666,5907,11133,93,14,119,0,22,192,64,128,11573,11302,271,0.4286,0.0346,26850,27294,27149,30176,15631,,20127,-666666666,,6699,17,185
"Calhoun County, Illinois",4858,2435,2423,4742,17,1,41,0,1,56,19,37,4858,4801,57,0.4284,0.0302,27314,27514,27671,2361,4247,,,-666666666,,,17,013
"Cumberland County, Illinois",10865,5455,5410,10580,9,22,30,14,48,162,0,162,10865,10751,114,0.3961,0.0210,25622,25959,26107,9700,,32855,19837,,25317,7425,17,035
"Jo Daviess County, Illinois",21834,10956,10878,21211,110,57,95,12,69,280,52,228,21834,21186,648,0.4355,0.0344,32710,33218,33580,16584,20165,37686,24766,,12778,6625,17,085
"Kane County, Illinois",530839,264211,266628,385578,29259,2419,21261,199,78054,14069,3762,10307,530839,362454,168385,0.4425,0.0065,34924,40139,45923,17139,23295,18598,39575,20107,16120,16490,17,089
"Lawrence County, Illinois",16189,8919,7270,14092,1445,39,43,0,167,403,28,375,16189,15573,616,0.4030,0.0150,22099,24505,25089,8613,1542,4877,17495,-666666666,8810,19313,17,101
"Brown County, Illinois",6675,4238,2437,5168,1364,6,37,0,34,66,2,64,6675,6389,286,0.3869,0.0277,22279,28023,28825,9198,1448,,,-666666666,,21911,17,009
"Marshall County, Illinois",11794,5874,5920,11471,49,18,37,18,49,152,2,150,11794,11434,360,0.4158,0.0197,29827,30095,30454,16519,8849,,18619,,9500,16001,17,123
"Iroquois County, Illinois",28169,13751,14418,26149,290,16,91,0,1202,421,62,359,28169,26255,1914,0.4197,0.0143,26976,27636,28076,12918,11081,18913,130838,-666666666,12063,17383,17,075
"Christian County, Illinois",33231,16818,16413,32101,423,62,220,68,7,350,11,339,33231,32698,533,0.4208,0.0147,26166,26543,26697,16086,4717,9376,35049,,,14810,17,021
"Clay County, Illinois",13338,6586,6752,13025,61,20,38,0,4,190,0,190,13338,13142,196,0.4237,0.0268,25821,25893,25912,24264,11852,23140,56147,-666666666,,20001,17,025
"Gallatin County, Illinois",5157,2472,2685,4989,12,27,22,0,13,94,14,80,5157,5082,75,0.4548,0.0349,25572,26051,26141,17209,26383,,,-666666666,29077,9705,17,059
"Jackson County, Illinois",58551,28989,29562,44880,8753,111,2003,8,722,2074,189,1885,58551,56021,2530,0.5355,0.0191,24521,26912,27393,14429,13775,23148,33697,,21563,10297,17,077
"Monroe County, Illinois",33936,16691,17245,33170,76,17,331,0,56,286,78,208,33936,33422,514,0.4289,0.0208,39988,40286,40447,26521,41404,,18647,-666666666,,32894,17,133
"Peoria County, Illinois",184463,89387,95076,134449,32473,522,7352,12,2906,6749,481,6268,184463,175782,8681,0.4756,0.0093,30753,34576,35160,18580,17083,26920,43621,,18568,11941,17,143
"Union County, Illinois",17127,8592,8535,16114,237,19,58,0,316,383,33,350,17127,16251,876,0.4472,0.0267,25416,26365,26926,9806,4734,17789,32631,-666666666,9113,10995,17,181
"Winnebago County, Illinois",286174,139748,146426,226087,36833,846,7339,99,6016,8954,928,8026,286174,250534,35640,0.4501,0.0088,28250,30908,32763,16447,17347,15142,33631,37623,16126,10863,17,201
"Piatt County, Illinois",16427,8080,8347,15955,90,10,74,0,34,264,28,236,16427,16214,213,0.3953,0.0235,33967,34582,34652,23231,7063,,6200,-666666666,33009,13577,17,147
"Pulaski County, Illinois",5611,2747,2864,3674,1685,7,16,0,22,207,7,200,5611,5487,124,0.4624,0.0372,20317,22932,23243,11832,16055,16214,17106,-666666666,,10860,17,153
"Schuyler County, Illinois",7064,3701,3363,6429,518,7,0,0,0,110,0,110,7064,7035,29,0.3868,0.0320,23068,24687,24795,,5365,,-666666666,-666666666,-666666666,10028,17,169
"Stark County, Illinois",5500,2716,2784,5353,38,0,61,0,2,46,0,46,5500,5412,88,0.4734,0.0343,30225,30460,30817,8789,5624,-666666666,37205,-666666666,,14604,17,175
"Edgar County, Illinois",17539,8617,8922,17132,61,12,181,0,13,140,66,74,17539,17338,201,0.4300,0.0303,27701,28028,27938,26515,4279,,20582,-666666666,,8274,17,045
"Bond County, Illinois",16712,8587,8125,15189,1043,68,196,0,98,118,0,118,16712,16134,578,0.4132,0.0320,26356,27486,28028,9943,15086,14332,17520,-666666666,16969,9915,17,005
"Boone County, Illinois",53606,26830,26776,46861,1190,179,633,0,3459,1284,176,1108,53606,42147,11459,0.4381,0.0258,30725,32053,34892,16768,31656,15566,38615,-666666666,15875,19615,17,007
"Bureau County, Illinois",33381,16437,16944,31250,311,48,289,3,1032,448,93,355,33381,30386,2995,0.4153,0.0126,29126,29979,30683,17427,10292,21142,22735,,15135,20068,17,011
"Carroll County, Illinois",14562,7229,7333,13933,166,17,107,0,118,221,21,200,14562,14039,523,0.4172,0.0191,28053,28713,28963,15948,17832,7059,10299,-666666666,10409,13772,17,015
"Coles County, Illinois",51736,24999,26737,48036,1905,107,627,97,117,847,34,813,51736,50448,1288,0.4984,0.0289,26790,27791,28076,13211,9178,12282,32574,14124,18061,9872,17,029
"Crawford County, Illinois",19088,9910,9178,17341,1100,14,137,13,76,407,47,360,19088,18420,668,0.4577,0.0230,26713,28077,28769,9353,3340,30079,78597,15431,31555,13667,17,033
"Monroe County, Indiana",145403,72416,72987,125310,4362,344,9529,19,804,5035,254,4781,145403,140508,4895,0.4998,0.0130,27461,29030,29249,21236,18478,19909,18899,,14601,15033,18,105
"Fountain County, Indiana",16486,8251,8235,16079,60,27,88,0,42,190,0,190,16486,16080,406,0.4429,0.0331,26721,27003,27159,18768,7910,15293,14175,-666666666,,18463,18,045
"Elkhart County, Indiana",203604,100713,102891,178022,10720,440,2156,149,5367,6750,932,5818,203604,171843,31761,0.4183,0.0093,25075,26506,28568,13824,15917,25635,32672,23369,13605,8564,18,039
"Crawford County, Indiana",10581,5367,5214,10296,33,51,0,0,0,201,0,201,10581,10430,151,0.4118,0.0405,21021,21270,21460,3236,20252,,-666666666,-666666666,-666666666,12888,18,025
"Cass County, Indiana",38084,19082,19002,31935,463,187,667,6,4011,815,278,537,38084,32417,5667,0.4185,0.0219,23918,25525,26127,13386,18339,35746,22190,,14765,7893,18,017
"Marion County, Indiana",944523,455007,489516,588161,261724,2447,29367,509,31660,30655,2967,27688,944523,848263,96260,0.4804,0.0049,27251,32419,34474,13428,19340,18494,24523,12053,13019,13892,18,097
"Clay County, Indiana",26268,12935,13333,25360,202,25,63,0,21,597,19,578,26268,26170,98,0.3865,0.0140,25290,25670,25717,9523,22751,5516,33857,-666666666,7062,10574,18,021
"Hendricks County, Indiana",160940,80391,80549,141209,10623,284,4448,15,1624,2737,244,2493,160940,154924,6016,0.3853,0.0135,34689,36007,36300,25590,29123,25777,26811,,15609,13412,18,063
"Franklin County, Indiana",22842,11426,11416,22717,25,3,63,0,9,25,0,25,22842,22817,25,0.4089,0.0277,27557,27640,27645,17556,11116,,,-666666666,,,18,047
"Grant County, Indiana",66944,31935,35009,59055,5072,119,547,0,435,1716,124,1592,66944,64130,2814,0.4140,0.0131,21739,22688,22900,14877,15213,10281,24640,-666666666,9758,11267,18,053
"Jackson County, Indiana",43938,21822,22116,40171,471,157,877,0,1657,605,160,445,43938,41035,2903,0.4203,0.0160,24522,24999,25423,16043,11782,17840,32200,-666666666,19178,8054,18,071
"Howard County, Indiana",82387,39852,42535,72036,5968,447,1075,29,812,2020,108,1912,82387,79696,2691,0.4345,0.0102,27297,28308,28483,22024,19510,24568,30424,,24249,14334,18,067
"Owen County, Indiana",20878,10628,10250,20258,159,50,97,0,0,314,39,275,20878,20619,259,0.3936,0.0219,24129,24059,24204,15217,32316,38876,17065,-666666666,-666666666,24335,18,119
"Randolph County, Indiana",25076,12269,12807,24059,170,45,27,0,312,463,62,401,25076,24231,845,0.4096,0.0224,23539,24050,24251,15227,23018,,,-666666666,10850,8510,18,135
"Whitley County, Indiana",33649,16702,16947,32608,139,126,137,0,48,591,167,424,33649,32974,675,0.3994,0.0208,30144,30531,30757,15452,13150,15780,26156,-666666666,22627,17384,18,183
"Brown County, Indiana",15034,7441,7593,14556,157,0,86,0,37,198,33,165,15034,14785,249,0.4596,0.0473,33617,34310,34483,17103,7847,-666666666,12164,-666666666,7381,17262,18,013
"Clinton County, Indiana",32301,15986,16315,30202,355,91,102,45,1220,286,54,232,32301,27273,5028,0.3888,0.0179,24276,24884,26664,12520,10319,23921,15762,49693,14775,17092,18,023
"Union County, Indiana",7153,3514,3639,6966,5,0,71,0,0,111,0,111,7153,7025,128,0.3792,0.0281,24040,24467,24818,,,-666666666,12949,-666666666,-666666666,4849,18,161
"Lawrence County, Indiana",45619,22558,23061,44038,163,263,206,17,217,715,180,535,45619,44876,743,0.4067,0.0170,25590,25951,25968,16957,19994,14483,29729,,9642,12678,18,093
"Daviess County, Indiana",32937,16634,16303,31356,577,10,44,10,518,422,0,422,32937,31354,1583,0.4137,0.0142,22548,23102,23513,9813,14699,,21439,,6389,12637,18,027
"Dearborn County, Indiana",49501,24764,24737,48080,433,151,264,11,186,376,0,376,49501,48887,614,0.4104,0.0131,29891,30274,30410,17128,21803,23574,16934,,27784,3685,18,029
"Knox County, Indiana",37409,18949,18460,35235,1082,36,299,57,187,513,8,505,37409,36692,717,0.4347,0.0161,24581,25339,25542,9941,9646,20125,31320,,6889,8767,18,083
"Perry County, Indiana",19141,10222,8919,18131,577,34,95,0,44,260,20,240,19141,18881,260,0.4086,0.0198,24540,25393,25404,10617,8395,,20974,-666666666,,6051,18,123
"Pulaski County, Indiana",12660,6404,6256,12085,61,26,80,0,185,223,46,177,12660,12288,372,0.3966,0.0319,24695,25349,25404,16511,13018,11831,,-666666666,19164,6706,18,131
"Posey County, Indiana",25589,12787,12802,24637,504,7,118,0,53,270,30,240,25589,25293,296,0.4065,0.0233,30572,30912,30953,28158,18026,,47681,-666666666,23558,16753,18,129
"Warren County, Indiana",8247,4124,4123,8062,53,18,1,0,10,103,6,97,8247,8110,137,0.3765,0.0286,29408,29082,29060,59664,10723,,,-666666666,42290,59088,18,171
"Vermillion County, Indiana",15560,7809,7751,15066,219,48,43,0,61,123,0,123,15560,15503,57,0.4169,0.0263,25143,25519,25558,11084,,24142,34230,-666666666,,23400,18,165
"Allen County, Indiana",370016,180669,189347,293212,42187,692,13714,155,5969,14087,1231,12856,370016,342846,27170,0.4521,0.0082,28239,30925,31890,15735,17247,20529,26730,16001,15433,12661,18,003
"Decatur County, Indiana",26552,13202,13350,25609,167,112,362,0,33,269,94,175,26552,26037,515,0.4022,0.0229,26515,26576,26830,11412,20300,15879,37717,-666666666,,16547,18,031
"Floyd County, Indiana",76809,37135,39674,69224,4122,290,809,0,643,1721,53,1668,76809,74388,2421,0.4452,0.0128,32299,33660,33929,20394,18051,27229,36432,-666666666,23354,13923,18,043
"Jennings County, Indiana",27727,13925,13802,26917,314,97,55,0,146,198,6,192,27727,27064,663,0.3877,0.0187,23490,23535,23573,19130,26389,68869,12029,-666666666,10314,3480,18,079
"Johnson County, Indiana",151564,74349,77215,139101,3743,239,4743,27,1779,1932,365,1567,151564,146278,5286,0.4135,0.0133,32475,33288,33590,19978,24744,17372,28088,,22463,11257,18,081
"Morgan County, Indiana",69727,34447,35280,67980,212,46,505,0,109,875,52,823,69727,68674,1053,0.3873,0.0147,28633,28969,29073,20421,12060,36789,24720,-666666666,22249,9216,18,109
"Gibson County, Indiana",33596,16848,16748,31952,660,18,137,0,166,663,0,663,33596,33073,523,0.4148,0.0167,27137,27593,27779,9972,21899,,18615,-666666666,11865,16007,18,051
"Orange County, Indiana",19547,9727,9820,18842,260,22,102,0,91,230,6,224,19547,19246,301,0.4297,0.0187,23317,23335,23455,15805,18939,29086,50888,-666666666,25126,13246,18,117
"Kosciusko County, Indiana",78806,39264,39542,73999,553,272,954,12,1784,1232,200,1032,78806,72561,6245,0.4112,0.0134,28740,29222,30155,15389,22021,13424,38046,,17831,14742,18,085
"Marshall County, Indiana",46595,23174,23421,43323,443,69,224,0,1680,856,84,772,46595,42010,4585,0.4281,0.0175,25537,26287,26998,14325,9792,14772,36507,-666666666,16060,12317,18,099
"Vanderburgh County, Indiana",181313,87676,93637,154849,17062,206,2209,282,2011,4694,267,4427,181313,176628,4685,0.4751,0.0154,28320,30193,30363,18767,16814,9133,40457,16189,14535,10104,18,163
"Blackford County, Indiana",12129,6037,6092,11803,17,40,48,0,2,219,0,219,12129,11938,191,0.4390,0.0407,24663,24939,25021,20450,,,,-666666666,,18802,18,009
"Scott County, Indiana",23743,11670,12073,23149,60,66,129,0,72,267,0,267,23743,23222,521,0.4046,0.0178,22688,23017,23184,13471,17137,22039,17357,-666666666,,3465,18,143
"Harrison County, Indiana",39712,19875,19837,38347,319,110,175,0,365,396,26,370,39712,38982,730,0.4131,0.0205,27211,27605,27781,10891,18795,32544,30318,-666666666,6715,11900,18,061
"LaPorte County, Indiana",110552,57068,53484,91514,12278,349,631,27,2372,3381,663,2718,110552,103416,7136,0.4395,0.0163,25865,28355,28894,14946,13520,24000,21277,,20186,8490,18,091
"Wabash County, Indiana",31631,15365,16266,30263,314,195,92,0,350,417,90,327,31631,30826,805,0.3999,0.0212,25228,25440,25595,15311,11251,30031,59076,-666666666,20267,14862,18,169
"Jasper County, Indiana",33449,16699,16750,31547,254,30,139,0,741,738,174,564,33449,31450,1999,0.3775,0.0162,26415,27091,27274,16463,19665,,14629,-666666666,12984,15827,18,073
"Martin County, Indiana",10210,5155,5055,10017,80,34,13,0,12,54,0,54,10210,10103,107,0.4123,0.0293,25676,25874,26065,11532,11378,23053,21715,-666666666,,10278,18,101
"Porter County, Indiana",168041,83212,84829,153164,6134,287,2294,150,2175,3837,732,3105,168041,151592,16449,0.4274,0.0091,32943,33740,34673,23089,20746,38981,45380,19426,24562,18051,18,127
"Shelby County, Indiana",44399,21941,22458,41895,481,57,290,0,1030,646,0,646,44399,42555,1844,0.3978,0.0154,28491,28846,29013,18811,20298,12500,58229,-666666666,16745,18370,18,145
"Ripley County, Indiana",28425,14077,14348,27593,144,116,252,0,75,245,15,230,28425,27913,512,0.4111,0.0241,27423,27453,27709,14753,17766,29585,17019,-666666666,30056,38616,18,137
"Spencer County, Indiana",20526,10363,10163,19870,149,46,57,13,185,206,33,173,20526,19937,589,0.4218,0.0592,29999,30463,30791,15089,20206,22567,10216,,19939,8835,18,147
"Sullivan County, Indiana",20792,11174,9618,19382,826,11,105,0,47,421,36,385,20792,20435,357,0.4359,0.0296,22976,23976,24109,10223,7779,,,-666666666,,11227,18,153
"Tipton County, Indiana",15218,7609,7609,14641,25,1,51,61,179,260,50,210,15218,14806,412,0.4109,0.0263,30026,30075,30261,24728,19412,,29271,,39115,22984,18,159
"Tippecanoe County, Indiana",189294,96866,92428,155740,9645,430,15378,74,3612,4415,491,3924,189294,173808,15486,0.4688,0.0100,26262,28250,29396,14449,13710,14832,20950,,18374,9488,18,157
"Vigo County, Indiana",107693,54705,52988,93885,7037,193,2028,48,928,3574,382,3192,107693,104867,2826,0.4653,0.0136,24254,25151,25199,25269,13760,11093,43458,,30376,9752,18,167
"Warrick County, Indiana",61928,30409,31519,58029,1072,88,1680,3,377,679,82,597,61928,60806,1122,0.4347,0.0160,35915,35202,35426,17645,20237,28586,80920,,21863,19147,18,173
"Hamilton County, Indiana",316095,154532,161563,275246,11845,386,18210,95,2096,8217,936,7281,316095,303815,12280,0.4378,0.0097,46597,47772,47997,35282,35237,25135,52545,21859,22752,17823,18,057
"DeKalb County, Indiana",42704,21307,21397,41541,114,35,141,0,131,742,19,723,42704,41516,1188,0.4132,0.0223,27036,27164,27180,29927,26472,8986,40966,-666666666,60152,12280,18,033
"LaGrange County, Indiana",38942,19752,19190,38112,31,19,77,5,41,657,8,649,38942,37398,1544,0.4023,0.0198,23626,23777,24269,10220,40513,6668,47735,,9959,12397,18,087
"Bartholomew County, Indiana",81893,41150,40743,69835,1625,173,5701,38,2730,1791,227,1564,81893,76470,5423,0.4319,0.0110,30515,30562,30985,14719,24303,6926,44769,,12298,19519,18,005
"Rush County, Indiana",16704,8185,8519,16223,264,0,21,0,46,150,12,138,16704,16438,266,0.4305,0.0242,24900,24852,24953,21966,24771,-666666666,,-666666666,10678,38137,18,139
"Boone County, Indiana",64321,31750,32571,59975,1024,75,1730,0,332,1185,179,1006,64321,62479,1842,0.4771,0.0208,44712,45138,45566,26329,48768,32993,41768,-666666666,23405,30631,18,011
"Fulton County, Indiana",20212,9962,10250,18947,204,93,88,12,657,211,28,183,20212,19183,1029,0.4182,0.0375,25106,25996,26217,11285,17516,25911,,,9604,7211,18,049
"Lake County, Indiana",486849,235515,251334,299802,116708,1279,6703,132,46223,16002,5631,10371,486849,395895,90954,0.4473,0.0068,27660,32445,33813,20011,20031,30227,36058,30370,19619,13140,18,089
"Montgomery County, Indiana",38276,19442,18834,36645,303,75,314,8,146,785,196,589,38276,36449,1827,0.3897,0.0121,26184,26460,26998,11884,24067,20295,43433,25763,11495,10489,18,107
"Noble County, Indiana",47451,23844,23607,45932,243,21,307,0,158,790,152,638,47451,42593,4858,0.4026,0.0178,26063,26244,27072,18836,8465,16548,48963,-666666666,28548,11852,18,113
"Adams County, Indiana",35195,17561,17634,34060,392,23,133,0,456,131,57,74,35195,33607,1588,0.4149,0.0230,22514,22686,22859,17580,13355,19204,36737,-666666666,16205,13373,18,001
"Fayette County, Indiana",23259,11474,11785,22408,588,0,44,0,92,127,16,111,23259,22992,267,0.4309,0.0251,23627,23927,24037,12487,14768,-666666666,,-666666666,16875,15425,18,041
"Delaware County, Iowa",17258,8689,8569,16865,48,55,66,0,46,178,24,154,17258,17004,254,0.4256,0.0493,31300,31657,31641,25659,12946,,6350,-666666666,20854,15843,19,055
"Wayne County, Iowa",6413,3157,3256,6226,67,19,2,0,0,99,0,99,6413,6358,55,0.4475,0.0533,25560,25950,26049,14771,14321,44826,,-666666666,-666666666,5345,19,185
"Linn County, Iowa",222121,109540,112581,196391,11858,370,5205,288,1896,6113,356,5757,222121,215037,7084,0.4308,0.0092,34289,36131,36455,20168,16713,31032,33788,10662,27701,12983,19,113
"Scott County, Iowa",172288,84515,87773,147815,12861,614,4678,30,1279,5011,299,4712,172288,160918,11370,0.4516,0.0098,31873,33879,34920,19471,17799,20533,28872,,29618,12878,19,163
"O'Brien County, Iowa",13911,6962,6949,13083,147,46,127,4,350,154,48,106,13911,13260,651,0.4233,0.0272,29901,30862,31174,10908,12247,14161,27499,,12405,12255,19,141
"Benton County, Iowa",25626,12783,12843,24977,155,47,85,0,50,312,77,235,25626,25255,371,0.4254,0.0213,32764,32982,33048,21892,21730,21289,91946,-666666666,21494,8279,19,011
"Dubuque County, Iowa",96802,47744,49058,89972,3326,181,1169,394,392,1368,74,1294,96802,94487,2315,0.4385,0.0145,31096,32348,32709,16217,11200,26374,32663,10233,13373,7491,19,061
"Hamilton County, Iowa",15110,7377,7733,14159,206,6,459,24,232,24,3,21,15110,14209,901,0.4103,0.0240,28706,29709,30317,15329,8317,,17049,,9862,16121,19,079
"Pocahontas County, Iowa",6898,3384,3514,6630,44,25,105,3,41,50,0,50,6898,6645,253,0.4037,0.0156,27984,28230,28729,14622,11923,,29813,,29351,8942,19,151
"Union County, Iowa",12453,6063,6390,12063,63,20,164,16,24,103,0,103,12453,12088,365,0.4312,0.0232,26216,26530,26848,14453,5303,,21904,,,18622,19,175
"Van Buren County, Iowa",7223,3698,3525,7054,53,0,9,0,11,96,0,96,7223,7116,107,0.4639,0.0489,27468,27798,27996,8059,8240,-666666666,,-666666666,6691,7559,19,177
"Ringgold County, Iowa",4984,2432,2552,4818,3,18,47,0,68,30,4,26,4984,4865,119,0.4713,0.0376,29759,30198,30402,9755,9800,34889,23968,-666666666,8691,15033,19,159
"Davis County, Iowa",8885,4398,4487,8705,5,0,62,0,5,108,23,85,8885,8761,124,0.4107,0.0264,26503,26833,26673,32227,,-666666666,7779,-666666666,,12619,19,051
"Adair County, Iowa",7124,3516,3608,6967,27,0,40,0,11,79,10,69,7124,6989,135,0.4293,0.0304,29984,30183,30424,15034,19030,-666666666,8078,-666666666,,27066,19,001
"Audubon County, Iowa",5637,2758,2879,5478,20,4,26,0,0,109,0,109,5637,5600,37,0.3920,0.0177,28957,28813,28776,32243,,,,-666666666,-666666666,42550,19,009
"Clarke County, Iowa",9282,4689,4593,9026,6,23,16,0,126,85,0,85,9282,8055,1227,0.4185,0.0298,26706,26819,29006,11449,,,,-666666666,22413,22269,19,039
"Ida County, Iowa",6916,3457,3459,6724,6,48,36,0,28,74,2,72,6916,6764,152,0.4608,0.0383,32562,32959,33183,18570,8700,18708,11850,-666666666,16414,23549,19,093
"Keokuk County, Iowa",10200,5202,4998,9973,39,12,27,5,25,119,23,96,10200,10034,166,0.4387,0.0295,28630,28898,28964,17130,15023,,33563,,3620,14560,19,107
"Monroe County, Iowa",7863,4064,3799,7552,5,0,10,0,110,186,0,186,7863,7662,201,0.4075,0.0608,26469,27126,27596,9820,,-666666666,,-666666666,,,19,135
"Wapello County, Iowa",35315,17403,17912,30868,1143,55,376,183,2026,664,145,519,35315,31552,3763,0.4409,0.0260,24864,26533,27246,11964,14977,23653,30469,8251,11631,6167,19,179
"Sioux County, Iowa",34825,17487,17338,32474,124,104,248,20,1264,591,109,482,34825,31170,3655,0.3844,0.0185,28467,29577,30547,14472,10148,20435,27312,,13045,5666,19,167
"Calhoun County, Iowa",9780,5044,4736,9361,121,64,30,0,38,166,12,154,9780,9598,182,0.4460,0.0170,27908,28412,28634,11477,17202,10770,34507,-666666666,24118,13550,19,025
"Cedar County, Iowa",18445,9161,9284,17924,136,45,59,0,39,242,18,224,18445,18087,358,0.3785,0.0176,32010,32487,32715,18808,,15564,4208,-666666666,25205,24062,19,031
"Cerro Gordo County, Iowa",42984,20850,22134,40492,745,208,482,8,339,710,83,627,42984,40950,2034,0.4437,0.0178,31304,32336,32803,17012,12611,11383,22761,,17956,10340,19,033
"Greene County, Iowa",9003,4380,4623,8655,33,12,59,0,61,183,78,105,9003,8751,252,0.4054,0.0178,28413,29010,29215,10823,25006,,36575,-666666666,8567,4787,19,073
"Hardin County, Iowa",17127,8565,8562,16335,230,171,74,3,120,194,29,165,17127,16392,735,0.4090,0.0202,28539,29425,29786,19369,4944,15092,8903,,23913,4519,19,083
"Lucas County, Iowa",8597,4318,4279,8522,14,1,0,0,38,22,0,22,8597,8444,153,0.4578,0.0475,28900,29059,29322,10198,14393,,-666666666,-666666666,,,19,117
"Winnebago County, Iowa",10571,5190,5381,10048,136,63,131,0,79,114,16,98,10571,10107,464,0.3871,0.0177,27117,27669,28027,15511,12160,37633,21215,-666666666,9444,9487,19,189
"Palo Alto County, Iowa",9055,4512,4543,8705,209,16,47,0,14,64,4,60,9055,8814,241,0.4059,0.0235,28843,29456,29683,19732,15708,,19789,-666666666,13379,4469,19,147
"Appanoose County, Iowa",12510,6154,6356,12156,74,22,68,0,10,180,11,169,12510,12271,239,0.5136,0.0466,27546,27865,28186,11153,16022,23191,23225,-666666666,,12803,19,007
"Iowa County, Iowa",16207,8052,8155,15776,150,11,40,0,70,160,0,160,16207,15777,430,0.4397,0.0369,32663,33215,33438,19155,11468,,20098,-666666666,5410,13011,19,095
"Jasper County, Iowa",36891,18669,18222,35225,705,68,176,56,74,587,106,481,36891,36099,792,0.4093,0.0143,27551,28182,28458,11384,14338,27449,31476,,8527,6116,19,099
"Winneshiek County, Iowa",20401,10156,10245,19758,193,22,270,0,52,106,48,58,20401,19955,446,0.4005,0.0155,30706,30598,30883,16017,12093,,59378,-666666666,29792,10054,19,191
"Poweshiek County, Iowa",18605,8990,9615,17454,345,0,396,9,61,340,45,295,18605,18008,597,0.4520,0.0233,30711,31889,32238,14697,15720,-666666666,13898,,14293,8416,19,157
"Marshall County, Iowa",40271,20400,19871,34246,383,125,1453,14,3056,994,28,966,40271,31690,8581,0.4024,0.0165,26516,28024,30762,14566,18619,26035,22185,,16084,15434,19,127
"Boone County, Iowa",26399,13310,13089,25448,135,132,98,93,71,422,5,417,26399,25714,685,0.4076,0.0223,31686,32052,32505,12056,25293,25067,52783,24181,22576,12012,19,015
"Bremer County, Iowa",24782,12274,12508,23847,258,81,277,11,78,230,24,206,24782,24402,380,0.4128,0.0168,32512,33049,33243,17383,13893,8027,23844,,15154,24205,19,017
"Howard County, Iowa",9264,4580,4684,9098,29,0,4,0,5,128,0,128,9264,9118,146,0.4145,0.0315,28828,29212,29601,5177,5993,-666666666,,-666666666,,8408,19,089
"Emmet County, Iowa",9551,4770,4781,9141,173,28,36,0,84,89,41,48,9551,8638,913,0.4744,0.0790,30386,31211,32515,17342,4645,,40583,-666666666,27560,3843,19,063
"Hancock County, Iowa",10888,5494,5394,10539,70,26,40,8,36,169,22,147,10888,10435,453,0.3863,0.0245,29537,30048,30440,18644,15664,15762,22290,,11483,8200,19,081
"Madison County, Iowa",15890,8028,7862,15457,37,13,200,19,10,154,0,154,15890,15559,331,0.4349,0.0400,33069,33572,33899,13744,10541,8400,18589,,,15036,19,121
"Marion County, Iowa",33207,16374,16833,31716,197,65,313,0,286,630,27,603,33207,32578,629,0.4038,0.0213,28832,29486,29667,6791,18299,26292,20078,-666666666,4260,14971,19,125
"Wright County, Iowa",12804,6383,6421,11925,88,45,39,0,522,185,19,166,12804,11323,1481,0.4314,0.0223,28317,29436,30830,13274,2626,,41097,-666666666,15574,5720,19,197
"Madison County, Ohio",43988,24041,19947,39704,2598,109,523,14,57,983,6,977,43988,43130,858,0.4102,0.0178,28331,29972,30314,9810,5804,3900,51352,,1256,13744,39,097
"Muskingum County, Ohio",86076,41719,44357,79116,2689,181,306,19,385,3380,312,3068,86076,85128,948,0.4492,0.0210,24080,24685,24709,19342,27232,2347,17315,,17392,9833,39,119
"Dakota County, Minnesota",418201,205909,212292,345402,24762,1294,19764,208,12214,14557,1336,13221,418201,389015,29186,0.4135,0.0045,40441,43765,44606,20480,24275,22085,37793,56208,17405,13381,27,037
"Lyon County, Minnesota",25839,12788,13051,22470,899,99,1071,3,834,463,73,390,25839,24118,1721,0.4652,0.0410,30531,33246,33872,10063,16200,11647,13151,,8886,9948,27,083
"Renville County, Minnesota",14721,7495,7226,13254,70,195,84,0,907,211,45,166,14721,13493,1228,0.4402,0.0146,31585,33454,33870,13161,15750,16267,11202,-666666666,13749,18360,27,129
"Cook County, Minnesota",5311,2632,2679,4614,24,463,47,0,53,110,2,108,5311,5191,120,0.4307,0.0341,32703,34296,34297,18993,29454,25666,24819,-666666666,4894,13010,27,031
"Meeker County, Minnesota",23079,11727,11352,22470,128,34,65,11,115,256,25,231,23079,22196,883,0.4281,0.0186,31819,32243,32729,17524,16453,16985,14352,,16936,14901,27,093
"Pennington County, Minnesota",14184,7054,7130,13275,174,247,140,1,37,310,7,303,14184,13677,507,0.4163,0.0219,30625,31477,31838,18917,23452,13060,23327,,62549,11721,27,113
"Wilkin County, Minnesota",6343,3215,3128,5965,48,134,0,0,6,190,0,190,6343,6291,52,0.4498,0.0512,32066,33330,33355,10606,15604,12728,-666666666,-666666666,,11205,27,167
"Clay County, Minnesota",62801,31010,31791,57015,1949,1024,640,11,366,1796,218,1578,62801,60005,2796,0.4139,0.0104,29631,31314,31823,14510,13379,12398,15950,3064,16874,11296,27,027
"Fillmore County, Minnesota",20888,10491,10397,20442,102,9,106,2,51,176,0,176,20888,20566,322,0.4060,0.0105,29440,29858,30038,15560,14233,,10980,,8059,8180,27,045
"Polk County, Minnesota",31591,15967,15624,29058,618,448,304,17,438,708,20,688,31591,29575,2016,0.4281,0.0100,28856,29838,30449,16763,35728,15643,12350,7276,13058,8308,27,119
"Roseau County, Minnesota",15462,8003,7459,14347,134,257,434,6,29,255,19,236,15462,15270,192,0.3869,0.0179,28049,29073,29096,18610,11945,8413,20180,,17862,13187,27,135
"Watonwan County, Minnesota",10973,5408,5565,9387,102,77,130,0,1189,88,8,80,10973,8280,2693,0.4328,0.0214,27772,29547,31742,17491,8497,39852,25195,-666666666,16635,4480,27,165
"Big Stone County, Minnesota",5016,2477,2539,4969,2,3,0,0,3,39,0,39,5016,4936,80,0.4494,0.0267,30489,30504,30718,18185,,,-666666666,-666666666,,31782,27,011
"Cass County, Minnesota",29022,14798,14224,24519,125,3364,183,13,49,769,8,761,29022,28401,621,0.4370,0.0085,29053,31914,32208,14415,12899,13585,17672,11946,11133,12243,27,021
"Goodhue County, Minnesota",46217,23093,23124,43562,519,472,352,0,337,975,179,796,46217,44674,1543,0.4171,0.0118,33400,34246,34734,15044,11983,35089,25962,-666666666,19177,13768,27,049
"Jackson County, Minnesota",10047,5069,4978,9499,13,10,290,0,141,94,19,75,10047,9699,348,0.4418,0.0623,33358,31762,32139,17701,,,94157,-666666666,11761,46253,27,063
"Nobles County, Minnesota",21839,11236,10603,17274,1020,131,1431,7,1587,389,85,304,21839,15908,5931,0.4307,0.0174,25554,27891,32335,14683,18764,8806,15632,,17364,15433,27,105
"Sherburne County, Minnesota",93231,47673,45558,86420,2053,591,1229,0,942,1996,83,1913,93231,90862,2369,0.3699,0.0131,34013,35200,35351,21352,16973,26421,16970,-666666666,16391,21198,27,141
"Carver County, Minnesota",100416,49793,50623,92839,1719,205,2835,5,538,2275,144,2131,100416,96260,4156,0.4279,0.0120,45637,46590,47559,19017,20345,60068,43309,,25081,32391,27,019
"Itasca County, Minnesota",45203,22913,22290,41967,228,1663,186,2,87,1070,71,999,45203,44565,638,0.4285,0.0174,28636,29342,29438,21656,9379,16006,23222,,11141,27040,27,061
"Ramsey County, Minnesota",541493,263843,277650,361501,63724,3723,77156,192,12028,23169,1790,21379,541493,500924,40569,0.4655,0.0057,34049,41824,43463,17499,18488,21039,19207,19011,18777,15112,27,123
"Winona County, Minnesota",50847,25191,25656,47580,681,173,1356,9,254,794,53,741,50847,49388,1459,0.4415,0.0182,28689,29690,30077,13948,10820,16196,16018,,12989,13467,27,169
"Madison County, Mississippi",103498,49524,53974,59091,39386,204,2646,7,1466,698,84,614,103498,100444,3054,0.4830,0.0154,38496,49627,50338,17332,22899,40192,43983,,11911,10469,28,089
"Marion County, Mississippi",25202,12230,12972,16463,8124,73,158,12,300,72,0,72,25202,24812,390,0.4942,0.0208,18687,22003,21952,21642,12389,,13192,,14954,8071,28,091
"Titus County, Texas",32730,16046,16684,22719,2995,370,371,12,5635,628,142,486,32730,18715,14015,0.4215,0.0171,20633,23508,29272,12719,15560,15242,22845,,12874,12333,48,449
"Liberty County, Texas",81862,40439,41423,66228,8098,394,500,13,5514,1115,106,1009,81862,62764,19098,0.4432,0.0145,22757,23911,26668,13777,17450,33954,17395,,15198,28860,48,291
"Wise County, Texas",64639,32424,32215,60340,827,276,281,124,1183,1608,453,1155,64639,52339,12300,0.4303,0.0205,28781,29135,32129,16438,19766,48361,26254,6040,30595,17629,48,497
"Jim Wells County, Texas",41192,20178,21014,39348,266,55,257,63,951,252,106,146,41192,8132,33060,0.4960,0.0347,21274,21358,31270,19119,21270,9613,14985,,23013,8829,48,249
"Dimmit County, Texas",10663,5186,5477,9507,5,0,402,0,745,4,4,0,10663,1419,9244,0.5200,0.0472,18121,17623,41661,14621,33020,-666666666,39487,-666666666,12901,,48,127
"Fort Bend County, Texas",739342,363177,376165,385103,152327,2259,147221,195,33611,18626,5361,13265,739342,559689,179653,0.4352,0.0069,39472,45038,55354,25090,31192,40125,39152,64871,22620,24679,48,157
"Irion County, Texas",1524,836,688,1259,54,0,0,0,199,12,2,10,1524,1150,374,0.4715,0.0472,31449,33769,35054,25448,,-666666666,-666666666,-666666666,25142,19650,48,235
"Cooke County, Texas",39571,19660,19911,36468,974,260,357,17,267,1228,51,1177,39571,32528,7043,0.4209,0.0155,28751,29699,33228,13336,21861,19672,26799,,18866,10631,48,097
"Dawson County, Texas",12964,7235,5729,10054,815,159,6,0,1458,472,325,147,12964,5562,7402,0.5012,0.0371,21543,25331,36030,14718,2364,11839,,-666666666,11918,7251,48,115
"Burleson County, Texas",17863,8977,8886,14298,2259,59,40,0,798,409,173,236,17863,14206,3657,0.4332,0.0384,28732,31657,34730,18414,16635,28908,20265,-666666666,21751,7719,48,051
"Jefferson County, Texas",255210,130660,124550,148751,86351,821,9461,114,5278,4434,1337,3097,255210,203749,51461,0.4888,0.0094,26205,30861,37019,16581,18438,19506,30810,33448,20250,19600,48,245
"Oldham County, Texas",2090,1145,945,1902,102,2,10,0,2,72,3,69,2090,1737,353,0.4742,0.0531,24151,26108,29283,11546,2716,,15440,-666666666,,4439,48,359
"El Paso County, Texas",837654,411682,425972,672260,28724,5142,10013,1178,99304,21033,6661,14372,837654,147465,690189,0.4634,0.0055,20763,21331,37871,17797,27163,17432,33262,16335,15118,15647,48,141
"Terrell County, Texas",862,429,433,560,23,2,0,0,253,24,0,24,862,314,548,0.4967,0.0712,23852,27656,37966,18987,,,-666666666,-666666666,19679,,48,443
"Uvalde County, Texas",27009,13083,13926,24114,133,143,279,19,1707,614,521,93,27009,7762,19247,0.4338,0.0243,19092,19806,29217,15091,10048,59071,13380,,11832,7042,48,463
"Archer County, Texas",8789,4326,4463,8334,81,40,47,0,95,192,0,192,8789,8062,727,0.4316,0.0309,31806,32369,33857,14464,6506,25318,,-666666666,31520,25814,48,009
"Hidalgo County, Texas",849389,415443,433946,747125,4647,1619,8157,192,76609,11040,8433,2607,849389,67708,781681,0.4907,0.0078,16490,16335,32005,15117,18385,21138,42131,13051,15830,11154,48,215
"Somervell County, Texas",8743,4192,4551,7946,54,115,35,60,474,59,57,2,8743,7095,1648,0.4244,0.0263,26523,27809,29421,15662,,,,12033,16596,,48,425
"Tooele County, Utah",65185,32871,32314,58452,344,418,505,367,3066,2033,530,1503,65185,57252,7933,0.3513,0.0172,25076,25950,26462,17563,37917,10955,22756,16879,16724,15341,49,045
"Haskell County, Texas",5809,3071,2738,5148,194,33,44,0,279,111,1,110,5809,4144,1665,0.4380,0.0265,21308,22479,26235,13306,11546,7236,6623,-666666666,17965,2458,48,207
"Mills County, Texas",4902,2329,2573,4818,10,10,5,0,50,9,1,8,4902,3934,968,0.4917,0.0654,24274,24377,26314,16798,,,,-666666666,29206,,48,333
"Newton County, Texas",14057,7233,6824,10822,2776,21,166,0,0,272,0,272,14057,13560,497,0.4437,0.0231,21144,22467,22578,19712,16700,43176,8190,-666666666,-666666666,20065,48,351
"Summit County, Utah",40511,20766,19745,38064,304,101,667,10,550,815,207,608,40511,35849,4662,0.4891,0.0174,53950,55477,59147,21688,19311,34640,47706,,19340,26587,49,043
"Piute County, Utah",1904,1020,884,1885,2,2,0,0,4,11,0,11,1904,1870,34,0.4358,0.0378,16932,17087,17339,2212,,,-666666666,-666666666,,,49,031
"Beaver County, Utah",6443,3280,3163,6181,0,62,16,0,159,25,0,25,6443,5714,729,0.3751,0.0283,22558,22810,23935,12257,-666666666,20774,,-666666666,14116,,49,001
"Sanpete County, Utah",29366,15412,13954,25880,276,301,140,152,2063,554,65,489,29366,26537,2829,0.3897,0.0210,17980,19356,19556,8556,1489,8066,11727,8912,7921,8796,49,039
"Utah County, Utah",590440,298256,292184,542398,3585,2843,8789,4797,10810,17218,1475,15743,590440,522155,68285,0.4164,0.0054,24528,25068,26095,16252,16937,13971,24146,21066,19990,14831,49,049
"Franklin County, Vermont",49025,24357,24668,46562,292,300,174,0,397,1300,25,1275,49025,48283,742,0.4029,0.0149,30692,31557,31633,20286,24265,17628,15198,-666666666,16310,10610,50,011
"Bennington County, Vermont",35920,17611,18309,34393,230,62,390,15,107,723,30,693,35920,35245,675,0.4622,0.0195,31896,32526,32659,22198,10875,5944,36786,24533,26706,9148,50,003
"Essex County, Vermont",6208,3135,3073,5987,62,20,35,0,15,89,0,89,6208,6125,83,0.4256,0.0206,24163,24681,24816,11041,5874,16055,11946,-666666666,8487,11292,50,009
"Buena Vista city, Virginia",6399,2845,3554,5678,381,6,275,8,12,39,0,39,6399,6337,62,0.4398,0.0423,19744,20290,20379,50887,15501,,8202,,,72579,51,530
"Petersburg city, Virginia",31827,14651,17176,5519,24574,79,324,16,706,609,31,578,31827,30305,1522,0.4822,0.0234,22356,29563,31034,17338,20825,11582,51424,,14175,14629,51,730
"Fairfax city, Virginia",23865,11801,12064,16461,1099,45,4060,0,969,1231,199,1032,23865,19826,4039,0.4061,0.0170,47047,53328,58384,27970,38259,,38836,-666666666,23764,17887,51,600
"Manassas city, Virginia",41457,20775,20682,27484,5758,283,2265,84,3626,1957,398,1559,41457,26594,14863,0.3970,0.0160,31638,34485,44553,17361,32247,18460,33556,43840,17103,15947,51,683
"Suffolk city, Virginia",89160,43085,46075,46065,37132,170,1713,14,868,3198,375,2823,89160,85396,3764,0.4306,0.0125,32894,39687,40023,26219,26072,38122,27724,,26691,18332,51,800
"Chesterfield County, Virginia",339447,163534,175913,231715,77546,1072,11398,135,6587,10994,824,10170,339447,310537,28910,0.4052,0.0064,36641,40324,42335,19657,29378,30882,39130,35662,18545,19092,51,041
"Isle of Wight County, Virginia",36372,17744,18628,26334,7955,99,371,22,409,1182,30,1152,36372,35297,1075,0.4266,0.0244,35344,38938,39303,19810,28098,35102,23145,,15063,14431,51,093
"Franklin city, Virginia",8211,3611,4600,3049,4833,0,27,0,90,212,0,212,8211,8121,90,0.4612,0.0293,25229,35250,35250,43718,19288,-666666666,,-666666666,43718,11894,51,620
"Charlottesville city, Virginia",47042,22830,24212,33128,8820,145,3362,23,169,1395,92,1303,47042,44511,2531,0.5168,0.0179,35026,41054,42307,22851,21329,8647,20049,,15183,19594,51,540
"Henrico County, Virginia",325642,154247,171395,185772,96112,728,26557,112,6129,10232,1013,9219,325642,307683,17959,0.4584,0.0077,37999,44053,45557,19235,27996,31080,43915,28066,17031,19829,51,087
"King William County, Virginia",16497,8113,8384,12764,2756,141,207,0,67,562,0,562,16497,16240,257,0.3948,0.0324,32809,35556,35663,26589,22517,30055,55936,-666666666,,16132,51,101
"Louisa County, Virginia",35380,17376,18004,27851,5237,83,252,0,700,1257,3,1254,35380,34394,986,0.4529,0.0331,31284,33593,33949,17623,23284,14831,25613,-666666666,14216,25184,51,109
"Prince Edward County, Virginia",22956,11493,11463,14663,7351,63,148,0,329,402,71,331,22956,22076,880,0.4640,0.0339,21216,24227,24644,8540,17059,28640,7401,-666666666,2172,6883,51,147
"Richmond County, Virginia",8878,4928,3950,5745,2452,37,25,0,202,417,57,360,8878,8275,603,0.4453,0.0455,22105,24734,25474,12081,19546,47311,14556,-666666666,10227,4893,51,159
"Spotsylvania County, Virginia",131412,64570,66842,95095,21165,579,3343,131,5856,5243,1076,4167,131412,119104,12308,0.3927,0.0093,35794,38799,39185,23542,32106,33874,30307,19193,18874,19199,51,177
"Clarke County, Virginia",14365,7333,7032,12902,687,6,109,0,208,453,45,408,14365,13617,748,0.4468,0.0283,39946,42610,43209,23641,21854,15300,19542,-666666666,20719,5567,51,043
"Mecklenburg County, Virginia",30847,14909,15938,19161,10992,63,34,3,212,382,56,326,30847,29959,888,0.4698,0.0252,23943,28483,28784,17100,16704,40832,20147,,7475,11204,51,117
"Augusta County, Virginia",74701,37897,36804,69281,3116,184,453,38,243,1386,144,1242,74701,72731,1970,0.4115,0.0154,29366,30461,30734,13486,13086,13586,39426,72789,14515,11464,51,015
"Dickenson County, Virginia",14960,7585,7375,14721,99,4,14,0,16,106,0,106,14960,14827,133,0.5800,0.0730,22924,23082,23201,7971,8862,,,-666666666,,18611,51,051
"Loudoun County, Virginia",385143,190737,194406,254787,28735,996,69222,361,11895,19147,3107,16040,385143,333024,52119,0.3859,0.0077,53408,57900,62364,28743,47245,40628,51079,37911,26971,28676,51,107
"Roanoke County, Virginia",93583,44850,48733,82547,5350,91,2708,17,495,2375,332,2043,93583,90852,2731,0.4224,0.0125,34901,35661,35717,30218,30884,42727,36889,,24337,17054,51,161
"Colonial Heights city, Virginia",17593,8053,9540,13483,2578,48,649,21,251,563,42,521,17593,16582,1011,0.4214,0.0182,27579,31058,31657,21911,16054,25858,14181,,22324,15260,51,570
"Bland County, Virginia",6447,3542,2905,6244,119,0,4,0,4,76,0,76,6447,6399,48,0.4065,0.0312,24275,24958,24897,25577,465,-666666666,,-666666666,,7533,51,021
"Buckingham County, Virginia",17004,9422,7582,10415,5816,106,56,0,307,304,15,289,17004,16596,408,0.4007,0.0193,19734,23570,23579,6033,14285,5992,26913,-666666666,4728,11210,51,029
"Covington city, Virginia",5582,2742,2840,4609,739,0,74,8,0,152,13,139,5582,5438,144,0.4578,0.0562,24955,26074,26169,24770,19697,-666666666,20262,,-666666666,20212,51,580
"Virginia Beach city, Virginia",450135,221285,228850,300103,85730,1164,29923,295,8935,23985,1938,22047,450135,414092,36043,0.4172,0.0069,36268,40880,41955,24346,27041,29751,34505,42629,22107,19270,51,810
"Galax city, Virginia",6638,3174,3464,5819,611,0,19,0,142,47,22,25,6638,5539,1099,0.5015,0.0682,21722,22649,24388,13050,16579,-666666666,,-666666666,13527,7351,51,640
"Westmoreland County, Virginia",17638,8629,9009,11902,4621,95,112,1,484,423,0,423,17638,16528,1110,0.4616,0.0335,32637,37077,37888,22418,24500,37087,25737,,22267,9356,51,193
"Pulaski County, Virginia",34234,17138,17096,31514,1575,16,244,0,186,699,24,675,34234,33650,584,0.4137,0.0184,26609,27206,27443,9969,24211,,21843,-666666666,6630,11709,51,155
"Danville city, Virginia",41512,19041,22471,18794,20444,24,453,30,482,1285,134,1151,41512,39801,1711,0.4787,0.0149,22200,27427,27705,19532,17873,30217,46624,,23280,5766,51,590
"Amherst County, Virginia",31882,15358,16524,24604,5670,123,152,22,112,1199,10,1189,31882,31108,774,0.4109,0.0180,24343,26210,26620,10686,19135,21159,42849,,8720,9398,51,009
"Bath County, Virginia",4393,2310,2083,4137,78,0,16,0,24,138,37,101,4393,4228,165,0.4506,0.1048,29127,29772,30407,13389,21886,-666666666,,-666666666,22125,12401,51,017
"Newport News city, Virginia",180145,87221,92924,87026,73725,426,5695,366,3729,9178,916,8262,180145,164347,15798,0.4369,0.0096,26993,33271,34469,20273,21457,29954,25102,17508,20359,16038,51,700
"Lynchburg city, Virginia",80131,37515,42616,52076,22850,209,2178,24,776,2018,433,1585,80131,76937,3194,0.4734,0.0160,22972,26787,27283,14005,15839,17480,22550,,13166,9598,51,680
"Martinsville city, Virginia",13101,5867,7234,6398,6203,89,33,0,99,279,15,264,13101,12398,703,0.5078,0.0289,22669,29293,30776,8774,17024,19091,,-666666666,9277,4182,51,690
"Essex County, Virginia",11036,4962,6074,6129,4281,103,69,0,316,138,0,138,11036,10646,390,0.4175,0.0367,26603,32351,32206,13149,20562,24922,13299,-666666666,,15549,51,057
"Staunton city, Virginia",24452,11198,13254,20387,2853,71,350,0,82,709,34,675,24452,23723,729,0.4547,0.0335,28836,29464,29864,14594,28780,21445,30137,-666666666,13724,12847,51,790
"Radford city, Virginia",17630,8425,9205,14903,1723,4,271,10,120,599,73,526,17630,17118,512,0.5247,0.0512,20760,21346,21613,40234,13915,,5386,,3924,36604,51,750
"Craig County, Virginia",5113,2501,2612,5092,8,0,0,0,1,12,0,12,5113,5111,2,0.3860,0.0392,28686,28653,28653,,,-666666666,-666666666,-666666666,,,51,045
"Giles County, Virginia",16814,8252,8562,16250,363,0,35,21,1,144,2,142,16814,16529,285,0.3991,0.0205,26459,26711,26835,19586,22815,-666666666,21369,,,8869,51,071
"Rappahannock County, Virginia",7332,3630,3702,6617,354,13,99,0,85,164,93,71,7332,7069,263,0.4564,0.0255,37733,39770,40135,4629,24492,,37168,-666666666,1904,2589,51,157
"Ritchie County, West Virginia",9932,4965,4967,9829,7,0,0,0,58,38,0,38,9932,9880,52,0.4545,0.0354,24442,24522,24627,,,-666666666,-666666666,-666666666,,,54,085
"Lincoln County, West Virginia",21078,10539,10539,20809,84,0,34,10,0,141,0,141,21078,20898,180,0.4423,0.0416,19423,19398,19529,4345,,-666666666,,,-666666666,32720,54,043
"Putnam County, West Virginia",56652,27862,28790,54622,678,79,391,33,84,765,0,765,56652,56008,644,0.4361,0.0159,31277,30980,31020,38332,25824,24941,79507,,16849,34950,54,079
"Boone County, West Virginia",22817,11350,11467,22349,209,8,53,0,4,194,2,192,22817,22765,52,0.4607,0.0271,21394,21607,21546,47902,12136,,20157,-666666666,,8248,54,005
"Marshall County, West Virginia",31645,15730,15915,30846,310,131,78,34,33,213,45,168,31645,31326,319,0.4519,0.0224,24882,25282,25353,13890,3491,14449,32108,,19488,3775,54,051
"Tucker County, West Virginia",7027,3540,3487,6854,33,0,30,0,25,85,0,85,7027,6999,28,0.4035,0.0166,23670,24047,24085,,,-666666666,,-666666666,,8982,54,093
"Pleasants County, West Virginia",7507,4064,3443,7419,16,0,0,0,0,72,0,72,7507,7463,44,0.4732,0.0499,27522,27795,27898,10505,,-666666666,-666666666,-666666666,-666666666,,54,073
"Roane County, West Virginia",14205,7034,7171,13878,12,27,14,0,43,231,0,231,14205,14055,150,0.4700,0.0245,20574,20651,20799,2999,13183,16837,18579,-666666666,20744,16826,54,087
"Wood County, West Virginia",85556,41246,44310,82266,1143,142,421,32,115,1437,218,1219,85556,84608,948,0.4644,0.0126,27201,27457,27550,17673,11543,19115,72015,13653,19241,13603,54,107
"Mason County, West Virginia",26939,13026,13913,26241,110,22,40,0,25,501,76,425,26939,26755,184,0.4330,0.0190,21812,21813,21860,19468,13642,,,-666666666,,22697,54,053
"Jefferson County, West Virginia",56179,27743,28436,48887,3572,124,827,0,1142,1627,291,1336,56179,53068,3111,0.4074,0.0104,34750,36053,36412,25538,29488,13001,33718,-666666666,19575,19966,54,037
"Logan County, West Virginia",33801,16672,17129,32644,578,129,34,6,24,386,0,386,33801,33498,303,0.4772,0.0202,21672,21812,21864,13489,23124,,54638,,,9503,54,045
"Jefferson County, Washington",30856,15354,15502,28181,250,639,532,80,158,1016,33,983,30856,29754,1102,0.4505,0.0244,34187,35319,35435,29827,24476,15726,24011,52905,16335,23421,53,031
"Pacific County, Washington",21281,10640,10641,18839,72,302,387,126,599,956,22,934,21281,19272,2009,0.4201,0.0178,24474,25880,26798,13191,5321,19792,19347,7597,12597,11417,53,049
"Skamania County, Washington",11620,5861,5759,10799,103,246,129,18,147,178,0,178,11620,10900,720,0.4228,0.0223,30217,30698,31330,18569,4411,25424,39742,,15120,29911,53,059
"Clallam County, Washington",74487,36857,37630,65566,832,3515,1120,47,702,2705,212,2493,74487,69847,4640,0.4408,0.0120,29663,31029,31710,18550,11661,17657,33147,28994,13324,20521,53,009
"Klickitat County, Washington",21396,10751,10645,19614,47,672,165,3,465,430,17,413,21396,18815,2581,0.3991,0.0253,26128,26964,28565,13110,9051,15070,33046,,14315,17430,53,039
"Douglas County, Washington",41371,20821,20550,28998,160,324,315,85,9911,1578,535,1043,41371,28423,12948,0.4229,0.0407,28579,34252,35671,15236,22644,30231,37576,40102,14931,7906,53,017
"Pierce County, Washington",859840,427571,432269,631465,57437,10829,53544,12396,25083,69086,4015,65071,859840,768404,91436,0.4260,0.0045,32874,36283,37773,18557,28200,21973,29237,24053,17949,17133,53,053
"Walla Walla County, Washington",60236,30830,29406,50823,1106,443,994,90,4278,2502,378,2124,60236,47447,12789,0.4494,0.0213,27835,29768,32410,15494,16136,22370,22710,24528,17857,13933,53,071
"Snohomish County, Washington",786620,394526,392094,600480,22623,6920,81648,4251,22008,48690,5127,43563,786620,707737,78883,0.4046,0.0038,37671,40266,41672,22025,29830,26171,37228,20372,21245,20618,53,061
"Thurston County, Washington",274684,134402,140282,224549,8403,3939,15798,2378,3517,16100,1103,14997,274684,250720,23964,0.4091,0.0069,33901,35826,36878,21735,30041,24000,29694,24550,24974,18942,53,067
"Clark County, Washington",465384,230092,235292,393116,7845,2726,20853,3632,13758,23454,1807,21647,465384,422037,43347,0.4266,0.0068,34163,35582,36755,18522,29808,24843,37375,27003,18505,20344,53,011
"Adams County, Washington",19452,9844,9608,13481,150,715,199,0,4571,336,45,291,19452,7206,12246,0.4203,0.0218,19152,21680,29508,13487,9085,8254,29219,-666666666,13005,23074,53,001
"Skagit County, Washington",123907,61376,62531,101768,974,2216,2446,307,11383,4813,840,3973,123907,101230,22677,0.4427,0.0135,31822,34305,36177,15578,20184,20902,49537,28404,15143,17354,53,057
"Lincoln County, Washington",10435,5311,5124,9799,76,138,72,32,66,252,5,247,10435,10094,341,0.4057,0.0162,27730,28363,28733,14455,9213,23496,31760,33775,15815,12223,53,043
"Taylor County, Wisconsin",20356,10385,9971,19841,101,50,32,0,91,241,0,241,20356,19952,404,0.4165,0.0150,26881,27193,27316,15881,,20452,57719,-666666666,8659,16337,55,119
"Price County, Wisconsin",13490,6813,6677,12913,102,134,82,110,35,114,2,112,13490,13251,239,0.4083,0.0141,27569,27704,27971,27903,33509,13116,16577,11106,8566,53684,55,099
"Milwaukee County, Wisconsin",954209,461670,492539,569806,252321,5552,40777,310,51945,33498,5329,28169,954209,813634,140575,0.4790,0.0042,28121,35482,38257,16006,16727,20812,24710,32556,14924,14518,55,079
"Dunn County, Wisconsin",44498,22372,22126,41816,291,107,1204,0,128,952,113,839,44498,43681,817,0.4186,0.0168,27107,27918,28092,11676,6985,22396,17671,-666666666,15568,11639,55,033
"Green County, Wisconsin",36864,18230,18634,35466,166,94,235,16,399,488,12,476,36864,35754,1110,0.4129,0.0094,31959,32485,32702,19875,15736,34823,30262,,17382,12349,55,045
"Shawano County, Wisconsin",41009,20521,20488,36549,154,3060,120,9,57,1060,30,1030,41009,39890,1119,0.4153,0.0113,28051,29070,29511,12371,14782,21593,18661,,4988,15929,55,115
"Menominee County, Wisconsin",4579,2324,2255,468,21,3914,21,0,0,155,0,155,4579,4321,258,0.5043,0.0478,20538,45429,45944,8871,12614,17917,,-666666666,-666666666,12692,55,078
"Buffalo County, Wisconsin",13167,6658,6509,12774,74,28,15,0,117,159,3,156,13167,12894,273,0.4050,0.0134,29613,29964,30121,17420,11778,24193,23060,-666666666,18609,19423,55,011
"La Crosse County, Wisconsin",117850,57361,60489,107388,1711,397,5187,36,732,2399,132,2267,117850,115668,2182,0.4480,0.0094,31001,32247,32447,13589,14147,16713,23055,40194,12392,12307,55,063
"Eau Claire County, Wisconsin",102991,50874,52117,94925,938,492,3894,369,127,2246,202,2044,102991,100543,2448,0.4406,0.0120,29524,30516,30934,12449,14924,8875,22304,25072,28815,11524,55,035
"Polk County, Wisconsin",43349,21842,21507,41757,194,471,210,14,230,473,31,442,43349,42531,818,0.4044,0.0074,29489,30042,30163,17052,15314,19823,15510,6279,13872,10628,55,095
"Waukesha County, Wisconsin",398879,196103,202776,368232,6400,986,13845,141,3282,5993,535,5458,398879,380410,18469,0.4462,0.0058,44301,44984,45804,22896,21387,24573,53512,15662,20289,22588,55,133
"Vilas County, Wisconsin",21593,10931,10662,18733,81,1844,124,9,57,745,1,744,21593,21059,534,0.4717,0.0203,31206,33661,34086,13428,6652,15848,19769,,62225,9841,55,125
"Juneau County, Wisconsin",26419,14067,12352,24829,620,410,141,5,141,273,10,263,26419,25631,788,0.4387,0.0199,26137,26886,27226,15522,9193,17458,27552,,17145,13919,55,057
"Washington County, Wisconsin",134535,66754,67781,127736,1647,294,1688,30,973,2167,538,1629,134535,130354,4181,0.4098,0.0115,37631,38358,38744,18863,19885,39092,35968,29040,22301,16372,55,131
"Dane County, Wisconsin",529843,263322,266521,443347,27334,1555,31169,178,9429,16831,2060,14771,529843,496558,33285,0.4457,0.0045,38757,41803,42832,18749,18230,25151,30620,32035,17893,19925,55,025
"Fond du Lac County, Wisconsin",102315,50302,52013,95324,1416,513,1367,11,1731,1953,203,1750,102315,97190,5125,0.4180,0.0125,30454,31329,31843,17930,13573,22623,23900,,19362,16595,55,039
"Pepin County, Wisconsin",7262,3696,3566,7119,28,10,24,6,15,60,1,59,7262,7141,121,0.4268,0.0190,29227,29071,29304,13688,,,131633,,19713,15920,55,091
"Portage County, Wisconsin",70599,35508,35091,65756,512,262,1999,11,971,1088,99,989,70599,68375,2224,0.4249,0.0109,29742,30649,30905,18233,16899,14891,17470,,17491,17883,55,097
"Lincoln County, Wyoming",19011,9695,9316,18226,18,100,56,4,113,494,65,429,19011,18140,871,0.4029,0.0255,30106,30668,31255,15459,,23468,20389,,21054,14833,56,023
"Laramie County, Wyoming",97692,49460,48232,86891,2411,707,1090,202,2879,3512,539,2973,97692,83554,14138,0.4237,0.0131,32920,33852,35077,22645,33953,34210,36738,12823,19808,19607,56,021
"Juana D�az Municipio, Puerto Rico",46960,22378,24582,21730,4089,34,90,0,5947,15070,243,14827,46960,72,46888,0.5102,0.0269,10611,11238,16631,10603,10352,13771,,-666666666,10988,9671,72,075
"Santa Isabel Municipio, Puerto Rico",22066,10650,11416,12470,7762,45,0,0,1728,61,25,36,22066,89,21977,0.5233,0.0339,10895,10405,,10928,11613,13813,-666666666,-666666666,10839,19187,72,133
"Guayama Municipio, Puerto Rico",41706,20744,20962,30198,5812,0,99,150,4951,496,87,409,41706,497,41209,0.5077,0.0340,9806,9768,7627,9816,10413,-666666666,19836,,9626,7468,72,057
"Gurabo Municipio, Puerto Rico",46894,22173,24721,31350,5739,18,61,0,8809,917,112,805,46894,1085,45809,0.5194,0.0293,17393,19438,20133,17411,13169,,,-666666666,13304,14272,72,063
"Lo�za Municipio, Puerto Rico",26463,12337,14126,6284,10072,40,71,0,9872,124,78,46,26463,66,26397,0.4943,0.0183,8809,10755,,8806,8674,,11599,-666666666,7703,6949,72,087
"Aguadilla Municipio, Puerto Rico",54166,26308,27858,41694,1999,115,387,10,8789,1172,315,857,54166,1308,52858,0.5605,0.0256,11339,11793,23015,11111,13509,6070,14580,,8959,8877,72,005
"Las Mar�as Municipio, Puerto Rico",8599,4147,4452,4430,91,0,0,0,4012,66,17,49,8599,50,8549,0.5357,0.0387,7098,7483,12216,7068,7568,-666666666,-666666666,-666666666,6713,4058,72,083
"Villalba Municipio, Puerto Rico",22993,11169,11824,12293,647,0,0,0,3452,6601,144,6457,22993,57,22936,0.5172,0.0767,10677,11436,6359,10665,19794,-666666666,-666666666,-666666666,8457,9531,72,149
"Carolina Municipio, Puerto Rico",157453,72157,85296,84705,34719,2945,450,16,21012,13606,1660,11946,157453,1886,155567,0.4785,0.0122,16536,17760,32843,16352,14700,13009,24423,,14110,17841,72,031
"Corozal Municipio, Puerto Rico",34165,16565,17600,27208,2218,0,0,0,3424,1315,131,1184,34165,354,33811,0.5205,0.0245,7619,7620,6763,7631,5503,-666666666,-666666666,-666666666,7089,12554,72,047
"Ponce Municipio, Puerto Rico",143926,69272,74654,111378,7834,202,95,0,11566,12851,587,12264,143926,938,142988,0.5814,0.0176,11368,12032,14406,11353,9378,14501,8454,-666666666,10527,7555,72,113
"Toa Baja Municipio, Puerto Rico",79726,37382,42344,53742,8639,20,0,0,9418,7907,282,7625,79726,794,78932,0.4804,0.0155,12763,13531,31205,12621,10654,,-666666666,-666666666,11436,10921,72,137
"Aguada Municipio, Puerto Rico",38643,18906,19737,30730,1070,0,0,0,1540,5303,91,5212,38643,2530,36113,0.5035,0.0160,9287,9151,15264,8848,9955,-666666666,-666666666,-666666666,9363,9915,72,003
"Ciales Municipio, Puerto Rico",16912,8240,8672,16305,166,0,0,0,136,305,75,230,16912,150,16762,0.5243,0.0566,8398,8471,6013,8420,7450,-666666666,-666666666,-666666666,8079,5180,72,039
"Cidra Municipio, Puerto Rico",40343,19560,20783,33244,3639,121,68,0,2279,992,8,984,40343,278,40065,0.5069,0.0173,11079,11050,11089,11092,9089,7472,,-666666666,12338,17300,72,041
"Luquillo Municipio, Puerto Rico",18547,8705,9842,10968,1870,20,63,0,5268,358,68,290,18547,279,18268,0.4889,0.0254,11007,11888,26007,10848,11186,,20517,-666666666,8089,24523,72,089
"San Lorenzo Municipio, Puerto Rico",37873,18450,19423,29306,6383,45,46,0,644,1449,132,1317,37873,56,37817,0.4966,0.0230,10974,10903,-666666666,10944,10934,,,-666666666,14994,10006,72,129
"Jayuya Municipio, Puerto Rico",14906,7428,7478,10248,303,47,5,0,3904,399,77,322,14906,57,14849,0.4883,0.0369,7519,7776,,7528,6446,7991,,-666666666,7282,4080,72,073
"R�o Grande Municipio, Puerto Rico",50550,24397,26153,26952,6570,73,152,0,15805,998,245,753,50550,293,50257,0.4705,0.0243,10931,11690,14135,10902,12152,6526,11559,-666666666,9210,9847,72,119
"Vega Baja Municipio, Puerto Rico",53371,25580,27791,45626,2725,68,0,26,4341,585,218,367,53371,1574,51797,0.5095,0.0193,10601,10337,5896,10724,11989,12671,-666666666,,11764,12938,72,145
"Guayanilla Municipio, Puerto Rico",19008,9076,9932,14608,368,131,123,0,3534,244,22,222,19008,92,18916,0.4631,0.0245,8717,8950,17198,8685,15004,4604,5394,-666666666,7377,8552,72,059
"Lajas Municipio, Puerto Rico",23315,11355,11960,7203,330,11,0,0,15379,392,361,31,23315,80,23235,0.5329,0.0320,7233,9702,,7177,7718,,-666666666,-666666666,5915,13315,72,079
"Marion County, Alabama",29965,14898,15067,27886,1097,122,49,0,300,511,1,510,29965,29213,752,0.4596,0.0185,21391,21909,21878,14800,18887,14893,26233,-666666666,5758,8732,01,093
"Jefferson County, Alabama",659892,312348,347544,342591,281702,1564,10250,215,12398,11172,1337,9835,659892,634844,25048,0.4996,0.0047,30657,40398,41002,17286,20171,23272,33215,33530,11680,16046,01,073
"Franklin County, Alabama",31542,15602,15940,26467,1388,488,119,0,2767,313,21,292,31542,26209,5333,0.4224,0.0191,19776,20975,21568,12514,20321,13902,1744,-666666666,11420,5852,01,059
"Cherokee County, Alabama",25853,12820,13033,23997,1267,236,55,0,90,208,0,208,25853,25455,398,0.4539,0.0249,23356,23877,24031,9589,20540,3723,,-666666666,,12604,01,019
"Dallas County, Alabama",40029,18448,21581,11257,28210,10,224,23,25,280,33,247,40029,39617,412,0.4885,0.0149,18910,29254,29323,28415,14647,,43935,,,9568,01,047
"Macon County, Alabama",19054,8790,10264,3025,15740,63,50,0,107,69,0,69,19054,18726,328,0.5145,0.0213,20125,27988,26188,25198,18701,15014,10704,-666666666,8173,30243,01,087
"Shelby County, Alabama",211261,102478,108783,169598,25455,468,4249,47,7515,3929,305,3624,211261,199136,12125,0.4344,0.0098,36576,38861,39112,18457,29561,43134,45465,32621,12050,19955,01,117
"Baldwin County, Alabama",208107,101188,106919,179526,19764,1522,1680,9,2034,3572,603,2969,208107,198754,9353,0.4609,0.0097,31203,33264,33767,19797,16965,20681,29943,,18613,18526,01,003
"Houston County, Alabama",104352,50029,54323,72387,28078,305,873,18,522,2169,175,1994,104352,100915,3437,0.4808,0.0075,25990,30086,30570,15941,16392,23439,37991,,16312,11635,01,069
"Tuscaloosa County, Alabama",206213,99539,106674,132877,65260,393,3302,73,1983,2325,145,2180,206213,198776,7437,0.4630,0.0090,26064,30128,30722,14305,18972,17550,23557,,10304,12117,01,125
"Clay County, Alabama",13378,6464,6914,11106,1977,155,18,0,26,96,7,89,13378,12963,415,0.4684,0.0350,23147,24638,25163,8475,17695,3377,,-666666666,,2703,01,027
"Pike County, Alabama",33403,16027,17376,18960,12697,209,715,3,23,796,29,767,33403,33140,263,0.5343,0.0325,21137,25823,25869,19625,15154,14019,17365,,,9265,01,109
"Coosa County, Alabama",10855,5501,5354,7133,3713,9,0,0,0,0,0,0,10855,10805,50,0.4646,0.0519,22963,26661,26737,15476,15896,,-666666666,-666666666,-666666666,-666666666,01,037
"Hale County, Alabama",14887,7019,7868,5898,8748,29,39,0,101,72,40,32,14887,14757,130,0.5071,0.0290,20272,29260,29260,21065,14379,,,-666666666,31053,,01,065
"Escambia County, Alabama",37328,19067,18261,23095,11920,1437,135,72,232,437,26,411,37328,36490,838,0.4823,0.0188,18161,21685,21810,16885,11335,20857,16369,,15504,9798,01,053
"Butler County, Alabama",20025,9368,10657,10414,9055,2,231,0,0,323,9,314,20025,19958,67,0.4708,0.0248,20430,26147,26191,13063,13963,,27322,-666666666,-666666666,12393,01,013
"Perry County, Alabama",9486,4436,5050,2838,6588,6,21,0,33,0,0,0,9486,9397,89,0.4790,0.0374,13678,17773,17934,6975,11968,,,-666666666,,-666666666,01,105
"Conecuh County, Alabama",12514,6037,6477,6369,5971,56,18,0,2,98,0,98,12514,12409,105,0.4354,0.0314,17542,21161,21315,9971,14014,9263,,-666666666,,2741,01,035
"Bibb County, Alabama",22527,12152,10375,17268,5018,8,37,0,9,187,0,187,22527,21980,547,0.4294,0.0261,20199,22566,22686,18164,11321,,,-666666666,,16242,01,007
"Chambers County, Alabama",33826,16257,17569,19483,13319,97,405,0,175,347,0,347,33826,33058,768,0.4568,0.0318,22827,25938,25793,28989,17714,118581,31252,-666666666,,8675,01,017
"Fayette County, Alabama",16585,8170,8415,14095,1978,0,108,6,0,398,0,398,16585,16300,285,0.4635,0.0302,21862,23502,23591,5128,14664,-666666666,5795,,-666666666,4257,01,057
"Blount County, Alabama",57645,28434,29211,55054,862,141,198,18,437,935,31,904,57645,52384,5261,0.4331,0.0196,22656,23002,24328,9885,14362,26589,26178,,15958,11115,01,009
"Autauga County, Alabama",55200,26874,28326,42437,10565,159,568,32,409,1030,18,1012,55200,53672,1528,0.4602,0.0410,29372,32593,32469,31866,18854,28861,22348,,21465,12149,01,001
"Geneva County, Alabama",26491,12971,13520,22871,2529,210,109,4,243,525,68,457,26491,25464,1027,0.4413,0.0199,20471,21569,21875,9467,11999,24404,17659,,10563,17185,01,061
"Valdez-Cordova Census Area, Alaska",9301,4898,4403,6803,25,1188,327,57,125,776,24,752,9301,8835,466,0.4226,0.0342,38507,44219,45203,31149,21808,20629,23554,17084,51040,22198,02,261
"Hoonah-Angoon Census Area, Alaska",2132,1095,1037,971,68,821,60,3,24,185,0,185,2132,1990,142,0.3914,0.0240,35355,46925,47163,29353,71766,22187,32575,,,19365,02,105
"Wrangell City and Borough, Alaska",2484,1302,1182,1670,2,496,69,9,30,208,0,208,2484,2363,121,0.4071,0.0282,31489,37203,37436,14914,,19542,23677,,,17940,02,275
"Pima County, Arizona",1019722,501879,517843,777452,35973,38200,29475,1610,88847,48165,11600,36565,1019722,642896,376826,0.4713,0.0044,28480,31521,37007,18404,21280,14280,32033,24242,17032,15119,04,019
"Gila County, Arizona",53400,26370,27030,41095,317,8562,486,20,1133,1787,166,1621,53400,43408,9992,0.4451,0.0137,22939,26135,27587,18306,10070,11688,13346,,14656,13554,04,007
"Cochise County, Arizona",126279,64135,62144,107243,4734,1642,2362,464,4096,5738,1041,4697,126279,81681,44598,0.4404,0.0111,25436,25955,31230,16266,31467,25513,26656,19432,18532,15649,04,003
"Apache County, Arizona",71522,35240,36282,16362,513,52708,286,18,497,1138,151,987,71522,67077,4445,0.4950,0.0126,14499,24911,28481,12205,14996,11007,24426,26139,29685,17005,04,001
"Yavapai County, Arizona",224645,109795,114850,205647,1274,3202,2247,226,6477,5572,356,5216,224645,192184,32461,0.4462,0.0103,28829,29619,31157,18177,34038,18141,30466,7592,18931,16322,04,025
"Navajo County, Arizona",108705,54533,54172,51934,964,48328,685,87,3459,3248,286,2962,108705,96376,12329,0.4751,0.0112,18333,25868,27224,14505,14486,11236,25092,7699,12654,9502,04,017
"Pulaski County, Arkansas",393463,188496,204967,222468,143508,944,8592,170,6810,10971,1872,9099,393463,369385,24078,0.5025,0.0070,31359,39881,41465,15480,19384,26715,40147,39169,15228,18611,05,119
"Clay County, Arkansas",15061,7414,7647,14443,93,66,0,0,232,227,6,221,15061,14761,300,0.4574,0.0276,20353,20790,20789,14365,12453,14700,-666666666,-666666666,13242,4663,05,021
"Dallas County, Arkansas",7432,3618,3814,4123,3093,31,26,15,58,86,0,86,7432,7203,229,0.4104,0.0284,19401,20950,21320,10496,18336,,,13627,,2594,05,039
"Randolph County, Arkansas",17603,8784,8819,16854,201,84,0,0,107,357,12,345,17603,17259,344,0.4593,0.0377,21338,21579,21728,8916,33950,11029,-666666666,-666666666,5432,10049,05,121
"Boone County, Arkansas",37288,18350,18938,35843,156,290,192,36,11,760,17,743,37288,36389,899,0.4451,0.0206,23998,24059,24272,14226,37889,9308,8295,,7936,27283,05,009
"Independence County, Arkansas",37264,18092,19172,34252,693,76,236,7,1007,993,163,830,37264,34959,2305,0.4500,0.0241,23426,23978,24479,9545,28283,5963,31839,,10524,13476,05,063
"Grant County, Arkansas",18086,8870,9216,17182,541,33,9,0,16,305,42,263,18086,17605,481,0.4394,0.0393,25907,25751,26053,16221,35067,8330,,-666666666,28213,19797,05,053
"Faulkner County, Arkansas",122416,59911,62505,100652,13904,493,1634,163,2496,3074,263,2811,122416,117460,4956,0.4615,0.0145,26163,28095,28347,15124,17960,55694,15331,,14325,11809,05,045
"Marion County, Arkansas",16438,7990,8448,15805,145,187,71,0,18,212,0,212,16438,16072,366,0.4433,0.0279,19710,20152,20393,8072,4477,14406,4379,-666666666,,6346,05,089
"Searcy County, Arkansas",7923,3981,3942,7421,54,203,96,0,28,121,37,84,7923,7740,183,0.4693,0.0431,20709,21256,21209,11505,,9073,,-666666666,20229,8883,05,129
"Crawford County, Arkansas",62472,30761,31711,55196,978,1237,1171,9,1871,2010,74,1936,62472,57757,4715,0.4456,0.0303,23851,25064,25409,13528,15228,17888,15658,,10947,15279,05,033
"Hot Spring County, Arkansas",33520,17418,16102,28346,4032,22,141,10,439,530,61,469,33520,32372,1148,0.4369,0.0335,21064,21965,22312,14585,15951,33318,6401,,15249,20402,05,059
"Madison County, Arkansas",16076,8038,8038,15105,87,211,162,59,89,363,34,329,16076,15180,896,0.4787,0.0381,23875,24825,25471,11789,12778,7079,14662,,11887,6592,05,087
"Howard County, Arkansas",13389,6440,6949,8964,2761,27,34,14,1305,284,0,284,13389,11758,1631,0.5284,0.0447,24590,28550,29158,9375,20189,,,,8840,16040,05,061
"Mississippi County, Arkansas",42831,20876,21955,25863,15070,28,236,25,861,748,29,719,42831,41103,1728,0.4622,0.0191,20879,24627,25101,11567,15646,40004,13650,,14123,6711,05,093
"Union County, Arkansas",39732,19332,20400,25485,12972,391,227,0,232,425,25,400,39732,38192,1540,0.4739,0.0221,24522,29121,29683,17305,15451,12664,81476,-666666666,14842,11373,05,139
"Geauga County, Ohio",93961,46425,47536,90888,1157,167,565,0,114,1070,159,911,93961,92600,1361,0.4657,0.0170,42149,42644,42824,22653,25769,14771,36659,-666666666,22675,27006,39,055
"Monroe County, Ohio",14090,7012,7078,13841,39,5,57,0,2,146,7,139,14090,13940,150,0.4625,0.0287,25141,25363,25612,1682,4490,,21361,-666666666,,11726,39,111
"Lake County, Ohio",230052,112379,117673,209948,9390,334,2816,46,2186,5332,256,5076,230052,220191,9861,0.4198,0.0075,33737,34799,35346,16956,21855,23190,40601,19639,22755,14518,39,085
"Clark County, Ohio",135198,65405,69793,117294,10641,258,836,96,865,5208,84,5124,135198,130686,4512,0.4305,0.0093,25948,27269,27730,12278,20928,19872,25832,11914,13320,9121,39,023
"Holmes County, Ohio",43859,21874,21985,43138,48,14,85,0,44,530,114,416,43859,43450,409,0.4275,0.0197,22923,22948,22869,41765,17696,,5468,-666666666,22689,24177,39,075
"Warren County, Ohio",226564,114030,112534,200647,7682,208,12340,0,1656,4031,120,3911,226564,220526,6038,0.4270,0.0105,39448,39973,40397,23123,27183,8438,46902,-666666666,29277,19643,39,165
"Ashland County, Ohio",53477,26101,27376,51672,436,3,396,0,230,740,45,695,53477,52764,713,0.4087,0.0156,25471,25396,25461,33333,9714,,26336,-666666666,65982,26951,39,005
"Seminole County, Oklahoma",25071,12278,12793,17080,1192,4920,88,1,128,1662,111,1551,25071,23831,1240,0.4516,0.0144,20460,22541,22959,12734,18556,15650,14693,,16018,15316,40,133
"Blaine County, Oklahoma",9634,5038,4596,7616,399,712,2,0,386,519,39,480,9634,8631,1003,0.4485,0.0313,25708,28428,29860,9414,14489,20747,,-666666666,8969,13416,40,011
"Coal County, Oklahoma",5618,2818,2800,3941,7,683,11,0,107,869,49,820,5618,5359,259,0.5063,0.0523,24399,27450,27794,9615,24457,18438,,-666666666,19475,16028,40,029
"Kingfisher County, Oklahoma",15618,7800,7818,12919,172,522,35,0,1379,591,67,524,15618,13179,2439,0.4627,0.0319,32049,35064,36059,17457,37833,21533,,-666666666,14400,13609,40,073
"Marshall County, Oklahoma",16376,8117,8259,11494,241,1227,37,0,1859,1518,178,1340,16376,13530,2846,0.4522,0.0277,23872,25814,26248,15441,81758,17656,5632,-666666666,14033,17494,40,095
"Nowata County, Oklahoma",10383,5125,5258,7060,257,1636,30,16,149,1235,29,1206,10383,10078,305,0.4238,0.0172,22147,25143,25212,11968,14535,17846,23500,11806,5722,14382,40,105
"Rogers County, Oklahoma",90814,45246,45568,67941,983,11304,1264,63,1077,8182,167,8015,90814,86645,4169,0.4257,0.0104,30886,33362,33765,20756,34203,23919,24288,17083,23878,21595,40,131
"Alfalfa County, Oklahoma",5857,3477,2380,4546,191,131,0,0,170,819,39,780,5857,5548,309,0.4764,0.0603,27871,31374,31673,22420,5432,8982,-666666666,-666666666,33564,15504,40,003
"Cleveland County, Oklahoma",276733,138143,138590,215798,12860,10939,12298,170,4269,20399,1060,19339,276733,253426,23307,0.4317,0.0084,30507,32905,33715,20409,24370,23796,26510,13456,16676,18056,40,027
"Atoka County, Oklahoma",13874,7306,6568,10104,536,1447,86,8,131,1562,17,1545,13874,13388,486,0.4879,0.0247,20733,23255,23536,11593,7032,15880,12267,,7724,15152,40,005
"Dewey County, Oklahoma",4918,2449,2469,4380,8,105,32,0,8,385,8,377,4918,4565,353,0.4872,0.0425,27432,29058,30797,6693,,17794,16434,-666666666,,13350,40,043
"Logan County, Oklahoma",46044,22846,23198,38149,3945,1680,162,20,157,1931,119,1812,46044,43290,2754,0.4515,0.0160,29387,31886,32874,16318,14891,30343,22490,,14808,10875,40,083
"Washington County, Oklahoma",52001,25253,26748,40278,1359,5665,1076,20,568,3035,183,2852,52001,48936,3065,0.4836,0.0154,30267,32764,33491,19478,20706,21047,31113,,19380,20331,40,147
"Haskell County, Oklahoma",12704,6311,6393,9287,106,1498,88,2,85,1638,57,1581,12704,12155,549,0.4455,0.0130,21280,23510,23946,9144,15241,15296,12007,,16087,15296,40,061
"Okmulgee County, Oklahoma",38889,19160,19729,25309,3314,5286,130,0,198,4652,115,4537,38889,37337,1552,0.4570,0.0241,22400,24788,25209,13527,20245,17037,35405,-666666666,19056,16817,40,111
"Jefferson County, Oklahoma",6223,3104,3119,5270,80,400,2,0,208,263,16,247,6223,5578,645,0.4350,0.0150,19155,19977,20860,11114,18453,12109,,-666666666,15269,16839,40,067
"Garvin County, Oklahoma",27823,13807,14016,23202,677,1495,93,0,147,2209,33,2176,27823,25448,2375,0.4411,0.0137,23020,23930,25149,11842,20924,20277,9060,-666666666,15134,17074,40,049
"Pontotoc County, Oklahoma",38358,18768,19590,26590,813,4037,296,30,313,6279,91,6188,38358,36345,2013,0.4440,0.0155,24683,27458,28139,12230,18864,22414,18620,,17120,15902,40,123
"Hughes County, Oklahoma",13460,7184,6276,9079,804,2752,18,0,34,773,22,751,13460,12736,724,0.4893,0.0361,20438,25084,26314,7392,6816,11424,24128,-666666666,8221,12583,40,063
"Comanche County, Oklahoma",122561,63585,58976,77455,20654,6389,2964,648,2902,11549,804,10745,122561,106759,15802,0.4500,0.0161,26149,28463,29393,19760,23173,18811,34360,20927,27428,17878,40,031
"Pawnee County, Oklahoma",16428,8216,8212,12939,155,1983,68,7,12,1264,13,1251,16428,15931,497,0.4398,0.0211,23916,25181,25314,17411,14021,22239,10818,32943,,15530,40,117
"Douglas County, Oregon",108323,53470,54853,100217,471,1396,1138,87,702,4312,188,4124,108323,102193,6130,0.4377,0.0151,25602,25857,26512,17264,26307,33542,31518,24293,21528,16154,41,019
"Polk County, Oregon",81427,39563,41864,71640,893,1571,1542,372,2293,3116,297,2819,81427,70301,11126,0.4294,0.0173,27492,28874,30467,15647,15278,21380,23566,15809,19051,11862,41,053
"Deschutes County, Oregon",180640,89209,91431,168883,1044,820,2223,110,2328,5232,424,4808,180640,166441,14199,0.4462,0.0135,34187,34839,36078,17267,24175,27519,37440,19346,19545,21638,41,017
"Yamhill County, Oregon",103820,51894,51926,91687,893,1219,1506,268,4015,4232,510,3722,103820,87382,16438,0.4472,0.0150,29141,30376,32449,16825,8722,18482,25430,10003,15609,25131,41,071
"Klamath County, Oregon",66310,33142,33168,58349,529,2583,677,63,1127,2982,267,2715,66310,57897,8413,0.4432,0.0123,24296,25407,26692,15005,16061,17229,26183,12541,17939,12367,41,035
"Benton County, Oregon",89780,45317,44463,76886,888,521,6439,232,1170,3644,211,3433,89780,83235,6545,0.4861,0.0136,32297,34065,35179,17749,15219,23702,22985,19686,23547,20471,41,003
"Crook County, Oregon",22337,10916,11421,20725,83,180,82,100,398,769,233,536,22337,20646,1691,0.4245,0.0292,25128,26051,26451,15053,7958,23888,30704,,14646,9981,41,013
"Harney County, Oregon",7228,3657,3571,6571,37,118,0,4,69,429,0,429,7228,6863,365,0.4398,0.0336,25871,26775,27260,15414,,14349,-666666666,,13788,18917,41,025
"Wallowa County, Oregon",6924,3402,3522,6582,16,72,24,6,54,170,12,158,6924,6721,203,0.4563,0.0284,28960,29446,29609,21148,,10124,12667,,30235,21491,41,063
"Wheeler County, Oregon",1426,728,698,1338,0,10,6,0,0,72,15,57,1426,1288,138,0.4361,0.0332,21375,21729,21990,20250,-666666666,24580,,-666666666,-666666666,13019,41,069
"Coos County, Oregon",63308,31042,32266,55911,499,1477,741,54,1424,3202,102,3100,63308,59267,4041,0.4743,0.0206,26610,27725,28110,13614,7759,23137,43801,,12437,14103,41,011
"Hood River County, Oregon",23131,11528,11603,20031,124,160,350,5,1532,929,394,535,23131,15851,7280,0.4428,0.0407,32581,32913,39273,19240,8203,34834,44216,,35086,19891,41,027
"Multnomah County, Oregon",798647,395653,402994,621439,43397,7093,58124,4949,19885,43760,3919,39841,798647,707517,91130,0.4766,0.0049,36868,40617,42848,20554,21758,20934,28941,22253,20489,20824,41,051
"Franklin County, Pennsylvania",153751,75503,78248,142843,5882,223,1265,16,692,2830,389,2441,153751,145397,8354,0.4138,0.0128,29748,30362,31070,15833,20505,36215,45629,,24611,11697,42,055
"Bedford County, Pennsylvania",48611,24200,24411,47439,262,54,187,0,115,554,77,477,48611,48036,575,0.4192,0.0122,25163,25438,25517,14295,21531,22889,17093,-666666666,9185,9612,42,009
"Somerset County, Pennsylvania",74949,39038,35911,71364,1941,60,297,24,349,914,61,853,74949,73845,1104,0.4322,0.0135,25294,26054,26130,13209,6530,36222,34067,,2719,10312,42,111
"York County, Pennsylvania",444014,219415,224599,394242,25790,660,6730,198,5656,10738,831,9907,444014,411986,32028,0.4185,0.0059,31468,32866,33933,15137,21640,29114,27828,8049,16608,14404,42,133
"Bradford County, Pennsylvania",61304,30206,31098,59418,270,39,415,6,236,920,84,836,61304,60424,880,0.4310,0.0151,27319,27546,27617,24786,11930,19077,26157,,39705,14770,42,015
"Chester County, Pennsylvania",517156,254746,262410,441326,30706,557,26777,120,6601,11069,1191,9878,517156,479298,37858,0.4572,0.0057,48225,50329,52287,22125,27970,29222,55453,25527,19893,21143,42,029
"Indiana County, Pennsylvania",85755,42835,42920,81170,1938,210,839,15,241,1342,74,1268,85755,84648,1107,0.4557,0.0152,25276,26003,26086,12630,9499,39084,16358,,6908,10935,42,063
"Washington County, Pennsylvania",207547,101709,105838,194228,6455,192,2023,37,489,4123,130,3993,207547,204130,3417,0.4539,0.0069,34244,35042,35212,24107,23132,12552,36233,43624,14266,16387,42,125
"Pike County, Pennsylvania",55498,28072,27426,49429,3438,71,844,30,711,975,251,724,55498,49587,5911,0.4361,0.0160,33111,33697,34056,29239,28591,27745,36887,45223,26381,21021,42,103
"Lehigh County, Pennsylvania",362613,177051,185562,284590,25293,1148,12165,127,26767,12523,2205,10318,362613,277167,85446,0.4531,0.0073,32252,35401,39151,15919,20582,15928,39301,5731,15828,14302,42,077
"Clarion County, Pennsylvania",38827,18962,19865,37487,426,83,207,24,66,534,17,517,38827,38493,334,0.4330,0.0154,24293,24744,24636,34181,8665,17278,16859,,13394,10882,42,031
"Clearfield County, Pennsylvania",80216,41905,38311,76181,2249,181,397,0,164,1044,223,821,80216,77875,2341,0.4284,0.0132,23743,24490,24733,14429,4680,6998,16987,-666666666,6941,18450,42,033
"Lycoming County, Pennsylvania",114859,56457,58402,105534,5518,180,811,18,632,2166,157,2009,114859,112581,2278,0.4230,0.0096,26867,28102,28246,15748,12243,28156,25400,35294,10448,9080,42,081
"Warren County, Pennsylvania",40035,20013,20022,39110,191,51,211,0,79,393,16,377,40035,39615,420,0.4325,0.0187,27593,27844,27515,55855,18761,20657,30230,-666666666,7905,10330,42,123
"Elk County, Pennsylvania",30608,15423,15185,30000,167,76,160,0,26,179,4,175,30608,30367,241,0.4081,0.0138,28476,28741,28725,28865,4113,35400,26121,-666666666,9373,8584,42,047
"Mercer County, Pennsylvania",112630,55546,57084,102752,6386,123,776,4,335,2254,96,2158,112630,111009,1621,0.4381,0.0124,26561,27732,27838,16731,14880,24743,25736,,16583,8169,42,085
"Sullivan County, Pennsylvania",6177,3253,2924,5809,192,16,26,6,50,78,13,65,6177,6043,134,0.4249,0.0198,28665,29784,29784,22847,7165,32631,15142,,13608,13856,42,113
"Kent County, Rhode Island",163861,79219,84642,150863,2754,442,4201,23,1954,3624,500,3124,163861,156237,7624,0.4439,0.0101,38039,38887,39244,28265,26880,27043,36087,,32692,17857,44,003
"Washington County, Rhode Island",126242,61110,65132,117380,1779,968,2427,110,1394,2184,237,1947,126242,122328,3914,0.4435,0.0118,41000,42158,42426,26230,20643,25791,39806,32804,24348,14426,44,009
"Oconee County, South Carolina",76696,37801,38895,67358,5433,331,517,13,1099,1945,93,1852,76696,72613,4083,0.4853,0.0166,28076,29622,30212,12105,20013,11490,46353,,10465,4996,45,073
"Allendale County, South Carolina",9214,4913,4301,2165,6974,30,6,3,0,36,6,30,9214,9076,138,0.4995,0.0329,14744,21898,22747,8907,12475,,,,-666666666,,45,005
"Chester County, South Carolina",32326,15747,16579,19601,11938,157,35,0,17,578,0,578,32326,31693,633,0.4712,0.0185,21240,24355,24607,15810,16150,19100,200291,-666666666,,11106,45,023
"Marion County, South Carolina",31562,14655,16907,12532,17913,189,225,0,408,295,87,208,31562,30682,880,0.5254,0.0546,19992,27370,28012,9434,15408,5043,13502,-666666666,13473,8449,45,067
"Charleston County, South Carolina",394708,191191,203517,269342,107789,674,5621,137,3144,8001,259,7742,394708,374764,19944,0.5058,0.0072,37801,45864,47344,20857,19511,26527,39093,11089,16031,21849,45,019
"Marlboro County, South Carolina",27131,14236,12895,11249,13735,810,80,0,199,1058,43,1015,27131,26235,896,0.4676,0.0247,17034,21770,22867,3251,14163,10849,36936,-666666666,5306,9385,45,069
"Cherokee County, South Carolina",56711,27529,29182,42693,11366,103,349,25,842,1333,151,1182,56711,54319,2392,0.5036,0.0352,21432,23889,24293,14221,14696,13673,11570,9576,18117,5683,45,021
"Jasper County, South Carolina",27900,14070,13830,14577,12015,27,156,0,843,282,0,282,27900,24216,3684,0.4564,0.0373,22406,29385,33400,12525,14416,,21124,-666666666,12869,6812,45,053
"Lee County, South Carolina",17606,9164,8442,5753,11549,25,6,0,112,161,0,161,17606,17183,423,0.4939,0.0310,17544,27005,27243,10488,12920,19240,,-666666666,,16391,45,061
"Spartanburg County, South Carolina",302195,146535,155660,221844,61724,526,6744,75,4693,6589,570,6019,302195,282058,20137,0.4561,0.0083,26072,28784,29629,16288,18843,22747,23914,74003,15501,11928,45,083
"Beaufort County, South Carolina",182658,89979,92679,137473,33074,477,2356,136,5234,3908,523,3385,182658,162246,20412,0.4759,0.0115,36306,41835,44637,16899,19270,20822,38771,41821,16696,12467,45,013
"Saluda County, South Carolina",20299,10200,10099,13213,5106,56,0,0,1628,296,0,296,20299,17134,3165,0.4352,0.0331,22174,26880,28179,13410,14505,,-666666666,-666666666,10362,13164,45,081
"Hutchinson County, South Dakota",7315,3605,3710,7033,0,149,28,0,2,103,4,99,7315,7149,166,0.4286,0.0182,27995,28666,28923,10251,-666666666,9607,,-666666666,,11073,46,067
"Buffalo County, South Dakota",2053,1018,1035,252,3,1756,0,22,0,20,0,20,2053,1987,66,0.4545,0.0329,11471,23815,23815,8648,,9895,-666666666,,-666666666,,46,017
"Dewey County, South Dakota",5779,2869,2910,1170,6,4529,5,0,4,65,3,62,5779,5721,58,0.4630,0.0258,16967,36144,36155,6834,59733,11830,,-666666666,,25605,46,041
"Hughes County, South Dakota",17617,8610,9007,14770,56,2189,82,0,50,470,4,466,17617,17076,541,0.4210,0.0326,33810,38194,38469,14131,8382,10102,6284,-666666666,,15837,46,065
"Sanborn County, South Dakota",2388,1233,1155,2304,0,20,10,0,33,21,0,21,2388,2301,87,0.4543,0.0391,32404,32795,32983,21195,-666666666,7605,,-666666666,15027,43824,46,111
"Hand County, South Dakota",3301,1674,1627,3256,3,0,18,0,0,24,0,24,3301,3275,26,0.4598,0.0524,33865,33801,34051,,,-666666666,,-666666666,-666666666,,46,059
"Yankton County, South Dakota",22717,11705,11012,20919,360,693,50,15,149,531,28,503,22717,21764,953,0.4824,0.0409,31986,33633,34207,16463,16051,9728,17586,,12304,14025,46,135
"Beadle County, South Dakota",18374,9460,8914,15275,144,258,1703,8,776,210,0,210,18374,16571,1803,0.3899,0.0189,26316,28727,29909,16932,11866,8958,11709,,23061,13678,46,005
"Davison County, South Dakota",19901,9963,9938,18546,160,431,68,0,175,521,0,521,19901,19333,568,0.4445,0.0350,29342,29646,30084,12745,13358,31799,97384,-666666666,23325,14521,46,035
"Jerauld County, South Dakota",2029,996,1033,1982,0,21,0,0,6,20,0,20,2029,1992,37,0.5358,0.0722,38650,38850,39335,11943,-666666666,49848,-666666666,-666666666,,,46,073
"Stanley County, South Dakota",2997,1549,1448,2586,0,290,0,35,0,86,13,73,2997,2925,72,0.3796,0.0367,35936,38848,37952,67167,-666666666,16909,-666666666,,-666666666,20698,46,117
"Potter County, South Dakota",2326,1179,1147,2181,0,42,33,0,14,56,23,33,2326,2258,68,0.4337,0.0277,31467,32690,33054,,-666666666,,35261,-666666666,,,46,107
"Charles Mix County, South Dakota",9344,4693,4651,5947,7,2945,13,3,25,404,0,404,9344,9033,311,0.4471,0.0187,21787,29102,29296,7926,38500,8993,21623,,21388,7090,46,023
"Marshall County, South Dakota",4895,2527,2368,4199,23,353,2,0,233,85,34,51,4895,4440,455,0.3992,0.0272,31307,34532,35621,11170,1048,12260,,-666666666,13939,7492,46,091
"Moody County, South Dakota",6506,3302,3204,5210,7,825,164,0,13,287,6,281,6506,6230,276,0.4317,0.0329,29142,31572,32182,15043,,20471,25268,-666666666,20385,13007,46,101
"Todd County, South Dakota",10146,4979,5167,949,18,8345,154,0,10,670,1,669,10146,9709,437,0.5517,0.0248,10931,29189,28658,11673,33189,8713,3551,-666666666,,13955,46,121
"Lyman County, South Dakota",3869,2017,1852,2223,3,1570,19,5,0,49,0,49,3869,3776,93,0.3831,0.0243,22097,30594,30760,16059,,10445,,,-666666666,17139,46,085
"Spink County, South Dakota",6543,3280,3263,6319,5,111,0,13,21,74,0,74,6543,6343,200,0.4709,0.0334,33597,34216,35011,8018,,16562,-666666666,,11067,18611,46,115
"Brookings County, South Dakota",34239,17538,16701,31668,545,351,979,8,177,511,39,472,34239,33228,1011,0.4267,0.0230,27968,29003,29304,16857,12762,7125,21801,,13155,11560,46,011
"Hamlin County, South Dakota",6000,3091,2909,5805,15,24,22,0,64,70,8,62,6000,5740,260,0.3557,0.0255,27777,27442,27804,19815,,100808,13273,-666666666,33252,15584,46,057
"Houston County, Tennessee",8176,4066,4110,7581,320,86,20,17,0,152,0,152,8176,8126,50,0.4610,0.0624,21866,22711,22550,,13750,,,,-666666666,5323,47,083
"Hardin County, Tennessee",25771,12606,13165,24279,1082,13,149,21,32,195,9,186,25771,25129,642,0.4731,0.0270,22905,23218,23530,12051,15201,,36230,,,18582,47,071
"Hardeman County, Tennessee",25562,14088,11474,14240,10642,56,191,0,85,348,39,309,25562,25120,442,0.4384,0.0247,17352,20583,20629,16829,13284,26907,17512,-666666666,11349,9382,47,069
"Polk County, Tennessee",16782,8369,8413,16168,37,45,10,0,150,372,13,359,16782,16447,335,0.4570,0.0467,24667,25039,25031,20570,13624,10807,22270,-666666666,18145,13973,47,139
"White County, Tennessee",26580,12982,13598,25499,534,8,51,0,12,476,16,460,26580,25926,654,0.4454,0.0334,20973,21156,21418,11496,16810,,23731,-666666666,,15074,47,185
"Unicoi County, Tennessee",17780,8895,8885,17156,65,18,70,0,256,215,40,175,17780,16956,824,0.4441,0.0211,22700,23018,23106,15651,21652,,,-666666666,7400,12419,47,171
"Weakley County, Tennessee",33626,16541,17085,29763,2908,106,75,18,280,476,43,433,33626,32812,814,0.4621,0.0330,21641,22662,22826,11756,13796,19154,49639,5483,7386,10857,47,183
"Bledsoe County, Tennessee",14602,8517,6085,13216,659,237,8,0,78,404,0,404,14602,14276,326,0.4922,0.0438,23453,23556,23753,10151,31831,20114,,-666666666,2121,9735,47,007
"Coffee County, Tennessee",54531,26640,27891,49509,1418,86,520,7,1137,1854,101,1753,54531,52248,2283,0.4443,0.0250,25637,26173,26414,11470,17596,27092,78198,,10022,12351,47,031
"Hawkins County, Tennessee",56402,27582,28820,54125,794,90,271,67,301,754,84,670,56402,55561,841,0.4660,0.0222,23801,24050,24070,17181,19334,20209,11797,,13923,20852,47,073
"Macon County, Tennessee",23487,11544,11943,22633,72,56,188,32,156,350,0,350,23487,22275,1212,0.4612,0.0364,21972,22330,22618,14163,30739,19870,17896,,8254,6231,47,111
"Robertson County, Tennessee",69344,34287,35057,61017,4883,218,378,48,1189,1611,298,1313,69344,64671,4673,0.4163,0.0155,28425,29738,30406,14968,21014,22828,21620,,15431,13255,47,147
"Cheatham County, Tennessee",39929,19817,20112,37939,550,95,171,12,314,848,38,810,39929,38789,1140,0.3833,0.0152,26719,26967,27165,17662,31524,10866,33903,,17918,16432,47,021
"Giles County, Tennessee",29167,14246,14921,25122,2917,90,65,0,249,724,17,707,29167,28504,663,0.4303,0.0223,23877,24748,25145,8801,19183,38316,20518,-666666666,13171,14758,47,055
"Madison County, Tennessee",97682,46137,51545,57277,36549,80,955,0,969,1852,80,1772,97682,93990,3692,0.4720,0.0127,25555,30456,31439,8958,18669,41478,36970,-666666666,12572,10069,47,113
"Pickett County, Tennessee",5088,2575,2513,5051,26,0,0,0,0,11,0,11,5088,5061,27,0.4243,0.0478,23250,23154,23191,23693,36208,-666666666,-666666666,-666666666,-666666666,,47,137
"Wayne County, Tennessee",16649,9186,7463,15311,1136,60,64,0,35,43,0,43,16649,16314,335,0.4512,0.0290,19350,20323,20469,12253,6940,13488,4172,-666666666,1726,46077,47,181
"Bedford County, Tennessee",47558,23409,24149,40019,3495,27,79,29,2414,1495,109,1386,47558,41849,5709,0.4534,0.0276,23988,25669,26778,11868,19269,20937,63397,,11712,8275,47,003
"Cumberland County, Tennessee",58634,28746,29888,56795,328,375,157,0,160,819,128,691,58634,56903,1731,0.4340,0.0210,24985,25234,25333,20090,12868,25609,26178,-666666666,10699,14853,47,035
"Claiborne County, Tennessee",31613,15361,16252,30507,349,60,206,84,18,389,9,380,31613,31219,394,0.4802,0.0244,20753,21231,21335,10764,7317,4742,3351,,,12061,47,025
"Humphreys County, Tennessee",18318,9013,9305,17155,435,206,122,6,57,337,143,194,18318,17882,436,0.4542,0.0347,23636,24190,24377,4212,11399,20791,14429,,,19779,47,085
"Putnam County, Tennessee",76440,37707,38733,71568,1716,294,965,31,477,1389,283,1106,76440,71719,4721,0.4896,0.0201,23873,24494,24842,17880,15343,11270,17319,8165,22104,10593,47,141
"Stewart County, Tennessee",13301,6631,6670,12516,151,61,99,50,65,359,20,339,13301,12931,370,0.4051,0.0224,22601,23224,23341,13619,25436,24577,13436,,4883,7251,47,161
"Decatur County, Tennessee",11683,5788,5895,10876,438,0,47,0,22,300,43,257,11683,11485,198,0.5178,0.0576,24337,25083,25357,9729,17734,-666666666,9515,-666666666,,9835,47,039
"McNairy County, Tennessee",25903,12685,13218,23731,1521,46,50,0,97,458,13,445,25903,25374,529,0.4609,0.0209,20236,20867,20786,23172,16064,,3100,-666666666,15895,4492,47,109
"Martin County, Texas",5614,2934,2680,4652,48,94,4,9,773,34,34,0,5614,3040,2574,0.4570,0.0309,29225,32418,38402,19062,7656,10798,,7011,14917,,48,317
"Bradley County, Tennessee",104557,50905,53652,94477,5123,122,1197,30,1654,1954,133,1821,104557,98340,6217,0.4686,0.0256,26319,27388,28174,13102,18362,21365,18233,3513,13580,11903,47,011
"Kimble County, Texas",4408,2154,2254,3929,1,36,0,5,300,137,63,74,4408,3294,1114,0.4940,0.0647,28899,30786,33830,16201,,,-666666666,,14508,10218,48,267
"Van Zandt County, Texas",54368,26619,27749,50558,1423,358,268,39,618,1104,83,1021,54368,48627,5741,0.4519,0.0244,26151,26934,28382,12762,19370,15501,27502,15495,11538,10694,48,467
"Yoakum County, Texas",8571,4438,4133,8207,37,11,5,0,151,160,46,114,8571,2928,5643,0.3925,0.0395,26519,27075,38762,20762,,,,-666666666,20931,4471,48,501
"Red River County, Texas",12275,5986,6289,9712,2080,39,6,0,147,291,0,291,12275,11373,902,0.4384,0.0236,21666,23181,24477,7628,16715,10638,,-666666666,9249,14467,48,387
"Sutton County, Texas",3865,2116,1749,2501,21,12,0,0,1324,7,0,7,3865,1480,2385,0.3973,0.0377,29360,30084,34526,26208,,,-666666666,-666666666,28587,,48,435
"Upshur County, Texas",40769,20224,20545,35051,3406,294,239,0,1115,664,117,547,40769,37346,3423,0.4338,0.0186,24458,25758,26413,14541,20038,11550,10568,-666666666,12121,9942,48,459
"Wharton County, Texas",41551,20395,21156,33749,5971,27,64,0,1425,315,103,212,41551,24568,16983,0.4853,0.0291,26281,27455,35374,19965,15002,88563,27986,-666666666,49505,3609,48,481
"Borden County, Texas",665,346,319,651,0,0,0,0,0,14,0,14,665,609,56,0.3326,0.0346,33781,34352,36254,14143,-666666666,-666666666,-666666666,-666666666,-666666666,7214,48,033
"Marion County, Texas",10083,4915,5168,7364,2361,43,0,38,184,93,0,93,10083,9677,406,0.5318,0.0359,27052,28849,28248,34250,18312,32423,-666666666,,17456,126583,48,315
"Grayson County, Texas",128560,62737,65823,111479,7057,1620,1824,66,2157,4357,319,4038,128560,111743,16817,0.4404,0.0122,27276,28587,30387,15938,18823,20888,20429,11221,18728,17144,48,181
"Palo Pinto County, Texas",28317,13987,14330,26054,628,194,217,37,680,507,137,370,28317,22692,5625,0.4674,0.0209,24983,25926,27720,16439,15218,29815,11140,,9890,13866,48,363
"DeWitt County, Texas",20435,10577,9858,13574,1905,147,1,0,4415,393,237,156,20435,13303,7132,0.5160,0.0268,28728,36058,40510,13446,17830,22030,,-666666666,13184,5548,48,123
"Callahan County, Texas",13770,6763,7007,13045,66,11,39,0,117,492,143,349,13770,12470,1300,0.4696,0.0300,24537,25304,25877,18461,17544,,9964,-666666666,14139,9312,48,059
"Gregg County, Texas",123494,60208,63286,91969,25062,459,1654,121,1127,3102,453,2649,123494,100578,22916,0.4645,0.0144,25839,28304,32686,12889,18612,33646,31392,42808,16177,9903,48,183
"Lubbock County, Texas",301454,148631,152823,244624,21954,3293,6578,186,16610,8209,1908,6301,301454,195940,105514,0.4851,0.0090,27089,28848,34571,17389,18825,18491,30259,25734,19225,13616,48,303
"Kaufman County, Texas",118910,58360,60550,97516,12906,523,1410,78,3441,3036,760,2276,118910,94379,24531,0.4156,0.0133,27411,28679,31564,17066,24524,21619,22688,26471,15509,15653,48,257
"Floyd County, Texas",5872,2885,2987,5460,230,8,10,0,75,89,0,89,5872,2443,3429,0.4351,0.0395,23308,23764,35130,15926,14138,,,-666666666,13268,21521,48,153
"Chambers County, Texas",40292,20377,19915,35465,3158,85,506,0,491,587,6,581,40292,31499,8793,0.4543,0.0232,34372,35544,38048,27043,27470,4961,27956,-666666666,23387,19687,48,071
"Bell County, Texas",342236,170918,171318,217203,80527,2434,10088,2338,11467,18179,1845,16334,342236,258606,83630,0.4305,0.0095,25911,28465,32295,17851,22879,17434,25159,19781,22008,13626,48,027
"Hutchinson County, Texas",21571,10797,10774,19040,494,369,91,122,561,894,212,682,21571,16612,4959,0.4345,0.0168,24725,25955,27643,17203,17032,18851,43603,8300,17005,10371,48,233
"Orange County, Texas",84047,41630,42417,73557,7116,311,1041,0,471,1551,104,1447,84047,77882,6165,0.4431,0.0137,28826,30136,30928,21604,18781,38363,21441,-666666666,35662,13772,48,361
"Winkler County, Texas",7802,3977,3825,6884,357,113,0,0,151,297,144,153,7802,3113,4689,0.4314,0.0325,24217,26008,30834,21029,6545,8732,-666666666,-666666666,19475,12245,48,495
"Burnet County, Texas",45750,22642,23108,42092,831,323,383,0,1537,584,114,470,45750,35630,10120,0.4505,0.0240,30507,31483,34512,18591,16642,32246,32918,-666666666,15203,17628,48,053
"Dallas County, Texas",2586552,1275226,1311326,1595565,582158,9595,159919,1356,169597,68362,15562,52800,2586552,1553552,1033000,0.4997,0.0028,31219,35507,55978,16634,22943,24425,37157,32286,17215,23406,48,113
"McMullen County, Texas",662,387,275,652,0,4,0,0,6,0,0,0,662,330,332,0.4747,0.0757,32556,31960,49079,16277,-666666666,,-666666666,-666666666,,-666666666,48,311
"Johnson County, Texas",163475,81568,81907,148605,5048,858,1492,612,3179,3681,497,3184,163475,129427,34048,0.4100,0.0103,27667,28548,31112,17948,21305,15845,20089,20799,17616,16472,48,251
"Hartley County, Texas",5767,3411,2356,4725,498,2,85,0,139,318,58,260,5767,4243,1524,0.3725,0.0523,20480,23533,27117,14364,518,,15748,-666666666,16581,9419,48,205
"Limestone County, Texas",23515,12056,11459,17884,4172,379,177,63,619,221,53,168,23515,18414,5101,0.4500,0.0233,21822,24337,27696,13256,13493,15766,16450,,15696,12609,48,293
"Parker County, Texas",129802,64448,65354,120953,1862,852,673,79,2458,2925,490,2435,129802,114240,15562,0.4356,0.0115,34705,35535,36993,21123,23590,39331,29547,16924,16686,22922,48,367
"Culberson County, Texas",2241,1231,1010,1834,3,0,12,0,346,46,0,46,2241,595,1646,0.4170,0.0359,15873,15501,17086,14272,,-666666666,,-666666666,12099,53187,48,109
"Garza County, Texas",6288,4070,2218,5234,272,49,137,0,477,119,75,44,6288,3016,3272,0.4443,0.1053,19177,20942,33915,7802,13571,,22254,-666666666,3604,18071,48,169
"Travis County, Texas",1203166,607356,595810,884639,100148,6847,79400,601,90556,40975,5990,34985,1203166,795490,407676,0.4851,0.0040,41049,45253,56440,21970,27018,30566,44736,65868,19233,27021,48,453
"Collingsworth County, Texas",2996,1496,1500,2346,222,81,0,0,271,76,17,59,2996,2162,834,0.4742,0.0659,22880,26155,29717,11165,12389,8270,-666666666,-666666666,11396,8936,48,087
"Lamb County, Texas",13262,6710,6552,11663,658,35,78,0,503,325,121,204,13262,5937,7325,0.4504,0.0232,21506,22398,31154,15218,10313,9606,27010,-666666666,22316,10870,48,279
"Loving County, Texas",102,58,44,99,0,3,0,0,0,0,0,0,102,86,16,0.2567,0.1202,23546,23951,26707,9650,-666666666,,-666666666,-666666666,-666666666,-666666666,48,301
"Prentiss County, Mississippi",25360,12304,13056,21190,3130,0,40,0,127,873,68,805,25360,25006,354,0.4742,0.0320,19693,20997,21127,11201,14624,-666666666,,-666666666,12561,7260,28,117
"Jackson County, Mississippi",142014,70065,71949,101325,30698,514,3359,66,2847,3205,425,2780,142014,133097,8917,0.4437,0.0122,25341,28418,28663,19966,17995,12791,20882,,16755,12562,28,059
"Tunica County, Mississippi",10170,4659,5511,1966,7984,0,121,0,24,75,0,75,10170,10085,85,0.4960,0.0957,19115,25923,26042,,17650,-666666666,20080,-666666666,,,28,143
"Claiborne County, Mississippi",9120,4312,4808,1066,7972,13,49,0,10,10,0,10,9120,9107,13,0.4934,0.0291,13503,28295,28292,,11445,,,-666666666,,,28,021
"Lauderdale County, Mississippi",77323,37617,39706,42033,33636,160,600,22,364,508,21,487,77323,75568,1755,0.4918,0.0194,23741,30822,31082,23391,15003,24648,22489,,31944,12342,28,075
"Simpson County, Mississippi",27073,13115,13958,16736,9878,3,74,0,23,359,16,343,27073,26980,93,0.4682,0.0191,20495,24727,24797,11371,13282,,26727,-666666666,,20866,28,127
"Attala County, Mississippi",18581,8826,9755,10026,7921,30,37,0,312,255,29,226,18581,18195,386,0.5054,0.0406,20936,27698,27666,20193,12708,39620,7284,-666666666,19849,11786,28,007
"Coahoma County, Mississippi",23802,11006,12796,5048,18436,23,119,0,8,168,11,157,23802,23746,56,0.5193,0.0256,17518,36740,36751,19907,12414,,4981,-666666666,,9974,28,027
"Walthall County, Mississippi",14601,7108,7493,7734,6719,0,63,0,32,53,0,53,14601,14512,89,0.5575,0.0650,20337,24652,24629,17672,15689,-666666666,7756,-666666666,5388,,28,147
"Pontotoc County, Mississippi",31315,15304,16011,24547,5002,9,18,0,1311,428,75,353,31315,29260,2055,0.4451,0.0300,20401,22117,22331,12196,15416,,,-666666666,12807,3768,28,115
"Alcorn County, Mississippi",37180,18287,18893,31589,4332,33,98,0,331,797,49,748,37180,35999,1181,0.4411,0.0240,21321,22525,22823,10326,16470,,5862,-666666666,12154,6562,28,003
"DeSoto County, Mississippi",176132,85174,90958,119830,46053,302,2156,29,3626,4136,558,3578,176132,167533,8599,0.4052,0.0120,29190,32500,33079,16525,23417,18359,25569,,16382,11583,28,033
"Mercer County, Missouri",3664,1834,1830,3550,14,0,19,4,15,62,0,62,3664,3593,71,0.4085,0.0301,22097,22661,22649,19234,3429,-666666666,,,,3208,29,129
"Clay County, Missouri",239164,117296,121868,204916,14425,1301,5141,417,3687,9277,1229,8048,239164,223150,16014,0.4116,0.0105,33342,35111,35682,22866,23808,23157,31385,27657,22841,16023,29,047
"Dent County, Missouri",15504,7692,7812,14821,100,101,72,0,48,362,4,358,15504,15246,258,0.4669,0.0390,22581,22879,22999,16949,39548,22048,,-666666666,31717,8564,29,065
"Worth County, Missouri",2040,981,1059,1981,7,1,4,0,0,47,0,47,2040,2026,14,0.3880,0.0253,24159,24566,24528,,,,,-666666666,-666666666,7762,29,227
"St. Louis city, Missouri",311273,150532,160741,143956,146057,732,10096,195,3183,7054,485,6569,311273,298910,12363,0.5081,0.0066,28478,40319,41559,23111,17559,30690,28944,15330,15926,18064,29,510
"Butler County, Missouri",42733,20823,21910,38740,2437,221,271,2,71,991,0,991,42733,41846,887,0.4802,0.0210,21286,22000,22265,9242,11544,12886,60088,,,8780,29,023
"Holt County, Missouri",4456,2197,2259,4308,30,37,34,1,0,46,3,43,4456,4430,26,0.4053,0.0216,25517,25843,25848,21935,7307,41716,9865,,-666666666,3941,29,087
"Montgomery County, Missouri",11545,5764,5781,10966,178,12,29,10,115,235,0,235,11545,11329,216,0.3981,0.0175,22980,23326,23437,14147,22790,,,,16691,13941,29,139
"Stoddard County, Missouri",29512,14365,15147,28664,340,3,10,0,10,485,20,465,29512,29011,501,0.4309,0.0198,22205,22370,22611,7673,32684,,,-666666666,,5462,29,207
"Washington County, Missouri",24931,12835,12096,23739,492,112,22,4,1,561,9,552,24931,24599,332,0.4280,0.0228,18915,19297,19285,17632,1572,28569,6568,,,16645,29,221
"DeKalb County, Missouri",12564,7947,4617,10796,1228,92,26,21,24,377,9,368,12564,12261,303,0.4162,0.0212,19524,21888,22221,9896,1319,3937,113696,,,6405,29,063
"Lafayette County, Missouri",32589,16106,16483,30639,634,43,185,75,205,808,23,785,32589,31692,897,0.4273,0.0186,28056,28168,28422,18570,26949,16358,8370,,28949,27993,29,107
"Schuyler County, Missouri",4502,2219,2283,4383,23,0,0,0,0,96,0,96,4502,4474,28,0.4490,0.0360,19316,19630,19675,,,-666666666,-666666666,-666666666,-666666666,8874,29,197
"Camden County, Missouri",45096,22328,22768,43463,339,267,145,0,287,595,15,580,45096,43893,1203,0.4569,0.0167,27385,27861,28207,9493,10657,35068,8369,-666666666,4508,14406,29,029
"Jasper County, Missouri",119238,58223,61015,107744,2400,1948,1314,136,1824,3872,236,3636,119238,109869,9369,0.4403,0.0133,24086,24666,25570,12476,15576,20212,34679,40922,11916,16713,29,097
"McDonald County, Missouri",22827,11635,11192,19969,450,698,328,421,357,604,11,593,22827,20185,2642,0.4321,0.0207,20270,20796,21585,16355,15775,14335,11828,9852,30210,19032,29,119
"Polk County, Missouri",31549,15435,16114,30117,299,336,158,16,29,594,0,594,31549,30792,757,0.4293,0.0211,22575,22895,23104,10410,11026,18605,15017,,14114,17412,29,167
"Reynolds County, Missouri",6315,3238,3077,6003,121,26,9,16,44,96,0,96,6315,6194,121,0.4368,0.0297,22693,23137,23187,16499,2034,38535,,22988,,26471,29,179
"Scott County, Missouri",38729,18712,20017,33004,4456,151,160,0,239,719,30,689,38729,37851,878,0.4682,0.0247,23185,24924,24984,20472,13829,20616,11332,-666666666,11546,8384,29,201
"Barton County, Missouri",11850,5865,5985,11161,35,222,0,6,33,393,69,324,11850,11538,312,0.4774,0.0257,25938,26493,26897,4898,12929,17357,-666666666,,15915,16754,29,011
"Cole County, Missouri",76740,38731,38009,64219,8970,283,1080,14,517,1657,102,1555,76740,74596,2144,0.4265,0.0165,29433,32263,32685,16526,15008,12005,27045,,9802,8490,29,051
"Gasconade County, Missouri",14746,7373,7373,14354,62,48,55,0,23,204,4,200,14746,14546,200,0.4251,0.0340,27240,27174,27399,11491,23685,6108,,-666666666,,33304,29,073
"Macon County, Missouri",15254,7683,7571,14415,284,97,80,3,34,341,77,264,15254,15044,210,0.3952,0.0159,21118,21642,21636,19826,17974,6595,8775,,,9704,29,121
"Pemiscot County, Missouri",17031,8022,9009,11937,4631,14,0,2,99,348,26,322,17031,16609,422,0.4895,0.0342,19876,22467,22671,11017,14363,,-666666666,,12558,6968,29,155
"Shannon County, Missouri",8246,4012,4234,7876,12,38,0,0,25,295,0,295,8246,8096,150,0.4501,0.0253,18066,18220,18339,8690,,33995,-666666666,-666666666,,14081,29,203
"Douglas County, Missouri",13374,6700,6674,13210,14,23,9,0,87,31,0,31,13374,13171,203,0.4583,0.0298,19164,18829,18880,11836,26164,207257,,-666666666,10902,43942,29,067
"Henry County, Missouri",21765,10643,11122,20755,289,120,74,0,55,472,49,423,21765,21254,511,0.4544,0.0270,25244,26096,26384,8459,7952,12758,6423,-666666666,,7327,29,083
"Lawrence County, Missouri",38133,18995,19138,36412,240,196,82,0,393,810,9,801,38133,35362,2771,0.4314,0.0165,22341,22675,23623,8413,15943,23246,13806,-666666666,7837,16925,29,109
"Chouteau County, Montana",5789,2839,2950,4482,3,1122,27,2,28,125,3,122,5789,5653,136,0.4350,0.0266,22661,25859,26001,7363,,11598,,,,13110,30,015
"Lincoln County, Montana",19358,9678,9680,18372,12,135,97,31,146,565,33,532,19358,18783,575,0.4779,0.0327,24082,24605,24831,11693,9542,24717,21326,,4623,13356,30,053
"Treasure County, Montana",777,384,393,748,0,0,14,0,4,11,0,11,777,771,6,0.4012,0.0518,26348,26545,26616,,-666666666,-666666666,31600,-666666666,,,30,103
"Sweet Grass County, Montana",3653,1770,1883,3503,8,40,10,0,0,92,2,90,3653,3542,111,0.4258,0.0301,29649,29224,29779,12265,,,,-666666666,-666666666,19791,30,097
"Prairie County, Montana",1342,673,669,1324,0,18,0,0,0,0,0,0,1342,1324,18,0.4494,0.0622,28087,28469,28389,,-666666666,,-666666666,-666666666,-666666666,-666666666,30,079
"Glacier County, Montana",13699,6855,6844,4451,38,8920,16,14,34,226,0,226,13699,13297,402,0.5209,0.0190,17219,27251,28230,8845,14534,12227,22575,,,17253,30,035
"Golden Valley County, Montana",724,355,369,675,28,0,0,0,0,21,0,21,724,665,59,0.4489,0.0655,27476,29179,30210,,,-666666666,-666666666,-666666666,-666666666,9357,30,037
"Stillwater County, Montana",9410,4693,4717,9016,20,97,40,0,59,178,0,178,9410,9040,370,0.3948,0.0225,32061,32462,32962,21019,,26591,9475,-666666666,34661,15699,30,095
"Granite County, Montana",3269,1696,1573,3200,5,16,2,0,0,46,3,43,3269,3195,74,0.4779,0.0517,29074,29338,29895,5458,,27900,,-666666666,-666666666,13398,30,039
"Madison County, Montana",8218,4261,3957,7752,20,75,4,0,191,176,0,176,8218,7806,412,0.4432,0.0290,34014,35152,35432,21257,,12255,,-666666666,18790,14041,30,057
"Sheridan County, Montana",3574,1794,1780,3343,0,45,16,0,5,165,0,165,3574,3479,95,0.4513,0.0415,33711,34966,35739,7908,-666666666,12153,34456,-666666666,,14779,30,091
"Big Horn County, Montana",13376,6572,6804,4194,6,8815,20,3,38,300,18,282,13376,12539,837,0.4254,0.0213,18560,31117,32783,16888,,12708,,,27839,11534,30,003
"Garfield County, Montana",1141,605,536,1140,0,0,0,0,0,1,0,1,1141,1139,2,0.4657,0.0488,27291,27313,27319,,-666666666,-666666666,-666666666,-666666666,-666666666,,30,033
"Lewis and Clark County, Montana",67077,33186,33891,62921,185,1207,424,44,366,1930,44,1886,67077,64912,2165,0.4103,0.0176,32433,33412,33898,12523,15588,19337,29183,16148,10674,15522,30,049
"Missoula County, Montana",115983,58372,57611,106340,594,2675,1880,134,430,3930,361,3569,115983,112269,3714,0.4767,0.0128,30636,31814,32217,18027,18252,18171,22265,16722,27543,13933,30,063
"Cascade County, Montana",81746,41269,40477,71996,1055,3950,706,71,874,3094,117,2977,81746,78177,3569,0.4691,0.0201,29212,30794,31040,19126,22646,13333,48265,25613,18898,13550,30,013
"Powell County, Montana",6861,4310,2551,6235,24,301,34,0,12,255,9,246,6861,6731,130,0.4138,0.0346,25060,26555,26826,6821,5554,5017,,-666666666,24892,15592,30,077
"Gallatin County, Montana",104729,54246,50483,98713,352,899,1469,11,677,2608,119,2489,104729,100952,3777,0.4626,0.0108,34331,35104,35441,22165,16017,16110,34607,,29357,15021,30,031
"Beaverhead County, Montana",9393,4748,4645,8922,6,234,43,13,38,137,0,137,9393,8972,421,0.4963,0.0392,28941,29942,30617,14498,,9623,1940,,12953,13290,30,001
"Musselshell County, Montana",4807,2399,2408,4749,0,8,20,0,0,30,0,30,4807,4679,128,0.4199,0.0347,22737,22680,22998,11200,-666666666,,,-666666666,-666666666,34833,30,065
"Sheridan County, Nebraska",5234,2566,2668,4331,40,502,42,2,26,291,8,283,5234,4973,261,0.4770,0.0387,27304,30520,30604,18276,9250,5911,41410,,,14064,31,161
"Nuckolls County, Nebraska",4275,2140,2135,4180,7,7,57,0,6,18,0,18,4275,4159,116,0.4505,0.0486,26735,27055,27426,12280,,,,-666666666,,9117,31,129
"Frontier County, Nebraska",2609,1326,1283,2542,2,20,3,0,0,42,1,41,2609,2582,27,0.4420,0.0449,28583,29076,29284,8681,,,,-666666666,-666666666,11817,31,063
"Douglas County, Nebraska",554992,273743,281249,441478,61513,3266,20210,315,11090,17120,1456,15664,554992,486222,68770,0.4694,0.0054,33734,37351,40313,15876,19117,14977,27371,23116,17704,14647,31,055
"Chase County, Nebraska",3734,1865,1869,3703,2,0,10,0,1,18,0,18,3734,3365,369,0.3820,0.0398,29526,29550,30863,17653,,-666666666,,-666666666,,,31,029
"Arthur County, Nebraska",418,205,213,400,0,2,0,0,2,14,0,14,418,415,3,0.4665,0.0823,26514,27254,27297,,-666666666,,-666666666,-666666666,,8093,31,005
"Franklin County, Nebraska",3006,1490,1516,2946,11,0,4,4,2,39,0,39,3006,2939,67,0.4146,0.0309,27757,27975,28064,23637,10345,-666666666,,,,19267,31,061
"Jefferson County, Nebraska",7188,3486,3702,6961,18,42,11,0,13,143,0,143,7188,6920,268,0.4558,0.0286,26439,26908,27378,10440,,10388,,-666666666,13454,10996,31,095
"Loup County, Nebraska",585,291,294,583,0,2,0,0,0,0,0,0,585,575,10,0.3999,0.0545,28299,28297,28475,,-666666666,,-666666666,-666666666,-666666666,-666666666,31,115
"Phelps County, Nebraska",9120,4578,4542,8792,23,19,24,0,76,186,8,178,9120,8616,504,0.4224,0.0318,30814,31389,32092,16193,13800,3089,,-666666666,10588,19728,31,137
"Scotts Bluff County, Nebraska",36255,17575,18680,33318,304,635,236,114,725,923,375,548,36255,27665,8590,0.4602,0.0237,28089,29234,32496,17094,8747,14603,16667,,23688,10438,31,157
"Kimball County, Nebraska",3667,1855,1812,3488,8,26,12,0,28,105,9,96,3667,3273,394,0.3932,0.0317,23870,24429,25030,17228,,16865,25533,-666666666,7711,12871,31,105
"Merrick County, Nebraska",7803,3919,3884,7445,67,9,23,0,103,156,11,145,7803,7471,332,0.4206,0.0383,29038,28995,29290,16620,8785,,,-666666666,15151,51331,31,121
"Burt County, Nebraska",6528,3209,3319,6215,46,111,32,0,38,86,1,85,6528,6336,192,0.4300,0.0241,28499,29373,29701,12396,15359,10776,6038,-666666666,12003,10890,31,021
"Cuming County, Nebraska",8991,4505,4486,8465,7,15,28,11,297,168,67,101,8991,8100,891,0.4142,0.0302,29306,30380,31387,13185,,15813,12318,,13727,6141,31,039
"Grant County, Nebraska",718,380,338,706,5,0,0,0,0,7,0,7,718,706,12,0.4420,0.0429,22640,22788,22928,,,-666666666,-666666666,-666666666,-666666666,,31,075
"Hayes County, Nebraska",943,495,448,928,0,0,0,0,15,0,0,0,943,874,69,0.4539,0.0487,26369,26303,26885,19836,-666666666,-666666666,-666666666,-666666666,30460,-666666666,31,085
"Cedar County, Nebraska",8523,4329,4194,8352,4,76,6,2,43,40,4,36,8523,8367,156,0.4171,0.0256,29494,29829,30045,15016,,10068,,,20693,12055,31,027
"Johnson County, Nebraska",5197,3097,2100,4513,339,43,48,0,195,59,0,59,5197,4673,524,0.4187,0.0245,23652,26075,27383,10059,5915,1035,16460,-666666666,11758,1885,31,097
"Garfield County, Nebraska",1975,969,1006,1940,4,0,7,0,9,15,0,15,1975,1936,39,0.4097,0.0358,27109,27404,27766,10374,,-666666666,,-666666666,,,31,071
"Pawnee County, Nebraska",2676,1277,1399,2580,0,5,0,0,0,91,0,91,2676,2628,48,0.4557,0.0500,26609,27084,27230,8544,-666666666,,-666666666,-666666666,-666666666,13611,31,133
"Wheeler County, Nebraska",822,435,387,812,0,0,2,0,5,3,0,3,822,817,5,0.3644,0.0487,27832,27906,27906,,-666666666,-666666666,,-666666666,,,31,183
"York County, Nebraska",13799,6693,7106,13113,210,35,56,0,124,261,9,252,13799,13108,691,0.4588,0.0425,31577,32776,33723,11811,6048,,,-666666666,5463,6349,31,185
"Colfax County, Nebraska",10760,5870,4890,9349,374,166,64,22,501,284,144,140,10760,5868,4892,0.3744,0.0228,22407,23346,30960,13105,16790,4204,37277,,14142,20338,31,037
"Logan County, Nebraska",886,462,424,874,0,4,0,0,5,3,3,0,886,860,26,0.3482,0.0325,24813,24465,24246,36000,-666666666,52950,-666666666,-666666666,,,31,113
"Polk County, Nebraska",5255,2540,2715,5124,10,15,3,0,42,61,0,61,5255,4973,282,0.3980,0.0312,30403,30717,31771,9468,26400,38587,,-666666666,,17267,31,143
"Brown County, Nebraska",2988,1430,1558,2912,1,7,10,0,0,58,0,58,2988,2946,42,0.4766,0.0676,28860,29114,29264,18876,,,,-666666666,-666666666,17286,31,017
"Lander County, Nevada",5746,3347,2399,5178,6,252,7,50,193,60,11,49,5746,4248,1498,0.3551,0.0429,33329,34668,35986,29002,,14858,,,22213,,32,015
"Eureka County, Nevada",1830,921,909,1725,1,96,0,0,8,0,0,0,1830,1710,120,0.3971,0.0764,34590,35352,36070,23990,,23318,-666666666,-666666666,,-666666666,32,011
"Mercer County, New Jersey",368762,180369,188393,234759,76176,491,39632,126,9700,7878,1268,6610,368762,305391,63371,0.4999,0.0083,42155,47327,54370,20432,23497,20833,55975,28660,22031,25225,34,021
"Somerset County, New Jersey",330176,161296,168880,222500,31853,778,57302,23,10472,7248,1564,5684,330176,282447,47729,0.4566,0.0057,54393,58306,63128,29716,35211,14728,59346,,26378,24260,34,035
"Atlantic County, New Jersey",268539,130026,138513,178914,40319,969,21567,115,16567,10088,2859,7229,268539,218410,50129,0.4615,0.0071,31366,36707,39991,17237,21887,20509,24119,16040,15568,17199,34,001
"Middlesex County, New Jersey",826698,407247,419451,487018,84342,1864,197711,306,34033,21424,7818,13606,826698,655082,171616,0.4319,0.0039,38140,38942,44425,22833,32522,39201,42809,12883,22616,23877,34,023
"Cape May County, New Jersey",93705,45829,47876,85531,4358,26,910,29,1264,1587,219,1368,93705,86717,6988,0.4809,0.0125,38496,39775,41274,17271,23604,,45227,32879,17874,23045,34,009
"Union County, New Jersey",553066,269450,283616,310654,117079,1580,27959,85,80862,14847,4386,10461,553066,381321,171745,0.4973,0.0060,40201,49214,58966,22677,29374,19054,54188,11072,20227,21858,34,039
"Hunterdon County, New Jersey",125051,62447,62604,113719,3369,63,4934,41,1277,1648,228,1420,125051,117109,7942,0.4335,0.0087,54984,56773,57890,32783,19273,,58263,40639,15709,27397,34,019
"Los Alamos County, New Mexico",18356,9353,9003,15686,36,201,996,0,567,870,139,731,18356,15120,3236,0.3941,0.0215,56410,57254,61002,37965,37847,26502,72197,-666666666,51354,34098,35,028
"Valencia County, New Mexico",75956,38130,37826,61391,839,3256,643,0,7531,2296,897,1399,75956,30113,45843,0.4361,0.0183,21934,22782,28625,18363,21909,17791,29307,-666666666,17524,17552,35,061
"Bernalillo County, New Mexico",677692,332271,345421,501468,19260,32867,17534,493,77556,28514,11842,16672,677692,340065,337627,0.4751,0.0045,29415,32089,40864,21368,27308,19282,33799,19503,19550,19800,35,001
"De Baca County, New Mexico",2060,1052,1008,1536,33,0,6,0,334,151,145,6,2060,1111,949,0.4410,0.0338,19215,20785,23333,15124,,-666666666,,-666666666,16892,11721,35,011
"Hidalgo County, New Mexico",4371,2149,2222,4197,27,28,0,0,59,60,48,12,4371,1836,2535,0.4806,0.0573,20275,20410,25976,16264,,22793,-666666666,-666666666,23161,11895,35,023
"Sandoval County, New Mexico",140769,68955,71814,100391,3098,17653,1943,243,11885,5556,1749,3807,140769,86731,54038,0.4293,0.0092,27549,31511,36868,21296,28292,13100,30790,40356,18894,18280,35,043
"Curry County, New Mexico",50199,26109,24090,33555,2717,555,815,128,10105,2324,1039,1285,50199,29327,20872,0.4559,0.0323,23729,28312,30102,17905,17805,27051,18909,11672,13785,9267,35,009
"Harding County, New Mexico",459,266,193,424,0,0,0,2,11,22,18,4,459,288,171,0.6289,0.0827,32424,33429,40567,18519,-666666666,-666666666,-666666666,,26964,14909,35,021
"San Juan County, New Mexico",127455,63123,64332,66357,816,50524,988,75,5319,3376,503,2873,127455,101836,25619,0.4518,0.0112,23206,29935,33922,17886,32542,15175,25327,31501,20191,12820,35,045
"Chaves County, New Mexico",65459,32600,32859,55609,1111,1063,405,23,5502,1746,762,984,65459,28662,36797,0.4596,0.0178,21356,22269,30108,15512,13207,16203,32468,700,15784,15842,35,005
"Union County, New Mexico",4175,2302,1873,3543,82,92,2,0,298,158,100,58,4175,2429,1746,0.5052,0.0800,23968,26180,35173,12726,5034,9841,,-666666666,14134,11255,35,059
"Roosevelt County, New Mexico",19117,9523,9594,14215,522,104,110,0,3277,889,288,601,19117,11176,7941,0.4514,0.0279,19849,21879,25223,14371,26052,16673,11060,-666666666,13892,7165,35,041
"Bronx County, New York",1437872,676963,760909,306423,490823,9596,52388,1128,525040,52474,22111,30363,1437872,634236,803636,0.5105,0.0046,20850,28766,38993,17093,21408,17399,24612,24100,15407,20676,36,005
"Fulton County, New York",53743,26847,26896,50849,1085,192,382,15,468,752,54,698,53743,52162,1581,0.4228,0.0148,26875,27287,27402,19060,13803,12694,43900,,20687,16842,36,035
"Rensselaer County, New York",159431,78611,80820,137648,10239,212,4134,9,1517,5672,310,5362,159431,151781,7650,0.4317,0.0093,34280,36930,37512,16750,20072,18497,22292,,17145,9533,36,083
"Dutchess County, New York",293894,146174,147720,230158,30830,1061,10664,117,11711,9353,1296,8057,293894,258924,34970,0.4453,0.0078,38048,41254,42457,23376,26026,27533,43855,40571,20139,15759,36,027
"Herkimer County, New York",62505,30918,31587,59916,849,150,331,93,313,853,102,751,62505,61196,1309,0.4147,0.0100,26151,26660,26828,12094,10078,27673,29240,7401,14814,11149,36,043
"St. Lawrence County, New York",109558,55780,53778,101766,2642,828,1153,68,1127,1974,253,1721,109558,107026,2532,0.4407,0.0094,24473,25532,25684,9248,6164,18888,20578,31297,10898,6495,36,089
"Warren County, New York",64480,31698,32782,61797,852,168,677,32,173,781,86,695,64480,62891,1589,0.4367,0.0138,33605,34208,34526,17141,19475,17621,30564,,22702,10730,36,113
"Monroe County, New York",744248,359374,384874,566271,113538,3378,26661,120,12226,22054,2921,19133,744248,680617,63631,0.4646,0.0042,32502,36551,37957,16689,17947,16926,32000,42258,18357,14252,36,055
"Ulster County, New York",179303,88774,90529,152289,10615,368,3452,131,4969,7479,1421,6058,179303,161327,17976,0.4620,0.0102,33879,36645,37625,18400,19873,16764,25387,13845,15480,14774,36,111
"Livingston County, New York",63907,32050,31857,59696,1805,128,833,22,429,994,126,868,63907,61684,2223,0.4150,0.0148,27073,28154,28664,10660,7608,27720,17167,,20312,8017,36,051
"Greene County, New York",47617,24903,22714,42731,2936,281,516,5,489,659,77,582,47617,44864,2753,0.4411,0.0136,27271,28981,29749,14015,8084,6838,35314,,16557,12433,36,039
"Allegany County, New York",47025,23755,23270,44860,652,133,525,12,276,567,24,543,47025,46281,744,0.4157,0.0115,23030,23536,23706,7024,6693,26341,22893,,6668,9576,36,003
"Cattaraugus County, New York",77686,38491,39195,71439,1247,2380,648,0,419,1553,129,1424,77686,76081,1605,0.4256,0.0082,24628,25373,25509,13226,11802,16283,40658,-666666666,10401,10603,36,009
"Schenectady County, New York",154883,75453,79430,119664,15965,351,7187,66,5180,6470,1315,5155,154883,144176,10707,0.4411,0.0123,31412,35032,35879,17889,17227,27088,28532,56568,16630,14488,36,093
"Yates County, New York",25009,11999,13010,24061,226,53,189,7,164,309,23,286,25009,24460,549,0.4512,0.0206,27512,28201,28329,19420,10085,14160,3994,,21033,7355,36,123
"Haywood County, North Carolina",60433,29220,31213,57778,617,294,318,0,535,891,154,737,60433,58126,2307,0.4634,0.0175,29453,29697,30166,14296,20112,17674,50070,-666666666,13054,26504,37,087
"Alleghany County, North Carolina",10973,5386,5587,10346,266,37,31,1,209,83,24,59,10973,9919,1054,0.4237,0.0198,21244,21864,22811,11102,10495,10565,10584,,8197,20283,37,005
"Cleveland County, North Carolina",97159,46856,50303,72778,20244,307,988,23,1475,1344,87,1257,97159,93842,3317,0.4694,0.0193,21920,24073,24440,12956,15298,20144,23726,,16832,10103,37,045
"Granville County, North Carolina",58874,30046,28828,35927,17923,335,266,0,2122,2301,358,1943,58874,54311,4563,0.4291,0.0144,26228,31485,32325,13377,19530,17731,27470,-666666666,12695,9880,37,077
"Hoke County, North Carolina",53239,26320,26919,24053,17740,4459,754,96,3430,2707,181,2526,53239,46289,6950,0.4160,0.0135,20656,25069,26590,12985,19404,13640,21805,27805,11406,12358,37,093
"Iredell County, North Carolina",172525,84936,87589,140774,21229,504,4046,123,2497,3352,382,2970,172525,159656,12869,0.4736,0.0114,32006,34584,35901,15304,19526,18720,35686,23029,16031,12573,37,097
"Pitt County, North Carolina",177372,83620,93752,102147,61671,564,3065,45,5703,4177,187,3990,177372,166469,10903,0.4926,0.0112,25722,31004,31656,16081,18596,15177,40248,,12538,10734,37,147
"Cherokee County, North Carolina",27668,13583,14085,25890,364,430,193,0,190,601,16,585,27668,26822,846,0.4123,0.0167,22754,23234,23385,13882,14278,18576,22258,-666666666,4535,16101,37,039
"Wilkes County, North Carolina",68460,33719,34741,62478,2827,192,419,168,1304,1072,347,725,68460,64144,4316,0.4764,0.0245,23745,24563,25127,11659,17732,12528,23689,12244,10918,11373,37,193
"Alexander County, North Carolina",37119,18942,18177,32640,2105,150,402,31,1285,506,16,490,37119,35396,1723,0.4671,0.0255,24452,26245,26455,8893,13477,26957,11814,,8967,4577,37,003
"Carteret County, North Carolina",68920,33839,35081,61988,3880,192,781,40,268,1771,111,1660,68920,65990,2930,0.4561,0.0123,32005,33165,33740,18531,21505,17570,33889,31383,16165,17568,37,031
"Pasquotank County, North Carolina",39479,19146,20333,23097,14418,35,662,58,207,1002,37,965,39479,37448,2031,0.4389,0.0171,23699,27991,28251,22763,17362,33986,32336,,21305,9993,37,139
"Swain County, North Carolina",14254,6799,7455,9229,60,4218,47,0,114,586,0,586,14254,13523,731,0.4656,0.0396,20984,22331,22542,12078,8017,19428,,-666666666,10514,14149,37,173
"Anson County, North Carolina",25306,13285,12021,12083,12333,96,335,9,166,284,35,249,25306,24307,999,0.4417,0.0198,20124,24334,25296,13896,16406,3620,14173,,34242,7421,37,007
"Franklin County, North Carolina",64902,32281,32621,43927,16410,762,365,150,1729,1559,317,1242,64902,59626,5276,0.4210,0.0145,26273,29113,30116,15580,20697,16956,34089,34975,19240,14623,37,069
"Macon County, North Carolina",34410,16630,17780,32278,489,193,267,0,863,320,17,303,34410,32043,2367,0.4773,0.0208,28429,29263,29658,18199,12557,22902,15594,-666666666,11304,28760,37,113
"Transylvania County, North Carolina",33513,16045,17468,30548,1523,115,111,15,736,465,45,420,33513,32423,1090,0.4327,0.0234,27050,28336,28484,8625,16902,25311,16850,,7301,10788,37,175
"Columbus County, North Carolina",56293,27981,28312,34898,17396,2114,248,9,1088,540,25,515,56293,53352,2941,0.5096,0.0285,22081,26679,26136,23146,14760,18828,14121,,7875,5845,37,047
"Montgomery County, North Carolina",27338,13546,13792,20863,4922,113,407,5,548,480,0,480,27338,23162,4176,0.4786,0.0373,22760,25772,27546,15959,13731,6489,21108,,9265,5288,37,123
"Richmond County, North Carolina",45189,22124,23065,28209,14351,1049,438,60,332,750,26,724,45189,42319,2870,0.4628,0.0152,20745,24208,25619,10071,14349,18082,34531,50770,15546,8410,37,153
"Surry County, North Carolina",72099,34858,37241,65890,2719,281,435,104,1808,862,52,810,72099,64649,7450,0.4805,0.0158,23957,24882,26076,11063,17121,16908,15937,5870,10992,10530,37,171
"Buncombe County, North Carolina",254474,122297,132177,225981,16095,1014,3147,341,2378,5518,606,4912,254474,237945,16529,0.4705,0.0120,31439,32662,33685,18176,20847,29489,31197,10118,31109,14186,37,021
"Cabarrus County, North Carolina",201448,98094,103354,144192,35634,671,6837,114,9357,4643,1129,3514,201448,180888,20560,0.4320,0.0096,31050,33928,34997,16300,23185,29443,48229,53487,13601,11561,37,025
"Davidson County, North Carolina",164664,80508,84156,141056,14970,499,2501,18,2812,2808,103,2705,164664,153148,11516,0.4345,0.0112,25109,26615,27492,12467,16637,17473,19603,,11776,14250,37,057
"Hertford County, North Carolina",24153,11947,12206,8418,14377,273,178,47,271,589,8,581,24153,23256,897,0.4430,0.0163,18918,24634,25357,12962,15898,21289,18793,,16488,12462,37,091
"Pender County, North Carolina",59020,29239,29781,45366,8788,164,315,39,2751,1597,108,1489,59020,54951,4069,0.4735,0.0165,27724,30790,31313,12874,20034,24328,20354,,12711,10676,37,141
"Watauga County, North Carolina",54117,27145,26972,50824,900,355,516,78,612,832,219,613,54117,52235,1882,0.5047,0.0157,24906,25796,25952,15515,11398,9602,17110,20160,7623,9718,37,189
"Tyrrell County, North Carolina",4119,2365,1754,2251,1550,35,0,0,204,79,0,79,4119,3856,263,0.4158,0.0330,18682,24402,24787,7756,12496,14689,-666666666,-666666666,8008,6391,37,177
"Traill County, North Dakota",8019,4077,3942,7570,91,116,12,17,101,112,10,102,8019,7732,287,0.4338,0.0425,32712,34019,34508,11590,4504,9866,26783,,10440,16138,38,097
"Dickey County, North Dakota",4970,2450,2520,4808,57,68,22,0,3,12,4,8,4970,4800,170,0.4270,0.0302,32943,32387,32773,21285,33363,82597,15764,-666666666,,11883,38,021
"Ward County, North Dakota",69034,35881,33153,60298,2695,1509,1160,80,936,2356,77,2279,69034,64952,4082,0.4210,0.0163,34382,35611,36239,21652,32392,20035,36017,21786,19413,19962,38,101
"McHenry County, North Dakota",5927,3034,2893,5748,25,62,19,0,12,61,10,51,5927,5792,135,0.4805,0.0629,37626,38440,38913,13499,8512,14697,5195,-666666666,19292,9830,38,049
"Benson County, North Dakota",6886,3529,3357,2829,2,3865,8,0,11,171,14,157,6886,6823,63,0.5207,0.0309,21407,39221,39301,11721,,8591,26625,-666666666,24382,15145,38,005
"Renville County, North Dakota",2495,1258,1237,2401,5,13,20,0,13,43,17,26,2495,2337,158,0.3848,0.0295,33635,34524,36073,,,,10645,-666666666,,12770,38,075
"Burleigh County, North Dakota",93737,47152,46585,85561,1986,3541,618,49,281,1701,47,1654,93737,91542,2195,0.4330,0.0134,37764,39451,39882,18062,18429,17319,42453,11596,19086,20214,38,015
"Oliver County, North Dakota",1837,935,902,1688,18,40,5,0,3,83,0,83,1837,1805,32,0.4072,0.0458,33849,35652,35361,42672,,20108,,-666666666,,14035,38,065
"Ramsey County, North Dakota",11557,5886,5671,9824,61,1210,47,0,28,387,43,344,11557,11254,303,0.4946,0.0409,35059,38610,38897,12146,11487,15680,16326,-666666666,,11725,38,071
"Griggs County, North Dakota",2266,1142,1124,2160,31,34,0,0,6,35,10,25,2266,2260,6,0.4630,0.0397,35069,35325,35325,,,59485,-666666666,-666666666,,,38,039
"Sheridan County, North Dakota",1405,723,682,1379,0,11,0,0,0,15,0,15,1405,1405,0,0.4789,0.0471,32559,33042,33042,-666666666,-666666666,,-666666666,-666666666,-666666666,,38,083
"Wells County, North Dakota",4055,2003,2052,3966,0,6,7,0,29,47,23,24,4055,4003,52,0.4460,0.0418,34602,35082,35082,19435,-666666666,,,-666666666,33997,832,38,103
"Mahoning County, Ohio",231064,112742,118322,184750,34859,698,1972,70,1724,6991,710,6281,231064,217575,13489,0.4736,0.0104,27429,30111,30813,15406,16593,19043,36125,71406,18866,10640,39,099
"Scioto County, Ohio",76377,37604,38773,71975,2152,329,330,0,249,1342,110,1232,76377,75347,1030,0.4926,0.0175,23042,23614,23691,12689,8679,24279,27916,-666666666,6237,17013,39,145
"Meigs County, Ohio",23160,11474,11686,22499,308,41,18,0,12,282,0,282,23160,23041,119,0.4669,0.0320,23897,24152,24209,9611,23156,,,-666666666,,4711,39,105
"Pike County, Ohio",28214,13945,14269,26943,311,109,31,0,156,664,96,568,28214,27912,302,0.4377,0.0184,22301,22470,22521,23358,16702,12957,,-666666666,,22557,39,131
"Hamilton County, Ohio",812037,391728,420309,548291,208770,886,21129,541,8098,24322,1241,23081,812037,786201,25836,0.5021,0.0046,34125,40346,40777,23204,20030,24178,39680,61615,18318,15052,39,061
"Erie County, Ohio",75136,36863,38273,64312,6765,270,443,6,1018,2322,185,2137,75136,71890,3246,0.4559,0.0180,31677,33420,33774,16200,17974,23881,45657,,14456,29074,39,043
"Lawrence County, Ohio",60622,29728,30894,57920,1265,13,327,0,34,1063,18,1045,60622,60046,576,0.4483,0.0284,23692,23962,23923,23208,23273,,37933,-666666666,,5648,39,087
"Tuscarawas County, Ohio",92526,45411,47115,89484,728,245,354,0,165,1550,205,1345,92526,90083,2443,0.4172,0.0112,26034,26367,26579,15196,18063,13957,37068,-666666666,12572,11402,39,157
"Brown County, Ohio",43679,21649,22030,42422,338,74,129,0,132,584,8,576,43679,43259,420,0.4129,0.0176,25637,25941,26016,13213,13299,17924,9338,-666666666,16489,17367,39,015
"Licking County, Ohio",172293,84398,87895,158208,6582,214,2009,18,877,4385,371,4014,172293,169139,3154,0.4296,0.0097,30338,31073,31224,18942,29187,19275,21204,,22896,11831,39,089
"Carroll County, Ohio",27578,13752,13826,26891,187,9,128,0,16,347,0,347,27578,27220,358,0.4420,0.0257,28421,28657,28723,22978,14777,,24079,-666666666,,19856,39,019
"Clermont County, Ohio",203216,100124,103092,193269,2858,312,2538,114,736,3389,222,3167,203216,199394,3822,0.4403,0.0093,32900,33453,33623,20627,23742,44149,28992,8461,19239,14798,39,025
"Highland County, Ohio",43007,21136,21871,41325,782,62,174,0,31,633,19,614,43007,42561,446,0.4428,0.0187,22624,23036,23166,5594,14465,7603,21533,-666666666,,8238,39,071
"Portage County, Ohio",162644,79741,82903,147630,6738,371,3078,28,920,3879,114,3765,162644,159740,2904,0.4495,0.0092,29439,30424,30605,16799,23474,25482,20746,,19357,12146,39,133
"Belmont County, Ohio",68472,34995,33477,63840,2775,153,301,0,307,1096,66,1030,68472,67833,639,0.4448,0.0152,26106,26833,26690,28845,16182,10238,51397,-666666666,14088,7558,39,013
"Perry County, Ohio",35985,18019,17966,34970,149,93,65,8,38,662,119,543,35985,35680,305,0.4149,0.0152,22659,22987,23001,14921,6693,19238,,,,10398,39,127
"Bandera County, Texas",21763,11032,10731,19849,172,296,59,0,191,1196,57,1139,21763,17753,4010,0.4245,0.0241,28539,29766,31192,19111,22224,18851,46710,-666666666,28059,10658,48,019
"Robertson County, Texas",16890,8296,8594,12934,3276,76,52,22,218,312,29,283,16890,13409,3481,0.4437,0.0338,25465,28163,32289,16594,16279,35336,20504,30082,26737,7295,48,395
"Taylor County, Texas",136348,66718,69630,103990,10658,1177,3045,79,13800,3599,1082,2517,136348,103479,32869,0.4571,0.0129,26469,28912,31171,16531,18603,20054,30825,,16575,15925,48,441
"Trinity County, Texas",14569,7011,7558,12608,1318,48,147,0,181,267,64,203,14569,13149,1420,0.4323,0.0234,22265,23644,24520,13292,14581,67248,,-666666666,8529,4838,48,455
"Cochran County, Texas",2904,1491,1413,2623,100,0,0,0,94,87,8,79,2904,1220,1684,0.4662,0.0291,21014,21526,28623,17097,12145,-666666666,-666666666,-666666666,30832,5180,48,079
"Comal County, Texas",135097,66793,68304,122339,2588,294,1403,45,5237,3191,559,2632,135097,98485,36612,0.4408,0.0096,36899,37891,43244,21140,44856,23842,26807,89687,19474,25898,48,091
"Houston County, Texas",22955,12432,10523,15730,5709,70,72,0,784,590,71,519,22955,20444,2511,0.4601,0.0242,18080,20838,22374,7990,12966,,9729,-666666666,8988,9117,48,225
"Potter County, Texas",120899,62295,58604,94415,11905,647,6506,115,3085,4226,698,3528,120899,74994,45905,0.4763,0.0142,22267,24234,31592,14586,13443,19946,18851,13383,19556,11013,48,375
"Scurry County, Texas",17239,9425,7814,15043,837,69,49,0,846,395,153,242,17239,10322,6917,0.4117,0.0205,24508,25873,31399,16523,20177,13314,,-666666666,14114,7224,48,415
"Crane County, Texas",4839,2511,2328,2546,202,6,19,0,2014,52,52,0,4839,1759,3080,0.3891,0.0437,26113,29606,34298,22800,13262,,,-666666666,23434,,48,103
"Stonewall County, Texas",1385,730,655,1253,48,31,0,0,47,6,0,6,1385,1129,256,0.4660,0.0395,28746,30570,33818,10609,14140,,-666666666,-666666666,12174,,48,433
"Brown County, Texas",37834,18774,19060,34631,1464,198,281,0,543,717,137,580,37834,29535,8299,0.4691,0.0252,25145,25827,28200,16654,16863,12149,28417,-666666666,14687,19340,48,049
"Bee County, Texas",32691,19911,12780,28554,2610,213,147,4,522,641,191,450,32691,13539,19152,0.4980,0.0316,17390,18671,25640,14480,4147,17784,53016,,12725,9848,48,025
"McCulloch County, Texas",8098,4260,3838,6768,148,2,16,0,775,389,51,338,8098,5511,2587,0.4429,0.0335,24409,26843,29775,16384,20658,,,-666666666,9731,12184,48,307
"Lee County, Texas",16952,8558,8394,13493,1903,0,182,0,1214,160,63,97,16952,12982,3970,0.4396,0.0292,25876,27814,31054,13965,22228,-666666666,21974,-666666666,12398,12516,48,287
"Ellis County, Texas",168838,83184,85654,137354,16415,1767,1118,64,5689,6431,943,5488,168838,125101,43737,0.4144,0.0179,30727,32734,37066,18066,25823,15822,34309,29073,19571,13745,48,139
"Kerr County, Texas",51365,24886,26479,45906,789,420,481,32,2604,1133,97,1036,51365,37663,13702,0.4609,0.0314,30498,31925,36660,16147,10905,29993,15719,,18977,19799,48,265
"Falls County, Texas",17299,8189,9110,12489,4212,71,73,7,273,174,20,154,17299,13312,3987,0.4635,0.0234,17830,20321,24090,11077,11204,11080,27866,,14246,2423,48,145
"Montgomery County, Iowa",10155,4869,5286,9654,0,50,0,0,160,291,9,282,10155,9771,384,0.4644,0.0537,28780,29735,29951,11889,-666666666,12120,-666666666,-666666666,13998,8085,19,137
"Mahaska County, Iowa",22208,11252,10956,21129,347,58,308,15,82,269,20,249,22208,21733,475,0.4465,0.0273,27061,27782,27881,24027,6144,22947,18989,,38668,5245,19,123
"Buchanan County, Iowa",21125,10451,10674,20574,22,72,123,0,6,328,41,287,21125,20804,321,0.4570,0.0402,31495,32044,32175,23929,5205,24378,2962,-666666666,,11553,19,019
"Decatur County, Iowa",8044,4017,4027,7631,127,30,58,38,37,123,0,123,8044,7817,227,0.4448,0.0258,22037,22651,22982,6803,12398,9083,14753,4442,9341,9724,19,053
"Jackson County, Kansas",13318,6642,6676,11518,86,966,79,18,56,595,61,534,13318,12718,600,0.4057,0.0287,27950,29543,29842,16637,21285,18077,29635,26611,33095,13453,20,085
"Logan County, Kansas",2810,1398,1412,2690,1,21,0,6,8,84,5,79,2810,2647,163,0.4468,0.0513,27883,28461,29618,9439,,37071,-666666666,,,8562,20,109
"Wyandotte County, Kansas",164345,81294,83051,98246,37018,739,7164,368,13458,7352,1396,5956,164345,117607,46738,0.4273,0.0083,21298,23982,27790,14998,19490,20600,14532,11015,14792,13610,20,209
"Clay County, Kansas",8142,4078,4064,7875,45,54,54,0,0,114,0,114,8142,7941,201,0.4855,0.0551,32110,32382,32656,21921,,33504,18387,-666666666,-666666666,31857,20,027
"Saline County, Kansas",54977,27375,27602,48040,1543,261,1243,0,1704,2186,372,1814,54977,48899,6078,0.4377,0.0185,27737,28983,30189,17050,25702,19636,25157,-666666666,21287,9256,20,169
"Wabaunsee County, Kansas",6888,3497,3391,6613,32,37,51,0,18,137,0,137,6888,6641,247,0.3779,0.0246,28104,28655,29113,16875,17519,15597,16524,-666666666,,15135,20,197
"Mitchell County, Kansas",6222,3163,3059,6030,51,11,14,0,8,108,0,108,6222,6075,147,0.4336,0.0366,24732,25341,25630,7775,,,43214,-666666666,,2712,20,123
"Atchison County, Kansas",16363,7949,8414,14785,378,77,71,10,26,1016,47,969,16363,15876,487,0.4500,0.0393,24224,25540,25612,16841,21472,11583,12672,,4942,8502,20,005
"Finney County, Kansas",36957,18940,18017,29720,948,158,1491,0,3386,1254,192,1062,36957,18671,18286,0.4041,0.0247,23637,25198,32852,16873,21963,25699,16596,-666666666,18512,9863,20,055
"Leavenworth County, Kansas",80042,42933,37109,66240,7008,458,1110,40,1349,3837,256,3581,80042,74544,5498,0.4242,0.0263,31639,33897,34479,19282,23839,17166,26209,,20319,13593,20,103
"Stanton County, Kansas",2063,1055,1008,1918,1,6,0,0,48,90,19,71,2063,1319,744,0.4236,0.0435,23542,24455,29164,14795,,47467,-666666666,-666666666,13438,8033,20,187
"Meade County, Kansas",4261,2129,2132,3660,26,0,50,3,432,90,9,81,4261,3476,785,0.4174,0.0283,27273,27822,29401,18332,34265,-666666666,26058,,22986,24287,20,119
"Pratt County, Kansas",9582,4785,4797,8975,225,142,11,0,8,221,10,211,9582,8894,688,0.4197,0.0246,27050,28278,29184,13068,6235,14654,,-666666666,,8462,20,151
"Anderson County, Kansas",7852,3932,3920,7567,45,166,1,0,0,73,37,36,7852,7710,142,0.4181,0.0308,23210,23913,24113,7179,15396,2251,,-666666666,-666666666,2766,20,003
"Geary County, Kansas",34895,18540,16355,23881,6334,432,1085,318,681,2164,137,2027,34895,29324,5571,0.3761,0.0159,22797,24760,25745,17820,20733,21446,19242,18616,20326,10626,20,061
"Ford County, Kansas",34484,17896,16588,30815,697,157,514,18,1408,875,301,574,34484,15675,18809,0.4230,0.0186,23348,23922,34806,15317,21598,19705,27160,,14822,17006,20,057
"Marshall County, Kansas",9798,4924,4874,9494,50,24,52,23,20,135,15,120,9798,9559,239,0.4143,0.0238,27167,27437,27626,18334,41826,,30069,,,8131,20,117
"Cheyenne County, Kansas",2677,1320,1357,2540,0,0,1,0,120,16,2,14,2677,2503,174,0.4289,0.0300,28467,29200,29444,16998,-666666666,-666666666,,-666666666,14990,,20,023
"Cowley County, Kansas",35591,17915,17676,31224,1126,639,570,42,513,1477,97,1380,35591,31755,3836,0.4256,0.0144,23778,24588,25778,14023,15601,24059,30540,17571,20726,11399,20,035
"Franklin County, Kansas",25563,12567,12996,23768,271,143,73,4,497,807,48,759,25563,24501,1062,0.4014,0.0282,26757,27744,28091,11487,19159,27026,35579,,10391,9514,20,059
"Jewell County, Kansas",2916,1482,1434,2840,18,15,0,4,10,29,0,29,2916,2848,68,0.4943,0.0550,26908,27173,27493,13359,,12493,-666666666,,,16269,20,089
"Rice County, Kansas",9762,4844,4918,8931,183,72,88,35,269,184,23,161,9762,8661,1101,0.4036,0.0175,23971,24790,25912,14019,14515,,9144,14291,20778,13692,20,159
"Chase County, Kansas",2645,1340,1305,2516,46,13,0,0,18,52,0,52,2645,2523,122,0.4360,0.0464,25105,25613,26191,12516,4952,,-666666666,-666666666,,2577,20,017
"Wichita County, Kansas",2143,1019,1124,1931,19,28,19,0,119,27,0,27,2143,1518,625,0.4020,0.0363,29762,30805,35652,15992,,15414,,-666666666,14914,40837,20,203
"Norton County, Kansas",5486,3036,2450,5067,148,46,32,0,27,166,66,100,5486,5204,282,0.4647,0.1031,26953,28720,29488,6213,6813,5070,,-666666666,9019,3292,20,137
"Barton County, Kansas",26791,13362,13429,25104,453,293,55,70,252,564,22,542,26791,22856,3935,0.4445,0.0221,27133,27791,29775,15558,10338,37888,20407,14104,19685,11345,20,009
"Edwards County, Kansas",2925,1494,1431,2792,17,0,11,0,48,57,2,55,2925,2330,595,0.3987,0.0250,27309,27705,30083,18734,11429,-666666666,,-666666666,28979,10395,20,047
"Rush County, Kansas",3102,1521,1581,2977,5,9,19,0,12,80,0,80,3102,3019,83,0.4307,0.0220,25590,26176,26073,27734,,,,-666666666,,8410,20,165
"Marion County, Kansas",12032,5971,6061,11535,59,12,30,0,41,355,13,342,12032,11602,430,0.4183,0.0313,25756,26242,26682,11801,11193,15433,11487,-666666666,2678,16608,20,115
"Ottawa County, Kansas",5902,3043,2859,5682,53,34,31,0,0,102,16,86,5902,5739,163,0.4134,0.0426,27610,27313,27402,58935,,,,-666666666,-666666666,9996,20,143
"Barber County, Kansas",4733,2356,2377,4518,28,49,31,0,5,102,0,102,4733,4542,191,0.4706,0.0430,28984,29620,30186,17087,9771,,20913,-666666666,49680,15743,20,007
"Dickinson County, Kansas",19004,9555,9449,17995,256,167,85,0,70,431,89,342,19004,18128,876,0.4447,0.0287,26201,26769,27222,16696,14409,24072,11828,-666666666,20971,14011,20,041
"Trimble County, Kentucky",8637,4238,4399,8323,0,26,6,45,87,150,7,143,8637,8381,256,0.4569,0.0411,26089,26197,26434,11164,-666666666,,,,,18267,21,223
"Hickman County, Kentucky",4568,2133,2435,3983,431,12,26,0,13,103,21,82,4568,4515,53,0.4824,0.0703,24432,26202,26314,,13758,,,-666666666,,5084,21,105
"Nelson County, Kentucky",45388,22492,22896,41391,2252,51,275,0,534,885,95,790,45388,44435,953,0.4828,0.0649,31387,30554,30714,6417,60030,21202,31061,-666666666,3663,14873,21,179
"Grant County, Kentucky",24915,12318,12597,23619,190,28,39,0,612,427,11,416,24915,24242,673,0.4178,0.0195,22073,22769,22864,15371,6888,,,-666666666,10374,9915,21,081
"Logan County, Kentucky",26849,13154,13695,24349,1668,20,68,2,137,605,57,548,26849,26096,753,0.4440,0.0328,23177,23932,24316,10704,19053,,7815,,23459,6660,21,141
"Pendleton County, Kentucky",14520,7360,7160,14120,116,8,81,45,11,139,0,139,14520,14331,189,0.4022,0.0241,22620,22951,23121,3995,2603,,31746,,,9204,21,191
"Spencer County, Kentucky",18246,9277,8969,17579,220,39,135,0,24,249,0,249,18246,17871,375,0.3887,0.0277,33568,33590,33584,33371,46909,,63221,-666666666,,7842,21,215
"Bath County, Kentucky",12268,6096,6172,11773,141,14,61,0,75,204,24,180,12268,12073,195,0.4579,0.0477,21175,21286,21376,28375,13404,,24592,-666666666,,5772,21,011
"Boyle County, Kentucky",29913,14903,15010,26374,2114,85,262,0,213,865,52,813,29913,28926,987,0.4731,0.0191,24933,26172,26622,9629,18622,13893,3716,-666666666,6347,14662,21,021
"Harlan County, Kentucky",27134,13132,14002,25899,699,21,110,0,101,304,56,248,27134,26887,247,0.4803,0.0181,15834,15996,16050,3663,13599,11533,19354,-666666666,,8742,21,095
"Lincoln County, Kentucky",24458,11981,12477,23147,500,4,4,8,134,661,185,476,24458,24069,389,0.4369,0.0196,20212,20324,20352,10906,33395,,,,22376,6144,21,137
"Monroe County, Kentucky",10634,5370,5264,10192,299,15,0,7,56,65,4,61,10634,10303,331,0.5282,0.0357,23025,23421,23761,10159,16626,,-666666666,,11098,6717,21,171
"Union County, Kentucky",14802,7597,7205,12333,1913,5,82,0,47,422,33,389,14802,14518,284,0.4204,0.0202,22027,24582,24738,11436,10641,,,-666666666,18919,3533,21,225
"Calloway County, Kentucky",38776,18818,19958,35338,1326,112,582,50,198,1170,92,1078,38776,37740,1036,0.4863,0.0203,22489,23328,23568,9482,18160,10140,21568,,15527,3465,21,035
"Daviess County, Kentucky",99937,48742,51195,90493,4283,164,1466,262,489,2780,120,2660,99937,96928,3009,0.4650,0.0160,27462,28513,28938,11544,20756,16630,33454,10445,8676,5958,21,059
"Pulaski County, Kentucky",64145,31517,32628,61682,653,205,497,0,330,778,45,733,64145,62553,1592,0.4918,0.0176,22342,22490,22665,16523,22765,25892,16100,-666666666,21341,13687,21,199
"Henderson County, Kentucky",46137,22328,23809,40608,3384,79,191,5,553,1317,89,1228,46137,44985,1152,0.4620,0.0259,25376,26691,27061,9191,19926,13718,20258,,12570,5495,21,101
"Knott County, Kentucky",15513,7693,7820,15183,95,5,8,13,17,192,29,163,15513,15361,152,0.4677,0.0221,18201,18384,18513,3067,16046,,,,,6950,21,119
"Muhlenberg County, Kentucky",31081,15286,15795,28825,1538,68,173,14,60,403,131,272,31081,30616,465,0.4299,0.0186,21521,22234,22271,18028,12564,16341,6862,,,6184,21,177
"Adair County, Kentucky",19241,9525,9716,18201,631,44,66,0,93,206,21,185,19241,18878,363,0.4696,0.0366,20166,20421,20530,11734,18963,,17747,-666666666,3953,7643,21,001
"Cumberland County, Kentucky",6713,3289,3424,6249,262,0,24,0,105,73,18,55,6713,6654,59,0.4672,0.0309,17926,18286,18407,,14349,-666666666,,-666666666,19866,1562,21,057
"Lee County, Kentucky",6751,3501,3250,6532,57,20,42,0,0,100,0,100,6751,6711,40,0.5154,0.0568,17179,17686,17546,,4458,1575,,-666666666,-666666666,1061,21,129
"Lewis County, Kentucky",13490,6714,6776,13196,62,146,14,0,0,72,0,72,13490,13490,0,0.5111,0.0384,20059,20387,20387,-666666666,16195,2337,,-666666666,-666666666,2907,21,135
"Woodford County, Kentucky",26097,12564,13533,23658,1166,0,86,0,536,651,69,582,26097,24344,1753,0.4313,0.0183,31259,32640,33358,15724,24876,-666666666,36397,-666666666,9489,9775,21,239
"Jessamine County, Kentucky",52422,25479,26943,47834,2121,209,751,16,467,1024,105,919,52422,50663,1759,0.4942,0.0237,30215,31625,32097,13052,14127,14985,26896,,14478,10822,21,113
"Letcher County, Kentucky",22676,11087,11589,22208,88,47,57,0,37,239,53,186,22676,22501,175,0.4967,0.0241,18811,18724,18700,20373,8876,19226,45391,-666666666,33524,21849,21,133
"McCracken County, Kentucky",65284,31193,34091,55642,7148,195,482,55,306,1456,81,1375,65284,63690,1594,0.5310,0.0296,31850,34319,34289,32126,18261,12030,13260,,24496,15129,21,145
"Whitley County, Kentucky",36089,17668,18421,34925,360,68,110,20,156,450,31,419,36089,35647,442,0.4930,0.0373,19145,19458,19562,5199,5938,19107,27515,,,9485,21,235
"Floyd County, Kentucky",36926,18070,18856,36050,399,4,116,0,35,322,37,285,36926,36631,295,0.5007,0.0305,18462,18354,18386,8099,9094,,120214,-666666666,,7337,21,071
"McCreary County, Kentucky",17635,9613,8022,15951,997,140,125,11,93,318,165,153,17635,17197,438,0.5039,0.0388,12903,13258,13314,17855,6382,13600,,,,18679,21,147
"Metcalfe County, Kentucky",10004,4923,5081,9636,110,4,32,0,0,222,0,222,10004,9874,130,0.4517,0.0235,19436,19832,19898,14998,9393,,13047,-666666666,-666666666,8058,21,169
"Rowan County, Kentucky",24499,11763,12736,23513,432,45,175,0,45,289,7,282,24499,24093,406,0.4793,0.0296,19692,20145,20307,10062,4321,,6108,-666666666,,9060,21,205
"Clark County, Kentucky",35872,17573,18299,33250,1663,30,200,0,133,596,20,576,35872,34843,1029,0.4439,0.0196,27416,28300,28742,13407,18676,,12810,-666666666,24953,7487,21,049
"Carroll County, Kentucky",10711,5455,5256,9860,318,19,45,0,337,132,6,126,10711,9978,733,0.4793,0.0314,23546,24325,24867,15426,7114,,23136,-666666666,23090,9241,21,041
"Estill County, Kentucky",14313,7104,7209,13972,24,58,12,7,5,235,8,227,14313,14266,47,0.4767,0.0250,17658,17880,17913,9377,19450,8400,,,,7446,21,065
"Greenup County, Kentucky",35765,17411,18354,34664,313,27,163,0,98,500,22,478,35765,35386,379,0.4585,0.0187,26712,26795,26761,28472,17805,,53309,-666666666,32308,17074,21,089
"Carter County, Kentucky",27290,13437,13853,26642,267,110,17,3,22,229,0,229,27290,27039,251,0.4846,0.0246,17782,18033,18146,5744,3987,20007,,,,6919,21,043
"Lafourche Parish, Louisiana",98214,48261,49953,77351,13064,2343,732,15,2187,2522,114,2408,98214,93923,4291,0.4605,0.0122,27375,30004,30040,24349,17007,24487,25059,,19802,10509,22,057
"Jefferson Davis Parish, Louisiana",31467,15590,15877,25140,5215,290,142,0,110,570,23,547,31467,30726,741,0.4974,0.0216,24582,27190,27531,11617,15222,15927,6725,-666666666,,6475,22,053
"West Feliciana Parish, Louisiana",15377,9802,5575,8243,6807,23,103,0,30,171,6,165,15377,15139,238,0.4625,0.0309,23565,33285,33875,8732,10636,,,-666666666,,3330,22,125
"Beauregard Parish, Louisiana",36769,18712,18057,30483,4580,321,120,11,224,1030,25,1005,36769,35406,1363,0.4683,0.0228,26075,27250,27639,17155,21064,21698,13746,,20108,16865,22,011
"Evangeline Parish, Louisiana",33636,17142,16494,22791,9253,78,147,0,790,577,11,566,33636,32453,1183,0.4830,0.0211,18344,22456,22646,4807,10337,16768,16040,-666666666,1842,7700,22,039
"Lincoln Parish, Louisiana",47356,23041,24315,25524,19343,152,779,0,944,614,57,557,47356,45919,1437,0.5385,0.0174,22498,30760,30891,14275,12937,2194,9950,-666666666,15344,12159,22,061
"Webster Parish, Louisiana",39631,19242,20389,25179,13568,139,133,42,64,506,47,459,39631,38892,739,0.4666,0.0161,18701,21930,22271,9054,12564,23301,12058,38286,24506,20746,22,119
"Iberville Parish, Louisiana",32956,16661,16295,16248,15935,71,21,0,205,476,0,476,32956,32118,838,0.4686,0.0234,23179,31500,31759,19638,15332,,34443,-666666666,12391,9423,22,047
"Morehouse Parish, Louisiana",25992,12444,13548,12857,12793,11,131,0,98,102,0,102,25992,25890,102,0.5129,0.0464,19399,24938,24977,5976,13973,,10760,-666666666,,29619,22,067
"Terrebonne Parish, Louisiana",112587,55305,57282,79613,21588,6391,1049,72,1192,2682,68,2614,112587,106822,5765,0.4691,0.0132,24921,28089,28701,19187,16029,18803,22826,8611,28789,16555,22,109
"Claiborne Parish, Louisiana",16153,9205,6948,7398,8397,36,22,0,78,222,19,203,16153,15917,236,0.5074,0.0496,16948,21022,21197,2436,13726,,,-666666666,,8229,22,027
"Avoyelles Parish, Louisiana",40882,20607,20275,27130,11769,368,220,69,118,1208,51,1157,40882,40120,762,0.5055,0.0167,21390,25919,26244,8536,12471,15280,41843,19525,14904,5441,22,009
"Pointe Coupee Parish, Louisiana",22158,10614,11544,13504,7874,65,57,0,417,241,0,241,22158,21581,577,0.5055,0.0317,26663,33395,33592,14102,16918,,15189,-666666666,9599,6738,22,077
"Vernon Parish, Louisiana",51007,27126,23881,38648,7437,646,1073,223,1195,1785,297,1488,51007,46217,4790,0.4419,0.0176,23763,24904,25541,18237,20112,17916,26836,22473,20524,16851,22,115
"Sabine Parish, Louisiana",24088,11929,12159,16735,3931,1764,96,7,166,1389,99,1290,24088,23155,933,0.4888,0.0165,22637,26279,26582,17095,11784,19168,16776,,14208,15109,22,085
"LaSalle Parish, Louisiana",14949,7730,7219,12639,1855,149,10,12,111,173,0,173,14949,14527,422,0.4774,0.0322,20427,22056,22282,7925,10716,31646,,,,9960,22,059
"Lincoln County, Maine",34067,16624,17443,33033,161,138,324,0,79,332,6,326,34067,33667,400,0.4469,0.0158,32400,32656,32781,17939,26465,13612,33489,-666666666,9541,21981,23,015
"Piscataquis County, Maine",16887,8440,8447,16229,91,92,115,0,100,260,10,250,16887,16645,242,0.4497,0.0164,24062,23990,24052,44904,14924,7652,11877,-666666666,81148,20961,23,021
"Washington County, Maine",31694,15614,16080,28896,152,1607,139,4,190,706,21,685,31694,30989,705,0.4610,0.0289,24647,25575,25718,17676,24604,13107,22781,,23247,13825,23,029
"Sagadahoc County, Maine",35277,17228,18049,33730,265,120,228,0,60,874,89,785,35277,34700,577,0.4254,0.0209,34432,34985,35058,26432,29978,26529,16435,-666666666,62485,18285,23,023
"Kennebec County, Maine",121545,59159,62386,116510,1045,666,1153,97,150,1924,90,1834,121545,119717,1828,0.4372,0.0121,29084,29565,29626,19652,12376,23025,27890,11215,4526,14664,23,011
"Hancock County, Maine",54541,26374,28167,52323,465,225,569,58,40,861,26,835,54541,53782,759,0.4653,0.0119,32491,32921,33072,18280,21473,11413,36327,,14180,17118,23,009
"Somerset County, Maryland",25737,13833,11904,13600,10863,86,265,5,460,458,0,458,25737,24838,899,0.4553,0.0252,18924,25712,26183,9184,11243,12576,18441,,8707,9408,24,039
"Allegany County, Maryland",71977,37646,34331,63483,6051,94,635,13,209,1492,102,1390,71977,70716,1261,0.4480,0.0139,23280,25234,25340,12940,5135,7938,40708,36100,9013,9145,24,001
"Prince George's County, Maryland",906202,436446,469756,162673,570494,3166,37726,377,105275,26491,4548,21943,906202,743830,162372,0.3988,0.0033,35869,40613,47483,19534,38300,32777,34455,58708,17900,27845,24,033
"Frederick County, Maryland",248472,122524,125948,201553,23337,606,10929,187,3611,8249,1095,7154,248472,225617,22855,0.4067,0.0074,41432,43794,45667,24392,30769,50223,41018,31349,27149,20253,24,021
"Kent County, Maryland",19593,9344,10249,15939,2818,25,248,6,157,400,5,395,19593,18745,848,0.4830,0.0251,34910,38774,39227,26218,19568,23988,11193,,9516,14886,24,029
"Worcester County, Massachusetts",822280,405434,416846,690566,40817,1813,39694,232,25404,23754,4239,19515,822280,730548,91732,0.4553,0.0044,36169,38163,39875,18332,22621,19985,37399,38991,19857,18080,25,027
"Chippewa County, Michigan",37834,20794,17040,26848,2505,5428,361,60,31,2601,95,2506,37834,37132,702,0.4534,0.0250,23310,26815,27055,10477,7051,18919,24576,18300,13532,12010,26,033
"Oakland County, Michigan",1250843,610771,640072,941026,171098,3302,90212,323,9911,34971,2380,32591,1250843,1200786,50057,0.4687,0.0032,42760,45616,46329,26127,29730,35202,48918,59049,24010,19622,26,125
"Muskegon County, Michigan",173043,86083,86960,139770,23717,1312,964,21,872,6387,402,5985,173043,163388,9655,0.4367,0.0091,24101,26462,27014,15571,14818,17382,26233,,16455,9068,26,121
"Lapeer County, Michigan",88202,44842,43360,84482,1092,307,484,24,456,1357,246,1111,88202,84110,4092,0.4135,0.0125,28309,28942,29415,17602,3038,25633,22919,,15940,16163,26,087
"Sanilac County, Michigan",41376,20534,20842,40015,242,136,140,3,281,559,53,506,41376,39857,1519,0.4342,0.0127,24835,25200,25361,17949,10142,24189,19960,,18562,9658,26,151
"Ontonagon County, Michigan",5968,3054,2914,5732,33,52,15,8,9,119,0,119,5968,5881,87,0.4096,0.0225,23850,24195,24154,27078,13091,27013,6160,,,12245,26,131
"Alcona County, Michigan",10364,5224,5140,10048,40,58,29,8,24,157,25,132,10364,10215,149,0.4313,0.0171,25219,25649,25752,15099,9890,18621,11666,,9717,9929,26,001
"Kalkaska County, Michigan",17463,8908,8555,16726,161,133,106,0,49,288,0,288,17463,17126,337,0.4213,0.0180,23687,24161,24019,28888,9253,20653,15815,-666666666,13696,10268,26,079
"Ingham County, Michigan",289564,140970,148594,215518,33020,1049,18754,115,4936,16172,1751,14421,289564,267278,22286,0.4757,0.0078,28366,31041,31711,18201,20037,24388,28300,31695,20458,12453,26,065
"Ogemaw County, Michigan",20928,10480,10448,20208,77,226,131,0,43,243,32,211,20928,20485,443,0.4143,0.0121,22527,22439,22522,18105,6803,21103,54692,-666666666,16091,19992,26,129
"Wexford County, Michigan",33111,16567,16544,31773,237,151,194,8,40,708,47,661,33111,32480,631,0.4321,0.0191,22760,23103,23185,14930,15803,8738,33514,13450,9653,10603,26,165
"Dickinson County, Michigan",25570,12754,12816,24584,157,324,157,0,56,292,93,199,25570,25189,381,0.4411,0.0237,28020,28436,28593,10959,8146,3114,34453,-666666666,15671,30205,26,043
"Menominee County, Michigan",23234,11781,11453,21933,65,540,93,0,29,574,35,539,23234,22830,404,0.4465,0.0282,27609,28454,28640,14610,13323,13853,24986,-666666666,22321,10544,26,109
"Missaukee County, Michigan",15006,7668,7338,14440,68,95,24,0,77,302,11,291,15006,14580,426,0.4014,0.0149,22850,23050,23310,12494,7837,18929,55625,-666666666,16104,17019,26,113
"Van Buren County, Michigan",75272,37429,37843,64678,2496,762,512,33,3432,3359,795,2564,75272,66686,8586,0.4398,0.0159,26771,28908,29737,12966,15539,11822,18000,23718,14662,11097,26,159
"Barry County, Michigan",60057,30248,29809,57803,295,163,333,3,447,1013,58,955,60057,58343,1714,0.3916,0.0161,28783,29192,29275,21082,22010,17617,19484,,15353,18225,26,015
"Benzie County, Michigan",17552,8743,8809,16836,67,293,78,7,11,260,21,239,17552,17117,435,0.4048,0.0175,27866,28066,28241,21500,4266,17438,26227,,,30333,26,019
"Schoolcraft County, Michigan",8069,3984,4085,6996,41,557,31,0,5,439,4,435,8069,7988,81,0.4295,0.0199,22931,23920,24134,3480,13510,20535,10874,-666666666,,12097,26,153
"Grand Traverse County, Michigan",91746,45367,46379,86964,982,997,530,44,394,1835,71,1764,91746,89162,2584,0.4484,0.0144,33754,34481,34885,18727,16610,23017,27424,31366,25788,17881,26,055
"Genesee County, Michigan",409361,197382,211979,306623,81213,1510,4253,130,2051,13581,691,12890,409361,395564,13797,0.4650,0.0064,26386,28965,29310,18533,18048,16037,51195,57312,21664,11828,26,049
"Livingston County, Michigan",188482,94566,93916,181591,1114,534,1730,124,589,2800,185,2615,188482,184014,4468,0.4020,0.0069,38399,38773,38972,26647,23335,28087,46378,10220,20440,22217,26,093
"Manistee County, Michigan",24444,12658,11786,22320,679,385,114,14,78,854,53,801,24444,23706,738,0.4408,0.0146,25778,26982,27334,10983,5284,21022,21809,,10138,14085,26,101
"Gladwin County, Michigan",25289,12739,12550,24563,89,168,125,0,43,301,49,252,25289,24892,397,0.4407,0.0151,24594,24850,24879,18791,42565,9842,17538,-666666666,15363,10838,26,051
"Lawrence County, Arkansas",16669,8270,8399,16127,173,47,16,1,23,282,0,282,16669,16429,240,0.4358,0.0164,20451,20662,20788,11243,10608,29055,20888,,,13407,05,075
"Conway County, Arkansas",20906,10182,10724,17805,2282,64,19,0,37,699,9,690,20906,20094,812,0.4675,0.0278,23750,24604,25118,13374,20805,22472,,-666666666,29059,11818,05,029
"Arkansas County, Arkansas",18124,8733,9391,13146,4677,18,0,0,76,207,33,174,18124,17570,554,0.4963,0.0266,24714,28575,29084,13801,14883,,-666666666,-666666666,15964,5363,05,001
"Lonoke County, Arkansas",72206,35667,36539,64282,4379,434,531,85,908,1587,136,1451,72206,69010,3196,0.4052,0.0133,26222,27159,27299,22369,18534,20961,27901,,24202,12213,05,085
"Merced County, California",269075,135816,133259,154376,8772,1988,20131,623,72152,11033,4177,6856,269075,110581,158494,0.4708,0.0116,21634,25910,36838,14919,19542,16558,19916,21485,14749,12564,06,047
"Modoc County, California",8938,4613,4325,8046,149,298,140,6,52,247,58,189,8938,7646,1292,0.4113,0.0276,23235,24203,25879,13150,14360,14249,20418,,7931,13295,06,049
"Inyo County, California",18085,9084,9001,14557,161,2101,290,35,322,619,250,369,18085,14158,3927,0.4240,0.0225,31540,33673,38694,16226,15024,20553,37883,16343,32208,20511,06,027
"Stanislaus County, California",539301,266844,272457,408817,15534,4261,29248,3973,54861,22607,5836,16771,539301,293328,245973,0.4451,0.0060,25101,26619,34224,16679,24247,25674,28064,18584,17195,14630,06,099
"Tehama County, California",63373,31504,31869,54119,471,1621,964,19,3639,2540,508,2032,63373,47750,15623,0.4585,0.0185,23126,24454,26776,14700,24370,18610,15114,,16380,10148,06,103
"San Benito County, California",59416,29626,29790,48851,440,422,1739,117,5035,2812,943,1869,59416,24168,35248,0.3989,0.0154,31475,32621,47079,21952,42827,25467,36074,32461,24777,19804,06,069
"El Dorado County, California",186661,93040,93621,164202,1494,1268,8291,406,4051,6949,659,6290,186661,163030,23631,0.4494,0.0081,40382,41393,43367,24052,31861,28978,45856,30293,20903,25826,06,017
"San Francisco County, California",870044,443970,426074,406538,45402,2746,297667,2911,67424,47356,7051,40305,870044,737393,132651,0.5128,0.0040,64157,87294,93473,34923,33622,34992,49681,34460,26322,43182,06,075
"Tulare County, California",460477,230255,230222,352259,7326,5469,16462,697,62743,15521,5178,10343,460477,165328,295149,0.4755,0.0082,20421,21307,34622,13526,19735,17109,29462,16273,14981,14399,06,107
"Nevada County, California",99092,48889,50203,91579,655,864,1008,154,1379,3453,244,3209,99092,89811,9281,0.4634,0.0131,37145,37845,39330,21301,24679,21113,45693,36336,27507,26331,06,057
"Madera County, California",155013,74683,80330,111621,5026,2505,3294,169,26944,5454,2259,3195,155013,66207,88806,0.4408,0.0110,21394,23251,32499,14745,16822,17753,27096,21476,15180,16504,06,039
"Trinity County, California",12862,6582,6280,11136,87,577,207,158,377,320,15,305,12862,11932,930,0.4821,0.0345,25964,27209,27737,17673,7570,22367,7519,,23724,20188,06,105
"San Bernardino County, California",2135413,1062472,1072941,1305047,178404,17894,149837,6506,376608,101117,28811,72306,2135413,1007600,1127813,0.4410,0.0033,23956,25747,33983,17772,22817,20004,31726,20457,17589,15976,06,071
"Placer County, California",380077,185511,194566,313636,6197,1890,27535,839,11920,18060,1989,16071,380077,327579,52498,0.4474,0.0061,41508,42959,44953,25767,35550,27375,45135,33450,23791,26368,06,061
"Solano County, California",438530,217931,220599,231149,61826,2114,67813,4113,39952,31563,4482,27081,438530,324124,114406,0.4231,0.0076,33700,38350,43935,21920,29278,21681,35261,29177,21152,22225,06,095
"Colusa County, California",21464,11124,10340,18854,362,201,324,53,1112,558,24,534,21464,8809,12655,0.4982,0.0459,27336,27527,42685,16949,63745,34284,25549,30525,16836,16414,06,011
"Kings County, California",150075,82674,67401,98429,9687,2291,5946,337,26971,6414,1400,5014,150075,68921,81154,0.4346,0.0138,21186,23146,31678,13770,20386,18498,35009,12908,13017,15244,06,031
"Fresno County, California",978130,487936,490194,627437,47372,10961,100017,1770,151250,39323,8622,30701,978130,462223,515907,0.4785,0.0055,23284,26143,38110,15334,18965,18496,23630,17413,14626,16885,06,019
"Ventura County, California",848112,419588,428524,680197,14835,7069,61772,1771,44907,37561,6971,30590,848112,488095,360017,0.4476,0.0050,36891,38067,51591,20266,37388,28016,44215,33035,21641,23441,06,111
"Weld County, Colorado",295123,148627,146496,267514,3431,2032,4327,280,9158,8381,1972,6409,295123,208801,86322,0.4156,0.0071,30626,31503,36427,18707,17840,29430,26016,21364,22102,20141,08,123
"Custer County, Colorado",4640,2265,2375,4333,119,44,0,0,36,108,0,108,4640,4196,444,0.4389,0.0446,26976,28185,28189,26977,4939,,-666666666,-666666666,21614,9726,08,027
"Douglas County, Colorado",328614,163766,164848,293266,4460,1075,14700,257,4823,10033,1306,8727,328614,300616,27998,0.3989,0.0071,51017,52175,53557,34518,43655,37793,50426,51846,41324,27355,08,035
"La Plata County, Colorado",55101,27790,27311,48385,261,3435,341,13,1238,1428,138,1290,55101,48073,7028,0.4584,0.0255,37864,40014,41971,22121,33252,21029,22277,,21449,24598,08,067
"Rio Grande County, Colorado",11351,5696,5655,10344,98,306,24,8,351,220,70,150,11351,6305,5046,0.4688,0.0318,22413,23085,28460,15938,13154,11546,,,24152,7964,08,105
"Bent County, Colorado",5809,3790,2019,5315,230,72,34,0,81,77,29,48,5809,3951,1858,0.4395,0.0336,14777,15594,18180,9825,189,15724,12782,-666666666,9631,7339,08,011
"San Juan County, Colorado",544,283,261,537,0,7,0,0,0,0,0,0,544,496,48,0.4197,0.0520,33984,34330,35333,24121,-666666666,,-666666666,-666666666,-666666666,-666666666,08,111
"Logan County, Colorado",21689,11708,9981,20060,202,105,164,0,168,990,31,959,21689,18246,3443,0.4365,0.0257,25776,27179,28870,17871,3563,13472,23846,-666666666,16012,5156,08,075
"Teller County, Colorado",24113,12157,11956,22823,191,110,244,8,185,552,26,526,24113,22581,1532,0.4104,0.0250,34392,34541,35569,19549,50502,30312,34831,,32304,23642,08,119
"Elbert County, Colorado",25162,12721,12441,23476,122,222,243,10,267,822,146,676,25162,23469,1693,0.4049,0.0193,43349,43999,44772,28517,86006,26233,55711,,35888,21714,08,039
"Lincoln County, Colorado",5548,3471,2077,4812,532,55,37,25,20,67,0,67,5548,4345,1203,0.4364,0.0350,16219,17718,22799,1855,1408,12876,29989,,27360,18943,08,073
"Alamosa County, Colorado",16444,8242,8202,14297,191,526,178,65,651,536,128,408,16444,8902,7542,0.4821,0.0348,21328,21793,28338,14218,16072,13885,16810,,20743,18288,08,003
"Fremont County, Colorado",47002,27324,19678,42213,1935,665,326,2,622,1239,409,830,47002,40816,6186,0.4470,0.0238,21965,23751,25845,7834,3484,6703,12711,,9451,6816,08,043
"Montrose County, Colorado",41268,20374,20894,38909,155,429,373,101,594,707,126,581,41268,32792,8476,0.4234,0.0182,25803,26318,29141,14569,23217,19410,15445,,17817,15279,08,085
"Saguache County, Colorado",6468,3182,3286,5944,0,170,0,0,149,205,15,190,6468,4102,2366,0.5097,0.0486,22901,23378,28790,13639,-666666666,26612,-666666666,-666666666,9474,15744,08,109
"Hinsdale County, Colorado",878,406,472,831,0,24,3,0,7,13,0,13,878,827,51,0.4769,0.0449,34644,35894,37009,11576,-666666666,,,-666666666,,,08,053
"Grand County, Colorado",15066,8129,6937,14284,122,11,167,84,261,137,0,137,15066,13793,1273,0.4019,0.0274,34717,35508,36894,18112,70761,,11128,15570,13738,,08,049
"Otero County, Colorado",18325,8872,9453,16346,251,293,186,16,814,419,131,288,18325,10688,7637,0.4770,0.0233,20109,20940,25614,13654,6364,16244,10261,,15039,9979,08,089
"Litchfield County, Connecticut",183031,90447,92584,170083,3528,356,3394,6,2222,3442,886,2556,183031,172090,10941,0.4479,0.0095,42443,43680,44443,23007,26839,32346,34326,,20397,20574,09,005
"New London County, Connecticut",268881,134703,134178,216974,15760,1477,11087,74,9126,14383,1847,12536,268881,241119,27762,0.4439,0.0068,38109,41567,42622,20050,24651,28730,37480,34089,18474,14616,09,011
"Wakulla County, Florida",31877,17490,14387,26203,4741,38,199,0,277,419,0,419,31877,30712,1165,0.3787,0.0190,24322,26410,26666,18051,14148,,18034,-666666666,16065,14936,12,129
"Fairfield County, Connecticut",944348,459963,484385,691642,107215,2338,49927,487,65132,27607,7619,19988,944348,761695,182653,0.5432,0.0037,55613,64925,71093,24561,26237,24367,58835,65116,18744,20043,09,001
"Kent County, Delaware",174822,84271,90551,115960,44292,1143,3509,59,2363,7496,597,6899,174822,162642,12180,0.4302,0.0105,28100,30712,31354,19661,24094,28587,29332,24441,21523,12811,10,001
"Hillsborough County, Florida",1378883,673286,705597,970497,229200,4336,55157,904,68035,50754,9256,41498,1378883,992405,386478,0.4799,0.0043,31173,34858,40428,20516,20963,27271,35686,14591,18018,20171,12,057
"Gulf County, Florida",16055,9586,6469,12522,3011,59,86,27,76,274,22,252,16055,15295,760,0.4149,0.0220,21255,23492,24167,6009,13008,15563,16138,,,8759,12,045
"Osceola County, Florida",338619,166820,171799,246757,38975,1526,9158,358,28338,13507,4274,9233,338619,159231,179388,0.4283,0.0105,21331,22495,29601,16716,19107,16150,21347,10550,17275,15869,12,097
"Walton County, Florida",65858,33317,32541,57089,3092,400,644,92,2159,2382,127,2255,65858,61829,4029,0.4993,0.0215,33731,36219,36581,17455,15523,24309,33547,,14535,17739,12,131
"Jefferson County, Florida",14105,7507,6598,8824,4868,77,30,0,84,222,0,222,14105,13540,565,0.4545,0.0286,23448,28109,28918,12774,16130,20047,,-666666666,,8427,12,065
"Hardee County, Florida",27228,14705,12523,22163,2111,45,212,21,2447,229,58,171,27228,15394,11834,0.4817,0.0339,18257,19895,26482,10745,9672,13331,25789,,10743,11734,12,049
"Okeechobee County, Florida",40572,21866,18706,35136,3529,334,380,86,562,545,0,545,40572,30355,10217,0.4429,0.0301,19943,21036,24723,10877,9442,18740,22098,,16077,23064,12,093
"Gilchrist County, Florida",17615,9249,8366,16104,1110,31,38,0,54,278,11,267,17615,16617,998,0.4217,0.0213,21379,22649,23260,11716,5244,14661,40192,-666666666,17131,11256,12,041
"Alachua County, Florida",263148,127298,135850,182692,52592,975,15736,154,2213,8786,953,7833,263148,237919,25229,0.5138,0.0100,27896,31630,33024,20657,16866,31583,30065,12365,27034,12455,12,001
"Charlotte County, Florida",176954,86278,90676,159598,9735,464,2209,115,1323,3510,425,3085,176954,164511,12443,0.4542,0.0128,30528,31438,32507,16936,24567,22710,29930,22002,17015,12471,12,015
"Martin County, Florida",157581,78002,79579,138394,9082,826,2133,130,4631,2385,828,1557,157581,136487,21094,0.5273,0.0148,40389,42928,45612,18067,14793,16352,53385,221422,18103,20642,12,085
"Sarasota County, Florida",412144,196433,215711,375993,18646,698,6931,106,3010,6760,684,6076,412144,375156,36988,0.4850,0.0064,39364,41092,42754,23786,17869,27230,29086,29067,32643,17448,12,115
"Citrus County, Florida",143087,69376,73711,132656,4183,449,2497,5,940,2357,320,2037,143087,135214,7873,0.4611,0.0159,25983,26335,26665,18999,22461,30484,28962,,23258,9551,12,017
"Santa Rosa County, Florida",170442,87175,83267,145869,10339,900,3221,442,2508,7163,431,6732,170442,161243,9199,0.4216,0.0129,30904,32697,33055,20907,21453,29717,26994,25519,21701,13496,12,113
"Broward County, Florida",1909151,929712,979439,1167526,543471,5207,68647,1259,61146,61895,11988,49907,1909151,1354542,554609,0.4861,0.0038,31464,37245,43957,25920,20899,25641,33491,25404,22667,22241,12,011
"Monroe County, Florida",76325,39822,36503,67672,5399,114,977,107,921,1135,148,987,76325,58119,18206,0.5060,0.0158,43477,45732,52001,25893,20432,25611,57900,,21243,28311,12,087
"Whitfield County, Georgia",103849,51525,52324,92143,4110,729,1511,4,4163,1189,291,898,103849,67985,35864,0.4651,0.0192,23271,24373,29480,13958,16104,4325,20274,,13410,12494,13,313
"Troup County, Georgia",69774,33387,36387,40993,24934,134,1471,0,686,1556,264,1292,69774,67211,2563,0.4681,0.0163,22348,26382,26834,16287,16319,14387,32928,-666666666,10743,8479,13,285
"Harris County, Georgia",33590,16832,16758,26584,5417,41,420,4,170,954,155,799,33590,32435,1155,0.4352,0.0320,34511,37614,37941,25660,23749,,20601,,51840,11894,13,145
"Worth County, Georgia",20656,10040,10616,14104,5833,77,70,5,97,470,226,244,20656,20225,431,0.4406,0.0375,23517,25942,26205,7723,18435,,45639,,,6937,13,321
"Evans County, Georgia",10727,5303,5424,6291,3262,1,91,0,1011,71,1,70,10727,9471,1256,0.4738,0.0314,20537,25916,26453,12223,12904,,25665,-666666666,12050,9224,13,109
"Webster County, Georgia",2613,1254,1359,1327,1045,5,0,0,217,19,0,19,2613,2363,250,0.4813,0.0542,21586,26176,26332,6105,19469,,-666666666,-666666666,3983,,13,307
"Glascock County, Georgia",3009,1438,1571,2661,275,15,0,2,0,56,16,40,3009,2960,49,0.4361,0.0513,21076,22080,22141,11643,15373,,-666666666,,-666666666,,13,125
"Chatham County, Georgia",287049,138403,148646,151228,114130,778,7391,370,4495,8657,1395,7262,287049,269042,18007,0.4804,0.0105,30664,38853,40002,22410,21181,21391,30987,18487,21410,18513,13,051
"Lanier County, Georgia",10366,5183,5183,7669,2507,28,32,0,46,84,0,84,10366,9792,574,0.4906,0.0387,18800,21275,21426,19538,11583,,,-666666666,12735,,13,173
"Madison County, Georgia",28900,14508,14392,24483,2534,82,347,0,890,564,28,536,28900,27405,1495,0.4277,0.0202,24292,25137,25544,8146,18166,32363,62929,-666666666,8446,15180,13,195
"Hart County, Georgia",25631,12558,13073,19823,4730,10,248,7,269,544,97,447,25631,24679,952,0.4590,0.0232,22361,24855,25398,8929,14808,,15655,,11306,6391,13,147
"McIntosh County, Georgia",14120,7036,7084,8832,4840,16,235,20,26,151,10,141,14120,13981,139,0.4562,0.0334,27030,31936,32082,18158,18917,,,,,13781,13,191
"Putnam County, Georgia",21503,10402,11101,14830,5633,8,175,0,586,271,0,271,21503,20122,1381,0.4768,0.0359,28819,34690,35577,13755,17288,,8465,-666666666,8395,4886,13,237
"Warren County, Georgia",5346,2475,2871,1996,3267,0,45,0,6,32,23,9,5346,5323,23,0.5242,0.0663,22916,29685,29685,,19113,-666666666,,-666666666,,11741,13,301
"Bryan County, Georgia",35885,17786,18099,27652,5296,162,525,25,889,1336,164,1172,35885,33431,2454,0.4416,0.0284,30892,33441,33744,23265,23457,39149,28833,,25354,10527,13,029
"Camden County, Georgia",52714,27019,25695,38452,9862,363,1118,64,993,1862,263,1599,52714,49248,3466,0.4366,0.0361,28509,31183,31605,22349,21504,19476,19736,,24820,18536,13,039
"Early County, Georgia",10348,4791,5557,4735,5315,9,57,0,151,81,0,81,10348,10119,229,0.4698,0.0200,17598,24744,24765,9105,11619,,,-666666666,,6857,13,099
"Coffee County, Georgia",42961,22088,20873,29193,12056,79,327,0,850,456,63,393,42961,38035,4926,0.5001,0.0253,19709,23585,25599,11420,11188,,11218,-666666666,17146,7917,13,069
"Gilmer County, Georgia",29922,15079,14843,27122,135,523,142,3,1403,594,54,540,29922,26493,3429,0.4486,0.0283,25812,27273,27845,12627,16886,8582,8744,,12908,10987,13,123
"Wilkes County, Georgia",9884,4770,5114,5284,4198,0,85,0,242,75,2,73,9884,9409,475,0.5070,0.0772,23198,30342,30918,12937,14343,-666666666,76095,-666666666,8138,4153,13,317
"Gordon County, Georgia",56790,28001,28789,50658,2255,468,637,14,1793,965,41,924,56790,47926,8864,0.4540,0.0227,22448,23469,24741,14040,12702,17521,15866,,11137,18993,13,129
"Cherokee County, Georgia",241910,119270,122640,209053,16478,864,4534,118,5278,5585,725,4860,241910,216933,24977,0.4110,0.0101,35199,36677,38213,18227,31246,15387,27733,,15708,19092,13,057
"Lee County, Georgia",29348,14674,14674,21735,5956,30,758,38,163,668,140,528,29348,28509,839,0.4005,0.0231,28612,31094,31088,30803,22446,,19781,,17783,15295,13,177
"Greene County, Georgia",16976,8299,8677,9924,6028,0,171,3,678,172,67,105,16976,15958,1018,0.5730,0.0278,35844,50967,51908,13286,14158,-666666666,24190,,13029,25451,13,133
"Cook County, Georgia",17184,8348,8836,11861,4723,45,109,0,225,221,15,206,17184,16196,988,0.4625,0.0270,19778,22497,23058,12964,13493,30120,25628,-666666666,11614,11436,13,075
"Fulton County, Georgia",1021902,495087,526815,458596,451053,3837,70225,321,15106,22764,2350,20414,1021902,947574,74328,0.5402,0.0050,43707,64515,69369,24340,23424,20980,48553,48534,23584,28551,13,121
"Lumpkin County, Georgia",31951,15551,16400,29981,605,203,96,35,449,582,8,574,31951,30421,1530,0.4582,0.0294,24790,25498,25998,11387,12065,36459,10909,,10657,11503,13,187
"Miller County, Georgia",5836,2832,3004,3989,1780,45,0,0,7,15,0,15,5836,5802,34,0.4555,0.0390,21746,25279,25329,15847,13910,12824,-666666666,-666666666,,,13,201
"Oconee County, Georgia",37017,18164,18853,32796,2005,15,1517,2,104,578,38,540,37017,35213,1804,0.4529,0.0222,41671,41793,42612,22427,36808,,51172,,33797,23334,13,219
"Henry County, Georgia",221307,105759,115548,109034,93814,149,7422,9,2891,7988,1343,6645,221307,206568,14739,0.3963,0.0080,28274,30721,31767,17850,27090,33827,27901,,16134,13416,13,151
"Long County, Georgia",18156,8872,9284,11752,4299,50,202,95,723,1035,88,947,18156,16113,2043,0.3810,0.0327,21695,22597,23700,10137,24054,10064,21490,33572,8386,10467,13,183
"Stephens County, Georgia",25676,11765,13911,21558,2876,40,84,2,489,627,31,596,25676,24833,843,0.4629,0.0317,21839,23615,23835,10070,14244,,14061,,10073,3930,13,257
"Upson County, Georgia",26216,12503,13713,18160,7369,88,105,198,0,296,85,211,26216,25616,600,0.4835,0.0272,21015,23032,23587,3048,15957,32276,14416,7299,-666666666,31392,13,293
"Peach County, Georgia",26966,12952,14014,13152,12047,32,271,31,1082,351,148,203,26966,24948,2018,0.4707,0.0264,22767,27843,28533,12653,18384,,16270,,9398,27543,13,225
"Pierce County, Georgia",19164,9639,9525,16402,1832,59,0,0,617,254,51,203,19164,18198,966,0.4560,0.0416,22236,24146,24316,12509,12055,1661,-666666666,-666666666,12660,350,13,229
"Screven County, Georgia",13990,6804,7186,7775,5868,31,100,0,95,121,9,112,13990,13714,276,0.4697,0.0258,21557,25263,25382,16293,16835,7045,38804,-666666666,16783,,13,251
"Banks County, Georgia",18510,9281,9229,17211,502,67,230,0,260,240,46,194,18510,17274,1236,0.4035,0.0205,20810,21380,21902,10995,21364,,8059,-666666666,7716,10510,13,011
"Clay County, Georgia",3001,1473,1528,902,2036,0,41,0,16,6,0,6,3001,3001,0,0.4930,0.0400,16199,28336,28336,-666666666,10737,-666666666,,-666666666,,,13,061
"DeKalb County, Georgia",743187,351871,391316,256546,401085,5661,45322,269,13542,20762,3161,17601,743187,679451,63736,0.4904,0.0049,34100,52339,58677,16963,24228,14350,31647,11615,14239,23400,13,089
"Jackson County, Georgia",65755,32445,33310,57489,4393,81,1049,8,1003,1732,280,1452,65755,60905,4850,0.4194,0.0182,27115,28405,29049,17010,21269,31583,20132,,10988,12603,13,157
"Lincoln County, Georgia",7799,3683,4116,5217,2462,4,15,2,46,53,0,53,7799,7670,129,0.4810,0.0374,26324,28935,29215,10395,21633,,,,8235,11085,13,181
"Appling County, Georgia",18454,9353,9101,14033,3363,72,139,0,543,304,39,265,18454,16651,1803,0.4446,0.0269,20421,22922,24221,9076,13847,2901,14397,-666666666,7965,6877,13,001
"Pulaski County, Georgia",11295,5075,6220,7133,3929,17,10,0,29,177,20,157,11295,10832,463,0.4597,0.0292,19389,24906,25182,20580,9816,,,-666666666,,11962,13,235
"Towns County, Georgia",11417,5334,6083,10887,135,64,77,0,58,196,9,187,11417,11277,140,0.4485,0.0323,23940,24342,24437,8596,9092,19783,33861,-666666666,4026,15196,13,281
"Turner County, Georgia",7962,3843,4119,4371,3423,17,66,0,72,13,0,13,7962,7831,131,0.4823,0.0390,18787,23559,23609,13129,12932,,14330,-666666666,17807,,13,287
"Power County, Idaho",7713,3781,3932,5991,4,402,0,2,1290,24,0,24,7713,5095,2618,0.3881,0.0452,22199,24811,27089,12751,,23652,-666666666,,9947,,16,077
"Oneida County, Idaho",4326,2083,2243,4206,4,9,0,0,4,103,24,79,4326,4134,192,0.3647,0.0406,21575,21789,22324,8635,,,-666666666,-666666666,,12790,16,071
"Lincoln County, Idaho",5321,2766,2555,4981,0,26,9,0,134,171,37,134,5321,3714,1607,0.3950,0.0262,20188,20590,23546,13550,-666666666,25092,,-666666666,15160,12512,16,063
"Franklin County, Idaho",13279,6787,6492,12778,32,86,8,10,218,147,7,140,13279,12388,891,0.3703,0.0215,22367,22769,23180,13312,,18306,,,7287,11839,16,041
"Jerome County, Idaho",23431,11801,11630,22059,29,113,129,83,605,413,19,394,23431,15132,8299,0.4154,0.0226,20820,20964,25122,13558,,53905,17796,12501,17000,11960,16,053
"Minidoka County, Idaho",20615,10377,10238,19491,27,188,82,22,482,323,68,255,20615,13389,7226,0.4496,0.0405,23578,24184,28971,15053,,10848,20926,,16137,7013,16,067
"Blaine County, Idaho",21994,11251,10743,20924,81,4,248,89,206,442,115,327,21994,17196,4798,0.4853,0.0331,32861,33614,39050,13537,16773,,28315,22071,8366,16183,16,013
"Boundary County, Idaho",11549,5735,5814,10863,33,119,90,26,72,346,0,346,11549,10982,567,0.4811,0.0477,25401,25669,26185,16009,,13221,4623,,14292,31471,16,021
"Gooding County, Idaho",15169,7911,7258,14032,15,117,54,45,453,453,182,271,15169,10756,4413,0.4027,0.0275,22542,23052,26026,14941,,20279,,45482,17641,11943,16,047
"Bear Lake County, Idaho",5962,2898,3064,5644,21,26,74,0,141,56,31,25,5962,5713,249,0.3919,0.0212,24654,25493,25672,9347,10071,,8581,-666666666,10673,7804,16,007
"Bonneville County, Idaho",112397,56237,56160,99868,608,498,1038,159,7362,2864,475,2389,112397,97915,14482,0.4539,0.0171,27272,28812,29787,14407,18257,20011,24239,2020,15415,9753,16,019
"Clearwater County, Idaho",8640,4790,3850,8033,33,186,27,21,137,203,6,197,8640,8284,356,0.4285,0.0234,22844,23456,23707,16213,17273,8083,14493,,19664,18420,16,035
"Lemhi County, Idaho",7798,3948,3850,7390,3,18,0,7,58,322,55,267,7798,7537,261,0.4017,0.0237,23042,23404,23520,14380,,,-666666666,,15269,17760,16,059
"Bonner County, Idaho",42711,21366,21345,40713,127,426,284,54,200,907,103,804,42711,41429,1282,0.4564,0.0221,27590,28102,28326,16976,19789,18574,12645,,15653,18857,16,017
"Custer County, Idaho",4141,2165,1976,3834,4,42,0,0,39,222,56,166,4141,3957,184,0.4582,0.0515,24545,25661,25624,19388,,12555,-666666666,-666666666,,6992,16,037
"Madison County, Idaho",38705,19529,19176,36249,106,48,447,53,746,1056,52,1004,38705,35803,2902,0.4899,0.0251,15626,16041,16550,8357,4764,,13019,,12135,6286,16,065
"Teton County, Idaho",11080,5887,5193,9818,17,41,10,0,942,252,87,165,11080,9185,1895,0.4239,0.0469,30554,32105,34170,14602,,41068,,-666666666,18111,15126,16,081
"Honolulu County, Hawaii",987638,497646,489992,207525,23472,1508,419852,93947,9112,232222,7679,224543,987638,891076,96562,0.4318,0.0035,35202,46740,49075,22980,35531,26815,37703,21884,31707,25916,15,003
"Vermilion County, Illinois",78407,38967,39440,64497,10975,211,743,24,707,1250,135,1115,78407,74530,3877,0.4467,0.0143,24272,26562,27325,13807,13736,8143,18541,,13888,10965,17,183
"Clark County, Illinois",15836,7824,8012,15357,49,14,100,0,86,230,66,164,15836,15589,247,0.4275,0.0245,29887,29958,30026,23990,8292,,64907,-666666666,40583,10847,17,023
"Effingham County, Illinois",34174,16971,17203,33240,179,24,210,15,198,308,3,305,34174,33490,684,0.4478,0.0242,30255,30637,30903,13510,16460,21696,18303,,17912,15250,17,049
"Hamilton County, Illinois",8221,4018,4203,8043,31,23,49,0,75,0,0,0,8221,8023,198,0.4150,0.0335,27795,27913,28347,,5484,,,-666666666,,-666666666,17,065
"Johnson County, Illinois",12602,7015,5587,11013,1486,13,44,0,14,32,0,32,12602,12199,403,0.4437,0.0447,22469,25570,26036,11412,241,18854,12623,-666666666,,7294,17,087
"Livingston County, Illinois",36324,18614,17710,33736,1454,3,278,0,227,626,19,607,36324,34697,1627,0.4291,0.0163,28236,29063,29746,12921,10608,,46626,-666666666,19824,19269,17,105
"Tazewell County, Illinois",133852,65987,67865,128237,1747,211,1400,27,420,1810,143,1667,133852,130833,3019,0.4247,0.0138,33077,33673,33862,20735,15976,10754,23948,18752,15323,21378,17,179
"Warren County, Illinois",17338,8353,8985,15267,453,40,453,0,753,372,0,372,17338,15707,1631,0.4346,0.0247,26082,27739,28625,13420,13047,,15741,-666666666,16781,8176,17,187
"Madison County, Illinois",265670,129718,135952,232485,22659,536,2622,57,1620,5691,379,5312,265670,257185,8485,0.4396,0.0075,30802,32733,33084,17574,17493,28327,23003,70507,16391,12409,17,119
"Mercer County, Illinois",15693,7798,7895,15215,92,16,65,0,106,199,1,198,15693,15329,364,0.3958,0.0245,28995,29389,29593,15885,22134,23050,20332,-666666666,17949,11254,17,131
"Alexander County, Illinois",6532,3104,3428,4078,2169,48,6,21,19,191,49,142,6532,6459,73,0.4596,0.0336,19065,22243,22275,8390,15266,1779,,,,1796,17,003
"Randolph County, Illinois",32546,18019,14527,28300,3311,47,128,0,251,509,77,432,32546,31550,996,0.4300,0.0220,25340,28096,28562,7857,4857,46885,25338,-666666666,6494,12602,17,157
"Macon County, Illinois",106512,51062,55450,83045,15291,293,1154,7,592,6130,77,6053,106512,104146,2366,0.4646,0.0111,28925,32308,32569,18908,16383,19792,35997,,22350,14154,17,115
"Wayne County, Illinois",16487,8141,8346,15938,290,38,43,0,10,168,3,165,16487,16406,81,0.4151,0.0192,26362,26812,26798,26583,6170,,18819,-666666666,,24992,17,191
"Franklin County, Illinois",39127,19285,19842,37938,323,116,223,25,116,386,4,382,39127,38470,657,0.4535,0.0183,23510,23838,23965,11016,7413,24521,12684,72624,13320,10507,17,055
"McDonough County, Illinois",30875,15009,15866,27867,1458,57,689,19,105,680,26,654,30875,30040,835,0.4652,0.0156,23299,24552,24847,10466,5346,29286,23344,,3369,13113,17,109
"Moultrie County, Illinois",14703,7172,7531,14410,78,40,32,0,25,118,0,118,14703,14506,197,0.3951,0.0229,28391,28722,28922,12354,4109,21393,18244,-666666666,19548,10957,17,139
"Pope County, Illinois",4249,2349,1900,3910,223,10,27,0,34,45,0,45,4249,4170,79,0.3977,0.0255,22343,23598,23779,4872,6856,,16430,-666666666,,,17,151
"Shelby County, Illinois",21832,10791,11041,21459,203,19,25,0,15,111,0,111,21832,21606,226,0.3856,0.0139,25320,25359,25452,16833,19731,,46936,-666666666,,19980,17,173
"Champaign County, Illinois",209448,104513,104935,151382,27942,312,22337,133,1902,5440,431,5009,209448,197209,12239,0.5097,0.0087,29683,33740,34751,18779,17657,24777,21727,24557,16406,16278,17,019
"Ford County, Illinois",13398,6616,6782,12787,147,59,64,5,232,104,15,89,13398,12971,427,0.4179,0.0180,28002,28174,28388,15781,10433,27461,61666,,16610,35993,17,053
"Kendall County, Illinois",124626,61761,62865,102615,8775,160,4169,0,5479,3428,1349,2079,124626,102010,22616,0.3577,0.0145,34423,36221,38476,21892,29428,160633,30556,-666666666,18725,17321,17,093
"Marion County, Illinois",38084,18726,19358,35266,1330,86,264,0,267,871,33,838,38084,37336,748,0.4296,0.0142,24727,25469,25685,11282,16763,22419,27813,-666666666,21309,7157,17,121
"Mason County, Illinois",13778,6838,6940,13386,130,14,27,0,39,182,31,151,13778,13631,147,0.4354,0.0212,27111,27477,27533,10658,18836,22157,23348,-666666666,,11876,17,125
"Starke County, Indiana",22941,11302,11639,22196,84,49,160,0,249,203,12,191,22941,22106,835,0.4155,0.0359,23282,23733,23995,12572,10110,15129,,-666666666,9226,8054,18,149
"Greene County, Indiana",32295,16033,16262,31579,125,13,112,20,32,414,38,376,32295,31849,446,0.3986,0.0116,24309,24518,24630,15045,16950,,17626,,20334,13374,18,055
"Wayne County, Indiana",66613,32288,34325,59997,3497,130,682,0,539,1768,31,1737,66613,64664,1949,0.4702,0.0213,25460,26155,26444,12052,17964,16868,45330,-666666666,19569,11492,18,177
"Dubois County, Indiana",42418,21048,21370,40206,189,113,295,0,1072,543,183,360,42418,39303,3115,0.4216,0.0286,28932,29864,30567,12380,21573,12794,7093,-666666666,11347,12413,18,037
"Hancock County, Indiana",73830,36255,37575,70053,1549,80,603,18,173,1354,116,1238,73830,72156,1674,0.3752,0.0120,32730,32874,33027,26524,32090,,45825,,19487,23004,18,059
"Ohio County, Indiana",5887,2918,2969,5725,68,5,24,0,32,33,0,33,5887,5823,64,0.3683,0.0298,29368,29448,29458,23050,35675,,18538,-666666666,18463,,18,115
"Parke County, Indiana",16996,8211,8785,16216,67,33,0,142,139,399,0,399,16996,16734,262,0.4321,0.0452,23052,22981,23142,14594,215,,-666666666,,24486,11504,18,121
"Benton County, Indiana",8667,4326,4341,8457,49,1,15,7,17,121,3,118,8667,8222,445,0.3892,0.0213,23322,23518,24113,12643,14188,,23007,,23829,12914,18,007
"Putnam County, Indiana",37559,19714,17845,35020,1020,56,706,9,157,591,34,557,37559,36843,716,0.3973,0.0213,24627,25525,25834,5817,5274,54009,21820,,6025,10649,18,133
"Washington County, Indiana",27827,13892,13935,27299,24,77,86,0,27,314,0,314,27827,27458,369,0.4237,0.0243,24048,24084,24149,18783,,,16157,-666666666,,26366,18,175
"Henry County, Indiana",48483,25391,23092,45945,1189,133,236,23,272,685,81,604,48483,47640,843,0.4234,0.0279,23851,24434,24625,9094,14867,7122,11699,,12982,12678,18,065
"Madison County, Indiana",129505,64707,64798,113768,10183,295,762,12,1093,3392,253,3139,129505,124431,5074,0.4313,0.0090,24625,25900,26329,13986,16152,23453,18183,,21283,10022,18,095
"Pike County, Indiana",12411,6256,6155,12025,125,0,91,0,53,117,6,111,12411,12310,101,0.3817,0.0166,26584,27092,27188,7525,4810,-666666666,,-666666666,,25132,18,125
"Steuben County, Indiana",34474,17542,16932,33484,93,35,140,14,92,616,5,611,34474,33268,1206,0.3964,0.0167,28429,28801,29402,10955,5474,23720,18383,,12220,16453,18,151
"Miami County, Indiana",35901,19084,16817,32567,1864,267,180,29,413,581,63,518,35901,34792,1109,0.4072,0.0216,22871,23698,23899,14449,10925,21484,21591,12966,16284,21103,18,103
"Wells County, Indiana",27947,13773,14174,26858,202,37,131,0,322,397,61,336,27947,27135,812,0.3979,0.0185,27106,27628,27920,11792,4506,48473,21609,-666666666,12263,15136,18,179
"Delaware County, Indiana",115616,55743,59873,102188,8440,98,1728,174,545,2443,299,2144,115616,112865,2751,0.4746,0.0171,24234,25200,25373,14260,17726,21776,22351,48540,9935,9234,18,035
"Jefferson County, Indiana",32237,15333,16904,30728,704,98,247,0,118,342,0,342,32237,31361,876,0.4321,0.0350,26060,26527,26797,16337,14546,14594,27984,-666666666,26869,9398,18,077
"Newton County, Indiana",14018,7004,7014,13576,37,14,0,0,283,108,78,30,14018,13150,868,0.3766,0.0249,25366,25586,26095,16039,8570,6614,-666666666,-666666666,14343,34762,18,111
"St. Joseph County, Indiana",269240,130832,138408,211730,34965,1255,6163,243,5788,9096,1084,8012,269240,246339,22901,0.4691,0.0072,27338,29947,31031,15185,16200,19517,38504,29084,14020,11359,18,141
"Switzerland County, Indiana",10628,5504,5124,10277,99,0,56,70,18,108,0,108,10628,10420,208,0.4274,0.0356,23347,23600,23596,14232,22129,-666666666,38357,,,10880,18,155
"Carroll County, Indiana",19994,10034,9960,19154,89,56,43,3,416,233,41,192,19994,19207,787,0.4056,0.0206,28430,28950,29163,17129,17120,37795,16165,,16746,10825,18,015
"Huntington County, Indiana",36378,17875,18503,34924,357,148,273,17,401,258,48,210,36378,35531,847,0.3827,0.0123,25386,25772,25843,15918,8099,12988,17215,,15784,29199,18,069
"White County, Indiana",24217,12143,12074,22199,106,71,61,0,1371,409,70,339,24217,22244,1973,0.3929,0.0182,27621,28692,28997,15504,29058,5232,53267,-666666666,15655,9297,18,181
"Jay County, Indiana",20993,10398,10595,20417,90,13,45,1,128,299,10,289,20993,20353,640,0.4218,0.0472,22470,22900,23074,12254,6441,,20371,,3622,7105,18,075
"Clark County, Indiana",115702,56359,59343,101426,7981,117,957,27,1337,3857,47,3810,115702,109555,6147,0.4191,0.0131,28525,29226,29708,19874,26634,24326,36195,,16136,16595,18,019
"Jefferson County, Iowa",18077,9112,8965,15066,321,2,1107,0,267,1314,12,1302,18077,17548,529,0.5016,0.0508,26064,29105,29699,10905,8632,,11384,-666666666,6163,11845,19,101
"Allamakee County, Iowa",13880,7045,6835,13432,174,25,70,10,17,152,29,123,13880,12996,884,0.4274,0.0238,27741,28071,29244,11562,11549,30896,38156,,,9949,19,005
"Dallas County, Iowa",84002,41367,42635,76545,1361,88,3597,67,528,1816,100,1716,84002,78882,5120,0.4323,0.0109,43583,44772,46215,22381,27547,32741,37476,,36691,19902,19,049
"Butler County, Iowa",14735,7381,7354,14375,84,28,83,9,7,149,0,149,14735,14541,194,0.4170,0.0245,29654,29076,29185,15397,8198,,160195,,,16598,19,023
"Fremont County, Iowa",6968,3470,3498,6651,33,48,0,0,151,85,7,78,6968,6784,184,0.4145,0.0160,29625,29999,30009,20889,11955,25529,-666666666,-666666666,19522,27498,19,071
"Taylor County, Iowa",6201,3168,3033,5918,15,14,44,0,154,56,4,52,6201,5709,492,0.4379,0.0368,27672,28382,29354,11450,24460,,16234,-666666666,11321,10427,19,173
"Worth County, Iowa",7489,3754,3735,7259,94,3,25,2,1,105,15,90,7489,7271,218,0.4119,0.0223,29482,30128,30511,14432,3602,,43656,,,5434,19,195
"Adams County, Iowa",3726,1854,1872,3662,16,3,10,0,28,7,0,7,3726,3679,47,0.4265,0.0258,27824,28149,28173,12870,,,,-666666666,5611,31886,19,003
"Chickasaw County, Iowa",12099,6058,6041,11858,62,34,52,0,26,67,0,67,12099,11804,295,0.4034,0.0287,29752,30007,30366,13785,18306,25150,21704,-666666666,11931,,19,037
"Dickinson County, Iowa",17056,8515,8541,16614,111,43,140,0,42,106,31,75,17056,16723,333,0.4363,0.0199,38031,38359,38452,30237,23724,37588,14756,-666666666,,39530,19,059
"Johnson County, Iowa",147001,72765,74236,120694,9945,290,9240,98,3277,3457,220,3237,147001,138817,8184,0.4929,0.0139,34310,37283,37947,19351,13585,24183,30924,20769,16616,17190,19,103
"Tama County, Iowa",17136,8497,8639,15114,143,1386,58,7,217,211,24,187,17136,15555,1581,0.3982,0.0142,27255,29107,30333,13182,13043,13826,14602,,14219,9435,19,171
"Franklin County, Iowa",10245,5117,5128,9439,142,10,0,0,563,91,0,91,10245,8974,1271,0.4216,0.0375,27480,28920,30351,11592,4997,18140,-666666666,-666666666,12545,6630,19,069
"Carroll County, Iowa",20344,9988,10356,20151,35,4,22,0,35,97,1,96,20344,20197,147,0.4338,0.0179,30658,30759,30899,11626,26700,,45082,-666666666,,8355,19,027
"Floyd County, Iowa",15858,7766,8092,14966,274,90,224,27,32,245,62,183,15858,15391,467,0.4469,0.0272,27897,28890,29278,14596,8947,2874,21440,,34056,3143,19,067
"Louisa County, Iowa",11223,5724,5499,10234,125,57,422,0,286,99,14,85,11223,9455,1768,0.4218,0.0237,27041,28032,30143,16051,18516,17200,15178,-666666666,19505,13442,19,115
"Lyon County, Iowa",11769,6013,5756,11403,7,79,28,33,100,119,16,103,11769,11465,304,0.3765,0.0229,29246,29695,29892,11115,,22942,29668,30521,14945,3302,19,119
"Shelby County, Iowa",11694,5735,5959,11338,96,17,37,0,63,143,12,131,11694,11362,332,0.4305,0.0255,31283,31665,31905,18270,24927,25918,66173,-666666666,8765,6789,19,165
"Henry County, Iowa",19926,10125,9801,18350,449,51,530,9,124,413,20,393,19926,18978,948,0.4158,0.0302,26760,27540,27986,15221,20800,56500,22012,,10690,6285,19,087
"Page County, Iowa",15363,7922,7441,14427,265,115,147,7,66,336,9,327,15363,14851,512,0.4244,0.0261,26767,27536,28032,12193,19327,9682,9582,,21573,12982,19,145
"Pottawattamie County, Iowa",93503,45923,47580,86905,1366,305,631,11,2122,2163,125,2038,93503,86381,7122,0.4259,0.0097,29729,30617,31365,17034,17535,19863,28449,,16356,16783,19,155
"Clayton County, Iowa",17672,8900,8772,17215,181,36,79,0,56,105,33,72,17672,17333,339,0.4078,0.0155,28486,28912,29144,13989,10527,14383,17559,-666666666,23282,5503,19,043
"Buena Vista County, Iowa",20260,10238,10022,15684,551,3,2155,97,1531,239,91,148,20260,15153,5107,0.4201,0.0247,26607,29193,33234,14574,20245,,20976,10544,14466,6953,19,021
"Guthrie County, Iowa",10674,5335,5339,10372,3,36,27,0,67,169,9,160,10674,10388,286,0.4076,0.0193,28953,29325,29603,17499,,11358,19904,-666666666,24888,13295,19,077
"Humboldt County, Iowa",9566,4651,4915,9315,25,41,40,0,52,93,0,93,9566,9159,407,0.4252,0.0284,29882,30294,31092,10497,1420,,41513,-666666666,13508,10845,19,091
"Washington County, Iowa",22143,11075,11068,21307,201,60,104,0,183,288,12,276,22143,20807,1336,0.3906,0.0185,29857,30373,31194,15191,21037,21335,31525,-666666666,10185,11490,19,183