NAME,B01003_001E,B01001_002E,B01001_026E,B02001_002E,B02001_003E,B02001_004E,B02001_005E,B02001_006E,B02001_007E,B02001_008E,B02001_009E,B02001_010E,B03003_002E,B03003_003E,B19083_001E,B19301_001E,B19301A_001E,B19301H_001E,B19301I_001E,B19301B_001E,B19301C_001E,B19301D_001E,B19301E_001E,B19301F_001E,B19301G_001E,state,county
"Los Angeles County, California",9974203,4913688,5060515,5329333,832253,54409,1394349,26074,1949940,387845,111506,276339,5173712,4800491,0.4992,27987,33336,49311,15782,24159,20588,31034,22639,14469,21111,06,037
"Madera County, California",152452,73450,79002,125830,5382,2287,3335,254,10254,5110,1859,3251,68443,84009,0.4441,17797,18609,27325,11763,11102,14621,24555,9945,13079,11716,06,039
"Marin County, California",256802,125838,130964,203975,6913,674,14565,593,19664,10418,1938,8480,216388,40414,0.5218,58004,66107,69865,21100,24406,22002,47886,28441,15020,20944,06,041
"Mariposa County, California",17946,9050,8896,15850,155,598,232,74,399,638,53,585,16217,1729,0.4507,28327,29357,30386,14817,14389,17373,32155,,14889,23328,06,043
"Mendocino County, California",87612,43979,43633,72141,705,4169,1570,186,5536,3305,465,2840,67280,20332,0.4712,23712,25773,28704,12324,10231,13334,19082,16368,12072,16812,06,045
"Merced County, California",261609,131899,129710,168794,9115,2024,19842,572,50949,10313,4246,6067,114339,147270,0.4607,18464,20595,29352,12878,17841,17105,17651,21609,13650,9575,06,047
"Modoc County, California",9335,4727,4608,8396,108,236,52,0,131,412,17,395,7990,1345,0.4465,21830,23013,25028,9209,3289,9051,23992,-666666666,10118,13350,06,049
"Mono County, California",14193,7520,6673,11993,63,380,116,132,1270,239,35,204,10350,3843,0.3534,29578,32224,36386,13675,9162,12866,49666,,9594,33835,06,051
"Monterey County, California",424927,218060,206867,319839,11826,4161,26497,2183,44818,15603,3839,11764,185026,239901,0.4579,25048,26599,44123,14173,21971,14758,28679,28467,15503,19101,06,053
"Napa County, California",139253,69301,69952,107543,2992,696,10362,356,12354,4950,1668,3282,93316,45937,0.4585,35092,38221,46277,18134,29775,24209,32344,40442,18123,19569,06,055
"Nevada County, California",98606,48812,49794,91335,358,978,1476,165,1632,2662,510,2152,89855,8751,0.4418,32117,32931,34015,18048,18497,26392,27635,22240,12112,23508,06,057
"Orange County, California",3086331,1525071,1561260,1942675,50766,11852,573661,9472,387005,110900,23780,87120,2035560,1050771,0.4637,34416,39559,49201,17542,32437,24172,32941,31804,15446,20373,06,059
"Placer County, California",361518,176490,185028,303509,4652,2372,23317,701,10753,16214,2473,13741,313718,47800,0.4361,35711,36950,38656,20825,36713,38967,40368,25886,18036,17209,06,061
"Plumas County, California",19286,9754,9532,17273,135,533,198,160,239,748,85,663,17692,1594,0.4660,29167,30463,31061,17237,16754,21837,20243,16136,15779,16130,06,063
"Riverside County, California",2266899,1127924,1138975,1480532,141350,22045,138538,7152,379932,97350,28518,68832,1211872,1055027,0.4437,23660,26594,34483,14812,22465,20100,26508,19792,14142,14947,06,065
"Sacramento County, California",1450277,709679,740598,865905,146236,12376,214861,14533,101936,94430,15998,78432,1130343,319934,0.4518,27071,31498,35099,17009,20293,21167,24490,19626,17707,14877,06,067
"San Benito County, California",56888,28428,28460,48133,574,413,1205,84,4209,2270,752,1518,24231,32657,0.4085,26317,27270,39033,18129,41012,17530,31584,9292,18355,16597,06,069
"San Bernardino County, California",2078586,1033761,1044825,1306230,180267,18520,136494,7172,339031,90872,25729,65143,1028413,1050173,0.4383,21384,23109,30604,15093,19626,17680,28743,19071,14964,13919,06,071
"San Diego County, California",3183143,1598266,1584877,2259494,160316,21329,357998,14343,215265,154398,28403,125995,2143391,1039752,0.4654,31043,33784,41850,17049,24522,25053,31978,22672,16019,18091,06,073
"San Francisco County, California",829072,421516,407556,410245,47611,3124,278274,3566,49540,36712,5755,30957,702548,126524,0.5156,49986,67414,74330,28168,25808,28752,36402,26197,23613,29268,06,075
"San Joaquin County, California",701050,348616,352434,405458,50377,6034,102469,3980,80481,52251,8267,43984,422527,278523,0.4476,22642,26126,33609,14516,19231,17495,20639,21752,15047,15178,06,077
"San Luis Obispo County, California",274184,139946,134238,231961,5791,2045,10205,85,15160,8937,1312,7625,215295,58889,0.4551,30392,32424,35301,17194,20469,22621,24426,22380,14541,19631,06,079
"San Mateo County, California",739837,363891,375946,417138,19503,2524,192649,10463,61897,35663,6830,28833,552202,187635,0.4829,47198,55537,67294,22547,31050,28956,44696,23797,20203,27029,06,081
"Santa Barbara County, California",431555,216370,215185,319490,8471,4372,21738,832,58911,17741,4633,13108,242812,188743,0.4851,30526,34355,44866,15962,25097,23745,29148,32182,15565,17129,06,083
"Santa Clara County, California",1841569,924848,916721,907336,48660,9658,610916,6739,174427,83833,18593,65240,1349023,492546,0.4627,42666,48890,61344,19905,29155,24009,44413,27513,18450,24155,06,085
"Santa Cruz County, California",267203,132817,134386,215832,2459,1610,11686,384,24084,11148,2464,8684,179797,87406,0.4686,33050,35941,43569,15492,34899,22391,32764,20388,14897,18181,06,087
"Shasta County, California",178520,87692,90828,155559,1759,4214,4462,326,4025,8175,903,7272,162612,15908,0.4464,23763,25057,25749,14636,12059,17888,19402,16837,14663,11835,06,089
"Sierra County, California",3019,1481,1538,2793,4,21,3,16,126,56,0,56,2736,283,0.4618,28030,28862,29508,12245,6700,56062,,,5049,37184,06,091
"Siskiyou County, California",44261,22021,22240,38114,574,1326,627,233,652,2735,154,2581,39338,4923,0.4535,22482,23738,24924,11976,20487,10821,15628,7664,16124,15395,06,093
"Solano County, California",421624,209901,211723,226669,59510,2340,63233,3654,36770,29448,5281,24167,316759,104865,0.4194,29132,33513,38594,17900,25328,24479,30227,25119,16773,17047,06,095
"Sonoma County, California",491790,241329,250461,387044,7490,6119,19811,1873,49266,20187,3354,16833,366116,125674,0.4510,33361,37002,40971,16960,21413,19783,30192,23258,16105,18253,06,097
"Stanislaus County, California",522794,258618,264176,396628,14456,4251,27581,3873,52446,23559,6207,17352,297781,225013,0.4493,21729,23067,29229,13716,21837,17678,24230,16198,13841,15416,06,099
"Sutter County, California",95067,47263,47804,65256,1925,1250,13904,303,7089,5340,899,4441,67136,27931,0.4552,23828,26782,32073,13307,24002,16260,19272,20047,14803,13490,06,101
"Tehama County, California",63284,31494,31790,54972,315,1548,805,70,3006,2568,584,1984,48745,14539,0.4269,21002,21922,23912,13198,12821,15681,24515,17010,12817,14114,06,103
"Trinity County, California",13515,6885,6630,11917,110,387,159,74,116,752,13,739,12555,960,0.4517,23145,24244,24469,18681,17761,12016,20368,5964,18695,15202,06,105
"Tulare County, California",451108,225881,225227,365823,7884,5739,14982,507,40340,15833,5233,10600,172086,279022,0.4588,17888,18613,29442,11726,15299,12741,24264,19719,12816,11131,06,107
"Tuolumne County, California",54347,28423,25924,47833,1018,906,770,108,1896,1816,206,1610,48299,6048,0.4378,26063,27802,28578,16339,9124,18296,22095,33869,9067,12595,06,109
"Ventura County, California",835790,414278,421512,649278,15035,5961,58479,1384,70998,34655,8476,26179,491270,344520,0.4429,33308,35079,46110,17680,32876,28240,41383,28028,18213,18702,06,111
"Yolo County, California",204162,99528,104634,134790,5314,2113,26954,1164,21710,12117,2931,9186,140913,63249,0.4815,28080,32389,37898,16590,22071,21881,22325,23985,16419,17957,06,113
"Yuba County, California",73059,37020,36039,51133,2378,1144,5149,257,7472,5526,1571,3955,53878,19181,0.4174,19586,21859,23806,12645,19306,19849,15036,17430,13459,11235,06,115
"Adams County, Colorado",461558,232139,229419,376581,14816,4758,17191,663,31596,15953,4340,11613,284324,177234,0.4047,24667,26174,32107,15374,19399,18588,21639,16062,15032,18505,08,001
"Alamosa County, Colorado",16111,7879,8232,13666,294,317,285,15,895,639,197,442,8772,7339,0.5202,19481,20498,26016,13053,7185,9632,19890,,12542,18167,08,003
"Arapahoe County, Colorado",596684,293092,303592,439517,60541,3908,31069,1179,33098,27372,6474,20898,485963,110721,0.4623,33574,37866,41375,16710,23648,21499,29011,23043,15669,15615,08,005
"Archuleta County, Colorado",12132,6116,6016,10629,65,270,99,8,835,226,91,135,9923,2209,0.4281,28506,30200,31810,16561,11977,23496,14786,,14558,16919,08,007
"Baca County, Colorado",3735,1814,1921,3575,58,38,6,3,17,38,6,32,3378,357,0.4474,22558,23175,23368,20518,10966,6937,,,3394,10892,08,009
"Bent County, Colorado",6000,4056,1944,4845,724,157,56,0,128,90,19,71,4137,1863,0.4481,15402,17658,20521,12218,714,985,46261,-666666666,15432,18019,08,011
"Boulder County, Colorado",305166,153300,151866,267572,2821,1599,12746,160,11193,9075,1147,7928,263684,41482,0.4758,38524,40726,43248,16809,22239,18324,33099,72325,14895,18409,08,013
"Broomfield County, Colorado",59027,29245,29782,51294,590,230,3541,0,1302,2070,209,1861,52158,6869,0.4232,38706,40257,42061,22907,26258,25463,36940,-666666666,24927,16997,08,014
"Chaffee County, Colorado",18121,9563,8558,16979,417,175,58,0,188,304,128,176,16319,1802,0.4192,27467,28523,30283,10710,2794,16209,17741,-666666666,16850,17194,08,015
"Cheyenne County, Colorado",2153,1065,1088,2084,7,6,29,0,6,21,5,16,1826,327,0.3911,23415,23623,25885,10208,20171,,25593,-666666666,,,08,017
"Clear Creek County, Colorado",9114,4704,4410,8601,130,65,83,0,124,111,9,102,8636,478,0.4655,42446,43253,44109,17201,17844,,,-666666666,18937,66601,08,019
"Conejos County, Colorado",8276,4110,4166,7417,8,141,8,0,317,385,54,331,3746,4530,0.4257,18247,18762,21135,15986,13150,19909,13475,-666666666,16078,9710,08,021
"Costilla County, Colorado",3578,1885,1693,3207,0,25,27,0,89,230,5,225,1258,2320,0.4943,20592,20457,28600,16224,-666666666,22868,42781,-666666666,16975,21022,08,023
"Crowley County, Colorado",5558,3521,2037,4621,438,151,31,13,166,138,13,125,3907,1651,0.4565,11726,13458,14440,11201,117,1453,17184,,11146,2384,08,025
"Custer County, Colorado",4274,2183,2091,4102,91,0,9,2,22,48,0,48,4140,134,0.4970,25842,26356,26897,7685,13876,-666666666,,,18036,11406,08,027
"Delta County, Colorado",30378,15295,15083,28820,328,203,184,0,473,370,101,269,25988,4390,0.4819,24590,25176,27158,12741,415,9902,16367,-666666666,19653,18803,08,029
"Denver County, Colorado",633777,316841,316936,473269,61868,7045,22301,613,46828,21853,4754,17099,436017,197760,0.5058,34423,39333,48797,15887,21021,20195,28676,28250,14716,18896,08,031
"Dolores County, Colorado",1736,913,823,1641,0,22,2,4,0,67,2,65,1617,119,0.4682,21543,21825,21128,30214,-666666666,,,,-666666666,18806,08,033
"Douglas County, Colorado",299794,148714,151080,272630,2985,779,11588,79,2892,8841,861,7980,275924,23870,0.3934,44105,45111,46618,25545,50431,31598,42520,23578,28699,19368,08,035
"Eagle County, Colorado",52233,28186,24047,46882,548,276,251,0,3361,915,177,738,36541,15692,0.4540,39355,41716,50011,16250,27220,27188,49736,-666666666,13484,21493,08,037
"Elbert County, Colorado",23545,11752,11793,22495,117,91,152,4,95,591,63,528,22155,1390,0.4055,36421,36769,37695,20753,68553,41871,35882,,18903,18477,08,039
"El Paso County, Colorado",645707,324108,321599,521280,38506,4119,17095,1928,26927,35852,4675,31177,544304,101403,0.4421,29314,31724,33521,17042,23084,19815,24307,22305,15734,15017,08,041
"Fremont County, Colorado",46879,27405,19474,40496,2788,766,563,61,1014,1191,310,881,40873,6006,0.4323,19161,20789,22614,7957,827,10905,7461,7925,25043,13155,08,043
"Garfield County, Colorado",56684,29065,27619,50191,499,447,392,0,3654,1501,316,1185,40720,15964,0.4089,27022,28436,32574,14441,7359,25528,17661,-666666666,10938,28312,08,045
"Gilpin County, Colorado",5557,2854,2703,5132,20,6,18,0,151,230,82,148,5110,447,0.4341,37375,37517,38315,17280,29160,,,-666666666,74930,7948,08,047
"Grand County, Colorado",14478,7822,6656,13269,91,25,210,42,743,98,22,76,13377,1101,0.4028,31713,33467,34015,11579,6046,29328,37191,11517,5878,11474,08,049
"Gunnison County, Colorado",15503,8401,7102,14852,77,92,144,0,37,301,4,297,14141,1362,0.4259,27070,27596,29155,10421,6171,40062,18352,-666666666,19546,7583,08,051
"Hinsdale County, Colorado",871,404,467,854,0,0,0,0,0,17,0,17,852,19,0.4382,36046,36434,37145,,-666666666,-666666666,-666666666,-666666666,-666666666,16565,08,053
"Huerfano County, Colorado",6550,3253,3297,5261,41,358,11,0,304,575,49,526,4258,2292,0.4970,23440,26722,30654,12251,24,10515,,-666666666,11163,10004,08,055
"Jackson County, Colorado",1389,750,639,1283,1,13,5,0,85,2,2,0,1132,257,0.3955,25818,27521,29692,9384,,7585,,-666666666,4424,,08,057
"Jefferson County, Colorado",546162,271437,274725,496471,5869,4884,13961,327,10115,14535,2164,12371,465014,81148,0.4305,36427,37580,40018,20916,27431,18654,32051,25750,23517,20070,08,059
"Kiowa County, Colorado",1407,658,749,1330,11,6,1,0,0,59,1,58,1322,85,0.4562,22173,22467,23531,6061,,,,-666666666,-666666666,17254,08,061
"Kit Carson County, Colorado",8122,4521,3601,7443,279,128,39,20,178,35,29,6,6574,1548,0.4219,21330,22634,24212,15294,38,5089,21664,19460,14756,,08,063
"Lake County, Colorado",7311,3953,3358,6476,38,17,80,7,567,126,1,125,5153,2158,0.3798,25998,26957,30632,15573,85432,,25948,5971,16335,6633,08,065
"La Plata County, Colorado",52547,26698,25849,46210,204,3032,361,71,1531,1138,216,922,46093,6454,0.4241,31016,32432,33536,21789,19728,19689,20429,61049,23576,17222,08,067
"Larimer County, Colorado",311435,154964,156471,282786,2948,1861,5810,372,8223,9435,1557,7878,277685,33750,0.4497,31082,32317,33487,17151,17123,22874,27447,17987,14977,16838,08,069
"Las Animas County, Colorado",14789,7596,7193,12504,192,304,89,27,992,681,280,401,8554,6235,0.4370,23365,24128,27802,17741,16529,20253,29052,39556,22201,12978,08,071
"Lincoln County, Colorado",5462,3261,2201,4594,665,104,4,0,20,75,0,75,4750,712,0.4701,17594,20628,23419,4084,348,1663,2325,-666666666,2780,11493,08,073
"Logan County, Colorado",22604,12369,10235,20866,287,194,350,9,267,631,477,154,19015,3589,0.4589,23533,24283,25807,15208,6315,15823,16144,,24181,12615,08,075
"Mesa County, Colorado",147509,73346,74163,135965,1060,1168,904,139,4280,3993,762,3231,127348,20161,0.4559,26518,27182,28456,16868,14875,22379,34245,9886,20471,13510,08,077
"Mineral County, Colorado",704,351,353,676,5,0,1,0,17,5,0,5,685,19,0.4092,34305,34575,34627,36311,,-666666666,,-666666666,,,08,079
"Moffat County, Colorado",13286,6965,6321,12331,25,305,115,118,257,135,68,67,11390,1896,0.4097,24623,25618,27400,10950,,9489,14416,15113,12332,11443,08,081
"Montezuma County, Colorado",25569,12628,12941,21246,75,3107,111,0,358,672,70,602,22549,3020,0.4273,23611,25453,26781,14533,813,13113,12516,-666666666,25251,17415,08,083
"Montrose County, Colorado",40885,20024,20861,37489,276,363,210,67,1492,988,203,785,32686,8199,0.4153,23408,24323,26626,12729,10712,13552,21599,21849,15243,8674,08,085
"Morgan County, Colorado",28342,14082,14260,25350,747,155,34,28,1198,830,287,543,18531,9811,0.4021,21297,22235,26156,14141,11922,13775,36744,,14681,11986,08,087
"Otero County, Colorado",18712,9261,9451,16999,86,344,178,144,691,270,50,220,11070,7642,0.4647,18868,19387,24159,11859,13799,13186,8967,,14224,6010,08,089
"Ouray County, Colorado",4532,2229,2303,4421,0,28,5,0,0,78,0,78,4262,270,0.4108,32562,32789,34003,11044,-666666666,,,-666666666,-666666666,25540,08,091
"Park County, Colorado",16174,8495,7679,15508,7,211,92,121,21,214,0,214,15305,869,0.3836,31838,31898,32363,22948,,35661,44418,,,14511,08,093
"Phillips County, Colorado",4385,2271,2114,4080,14,27,33,0,117,114,22,92,3288,1097,0.4606,22996,23662,27724,10682,,10344,11124,-666666666,16185,14006,08,095
"Pitkin County, Colorado",17303,9221,8082,16413,295,107,177,2,134,175,0,175,15648,1655,0.5384,54441,55499,59524,14229,35350,27074,46061,,35669,27585,08,097
"Prowers County, Colorado",12359,6186,6173,11667,51,133,61,0,258,189,40,149,7924,4435,0.4472,19039,19203,23245,12023,9461,18968,21533,-666666666,15326,15799,08,099
"Pueblo County, Colorado",160757,79168,81589,126386,3374,3950,1183,92,18743,7029,2698,4331,93234,67523,0.4437,22229,24158,27532,16017,13753,15011,25090,8696,15238,13991,08,101
"Rio Blanco County, Colorado",6739,3456,3283,6405,32,139,42,12,39,70,0,70,6033,706,0.4044,27776,27706,29252,15124,20422,31364,18829,,26336,20400,08,103
"Rio Grande County, Colorado",11840,5932,5908,9714,48,303,41,17,1416,301,75,226,6674,5166,0.4441,21104,22204,26367,14767,63879,15050,7332,18541,15090,15194,08,105
"Routt County, Colorado",23428,12314,11114,22103,119,97,291,0,508,310,89,221,21827,1601,0.4539,35019,36233,37236,11826,16223,19418,25245,-666666666,7252,15246,08,107
"Saguache County, Colorado",6211,3167,3044,5309,24,68,31,0,530,249,63,186,3775,2436,0.4858,20569,21838,26964,11590,15642,21541,4294,-666666666,11117,15867,08,109
"San Juan County, Colorado",653,370,283,608,0,6,10,0,26,3,0,3,511,142,0.3694,25926,25051,27135,20489,-666666666,,,-666666666,35965,,08,111
"San Miguel County, Colorado",7597,3999,3598,7334,17,22,91,0,39,94,7,87,6891,706,0.5133,40993,38581,40785,17097,9647,33009,273114,-666666666,9831,24924,08,113
"Sedgwick County, Colorado",2365,1131,1234,2159,10,11,24,0,54,107,10,97,1958,407,0.4201,22124,22745,24578,13605,23590,13745,36729,-666666666,18706,8753,08,115
"Summit County, Colorado",28482,15523,12959,25418,199,240,329,96,1775,425,238,187,24346,4136,0.4359,34842,37742,39394,15584,24538,14393,3587,8053,10909,7934,08,117
"Teller County, Colorado",23363,11818,11545,22000,211,109,233,0,321,489,27,462,21984,1379,0.4013,31732,31904,32854,14361,59325,27867,35365,-666666666,19011,19549,08,119
"Washington County, Colorado",4781,2498,2283,4607,49,13,6,0,41,65,19,46,4347,434,0.4338,24326,25071,26212,11102,943,8738,,-666666666,7339,2138,08,121
"Weld County, Colorado",265066,133051,132015,229905,2872,2390,3496,198,18943,7262,2108,5154,189408,75658,0.4225,25959,27285,30875,15247,15416,17566,26233,29651,15968,16759,08,123
"Yuma County, Colorado",10131,4892,5239,9093,104,9,14,0,591,320,82,238,7964,2167,0.4176,22902,23452,25643,13959,,5311,23764,-666666666,28860,3663,08,125
"Fairfield County, Connecticut",934215,454762,479453,694475,103232,1996,45560,241,66481,22230,6419,15811,767168,167047,0.5426,49688,57708,62163,22511,23966,22809,48716,44698,17253,20034,09,001
"Hartford County, Connecticut",897374,434604,462770,653648,119274,1900,41814,406,51865,28467,8057,20410,752104,145270,0.4725,35307,40275,43081,16397,21456,15894,36020,82885,15312,15265,09,003
"Litchfield County, Connecticut",187542,92200,95342,175327,2959,275,3343,0,2631,3007,420,2587,178245,9297,0.4391,37696,38715,39339,18761,22842,25401,30077,-666666666,16766,20839,09,005
"Middlesex County, Connecticut",165534,80927,84607,147394,8048,208,4527,44,1715,3598,366,3232,156808,8726,0.4333,40589,42243,42932,23829,27363,29834,33433,6939,22086,21261,09,007
"New Haven County, Connecticut",863148,416027,447121,649232,109755,1692,32080,214,48237,21938,5582,16356,725304,137844,0.4675,32794,36617,39204,16212,21366,33171,33604,21945,14335,16313,09,009
"New London County, Connecticut",274071,137029,137042,224950,15500,1546,11690,144,8074,12167,1801,10366,248687,25384,0.4297,34241,36928,37971,18135,22158,23958,29920,13657,17420,16824,09,011
"Tolland County, Connecticut",152251,76563,75688,136545,4511,70,5401,8,1696,4020,166,3854,145094,7157,0.4004,35022,36198,36707,19877,21282,14650,33026,,14962,21041,09,013
"Windham County, Connecticut",117918,58509,59409,107534,2592,349,1427,48,2598,3370,339,3031,105848,12070,0.4158,28044,29065,30193,13990,21821,15760,26075,,13529,13461,09,015
"Kent County, Delaware",167477,80690,86787,113563,40633,1056,3424,141,1968,6692,406,6286,156829,10648,0.4087,25259,27917,28519,15823,20890,15539,22584,22626,22212,10534,10,001
"New Castle County, Delaware",545846,264092,281754,360264,131536,1216,26119,318,13478,12915,1807,11108,496281,49565,0.4507,32616,37001,38729,17410,23204,20937,38285,19030,16685,12738,10,003
"Sussex County, Delaware",203737,99141,104596,165527,25859,862,2202,35,4923,4329,378,3951,185352,18385,0.4288,27748,30152,31374,14647,17519,21652,31614,20086,13373,12589,10,005
"District of Columbia, District of Columbia",633736,300030,333706,254955,314138,2072,22785,195,23999,15592,2015,13577,571099,62637,0.5295,46502,74468,78853,33231,25785,35316,52077,61480,22095,37345,11,001
"Alachua County, Florida",251759,121740,130019,175713,50882,717,13951,194,2511,7791,1445,6346,229688,22071,0.5168,25020,29170,30221,17658,13822,23471,24010,22064,11951,10797,12,001
"Baker County, Florida",27057,14116,12941,22713,3849,43,163,0,120,169,6,163,26459,598,0.4348,20346,22185,22392,9880,10968,13447,18931,-666666666,,3649,12,003
"Bay County, Florida",172988,85634,87354,142262,18052,1005,3482,123,918,7146,520,6626,163919,9069,0.4347,24937,26499,26660,20910,19721,16607,22602,16274,16536,10555,12,005
"Bradford County, Florida",27552,15369,12183,21368,5449,36,118,4,35,542,42,500,26523,1029,0.4533,18540,20596,21040,10318,11713,17022,15295,,3463,7988,12,007
"Brevard County, Florida",548891,268364,280527,456683,56026,1525,12200,494,7036,14927,1964,12963,500821,48070,0.4474,27360,29063,29836,19150,16623,25890,30226,66954,17391,16742,12,009
"Broward County, Florida",1815269,881064,934205,1146423,498880,4807,62158,982,53599,48420,11369,37051,1335189,480080,0.4782,28329,33700,38541,23511,17865,25231,28570,28192,19578,18659,12,011
"Calhoun County, Florida",14657,7990,6667,11947,1947,219,92,0,140,312,44,268,13848,809,0.4378,15463,17028,17560,5982,8687,15592,11797,-666666666,966,5339,12,013
"Charlotte County, Florida",163151,79302,83849,147782,9424,380,2031,5,885,2644,260,2384,152864,10287,0.4314,26374,27335,28171,14400,16550,15899,23290,,18210,14331,12,015
"Citrus County, Florida",139771,67497,72274,130161,4289,513,2206,0,821,1781,192,1589,132872,6899,0.4511,23495,23567,23956,16054,13952,28024,44760,-666666666,29772,10723,12,017
"Clay County, Florida",194868,95642,99226,160247,18671,599,6015,111,2280,6945,828,6117,178344,16524,0.4070,26489,27713,28169,21375,22893,20545,24275,23619,17880,13232,12,019
"Collier County, Florida",334474,164631,169843,291481,22566,822,4207,38,11122,4238,998,3240,246380,88094,0.5324,37236,40681,49706,14130,11974,19695,21475,,12280,19537,12,021
"Columbia County, Florida",67662,34883,32779,52253,12052,230,424,25,838,1840,138,1702,64139,3523,0.4467,19884,21971,22229,13625,12786,22859,34275,,7485,9330,12,023
"DeSoto County, Florida",34785,19627,15158,28654,4528,95,196,0,918,394,132,262,24260,10525,0.4222,15596,16842,20127,10351,8582,9494,24014,-666666666,13846,6941,12,027
"Dixie County, Florida",16137,8760,7377,14081,1627,40,53,0,10,326,46,280,15760,377,0.4071,16954,18193,18466,3471,8476,2928,9879,-666666666,,8493,12,029
"Duval County, Florida",880750,426934,453816,543264,259375,2408,37316,871,10115,27401,3343,24058,809210,71540,0.4730,26267,31181,32385,18926,17093,24260,31345,18882,18073,12181,12,031
"Escambia County, Florida",304099,151056,153043,210631,66834,1506,8795,541,2675,13117,1178,11939,288518,15581,0.4504,24014,27806,28324,18323,14978,24302,20599,15792,16138,13347,12,033
"Flagler County, Florida",98843,47366,51477,80341,11020,104,2339,76,2671,2292,567,1725,89671,9172,0.4363,24393,26470,26967,17455,16547,16716,19705,5593,12139,9368,12,035
"Franklin County, Florida",11636,6779,4857,9472,1797,50,73,10,119,115,6,109,11072,564,0.4904,20287,23137,23295,11842,7415,16870,13044,,2322,10132,12,037
"Gadsden County, Florida",46865,23449,23416,18531,25854,60,255,11,1564,590,59,531,42113,4752,0.4535,18101,23874,25987,10748,14550,7258,47529,,7591,8988,12,039
"Gilchrist County, Florida",16948,8882,8066,15576,1043,38,39,0,48,204,18,186,16093,855,0.4572,20536,21497,22188,9520,6207,6674,30492,-666666666,13685,22768,12,041
"Glades County, Florida",13190,7373,5817,10324,1732,568,65,0,419,82,14,68,10373,2817,0.4439,16799,17304,19072,9960,8929,40335,10432,-666666666,5563,18861,12,043
"Gulf County, Florida",15781,9244,6537,12215,2899,135,176,22,187,147,18,129,15052,729,0.4413,19411,21201,21872,5193,15015,6736,273,,10664,2500,12,045
"Hamilton County, Florida",14466,8698,5768,8790,4858,87,42,0,323,366,96,270,13148,1318,0.4664,15012,18954,19820,7672,8936,37433,9914,-666666666,4542,5493,12,047
"Hardee County, Florida",27549,15103,12446,22983,2019,100,274,1,1742,430,153,277,15714,11835,0.4835,15783,17546,23424,9763,3968,7288,6313,,10305,7274,12,049
"Hendry County, Florida",38360,20653,17707,27230,4713,711,323,39,4514,830,358,472,19193,19167,0.4594,16381,18651,25898,11534,9740,22097,12443,,11020,6152,12,051
"Hernando County, Florida",173792,83239,90553,156206,9211,548,1792,83,2686,3266,357,2909,154781,19011,0.4201,21245,22191,22751,15843,12877,15814,18465,17755,11817,9911,12,053
"Highlands County, Florida",98261,47726,50535,82654,9243,621,1438,91,2545,1669,276,1393,80583,17678,0.4375,20455,21740,23692,11955,13674,11568,23164,19574,8924,12972,12,055
"Hillsborough County, Florida",1279668,624290,655378,918084,213555,6635,45878,1023,55568,38925,8283,30642,950848,328820,0.4792,27532,30898,35450,17408,18017,15903,32870,15879,14068,15559,12,057
"Holmes County, Florida",19741,10555,9186,17654,1366,54,40,22,154,451,26,425,19228,513,0.4458,16946,17574,17838,3035,7674,9852,20733,6195,1001,26943,12,059
"Indian River County, Florida",140918,67809,73109,121670,12735,280,1655,10,2108,2460,285,2175,124580,16338,0.5251,31089,33776,35751,16745,12451,9255,30635,,10144,15447,12,061
"Jackson County, Florida",49105,27263,21842,33718,12924,166,316,0,692,1289,210,1079,46860,2245,0.4511,17611,20115,20598,7694,13130,13249,18623,-666666666,2346,5558,12,063
"Jefferson County, Florida",14335,7645,6690,8615,5242,31,0,0,316,131,24,107,13768,567,0.4480,20972,26308,27306,7856,13042,3110,-666666666,-666666666,3944,32679,12,065
"Lafayette County, Florida",8821,5248,3573,6888,1539,0,5,0,265,124,79,45,7677,1144,0.4979,18125,20928,22654,10293,5409,-666666666,,-666666666,9592,38799,12,067
"Lake County, Florida",305010,147503,157507,254313,29607,1132,5685,256,7170,6847,1362,5485,265246,39764,0.4326,24103,25508,26863,15976,16567,27787,26807,10296,14619,12096,12,069
"Lee County, Florida",647554,317586,329968,545605,55693,2084,10098,102,23688,10284,2377,7907,524742,122812,0.4727,27578,29956,33229,13433,14051,18304,26489,33858,12007,13435,12,071
"Leon County, Florida",280882,133487,147395,175713,87092,1000,8838,38,2354,5847,829,5018,264129,16753,0.4939,26486,31795,32839,17442,16489,19327,28413,,13924,19282,12,073
"Levy County, Florida",40057,19818,20239,35022,3685,169,157,1,157,866,97,769,36935,3122,0.4556,19655,20381,21033,13016,15550,24888,4192,,20527,9423,12,075
"Liberty County, Florida",8302,5153,3149,6415,1420,85,44,0,186,152,0,152,7811,491,0.4579,16928,19822,20537,5983,6559,6996,21627,-666666666,8754,5846,12,077
"Madison County, Florida",18901,9894,9007,10771,7330,9,26,72,329,364,3,361,17983,918,0.4520,15664,19291,19784,7098,11130,,12808,,6933,7492,12,079
"Manatee County, Florida",335840,162371,173469,282584,30097,919,5797,205,10811,5427,754,4673,284456,51384,0.4626,27948,30313,32787,13645,14908,30509,26453,19031,10644,13127,12,081
"Marion County, Florida",334771,160708,174063,273311,42256,1274,4705,104,5584,7537,1559,5978,296327,38444,0.4356,21752,23152,24049,14742,14251,16435,29941,28465,13238,15050,12,083
"Martin County, Florida",149658,73926,75732,130129,8503,677,1429,15,6390,2515,757,1758,130768,18890,0.5160,35183,38023,39824,14602,14722,10627,55677,,9345,18152,12,085
"Miami-Dade County, Florida",2600861,1262305,1338556,1963920,489045,4192,41005,701,66819,35179,11333,23846,904690,1696171,0.5199,23433,25505,43093,20757,15338,20071,30782,21259,19331,19972,12,086
"Monroe County, Florida",75208,39931,35277,67153,4826,280,746,5,1003,1195,107,1088,58902,16306,0.5037,34424,35900,40379,19800,18873,19177,47547,,22841,19432,12,087
"Nassau County, Florida",74918,36734,38184,67783,4929,273,699,19,271,944,125,819,72223,2695,0.4471,29321,30027,30455,17496,21415,17470,45136,,5705,17996,12,089
"Okaloosa County, Florida",188984,95355,93629,150361,17453,1251,5762,160,5274,8723,988,7735,174210,14774,0.4349,29082,31806,32259,19873,18819,23182,23793,9397,19581,13125,12,091
"Okeechobee County, Florida",39398,21173,18225,33452,3453,331,350,0,1348,464,47,417,29689,9709,0.4766,18087,19516,22151,10646,6556,11408,19204,-666666666,8300,33258,12,093
"Orange County, Florida",1200241,590597,609644,780991,249396,3079,60313,1493,67762,37207,9606,27601,862370,337871,0.4762,25052,28910,34276,16864,16625,21576,26137,19790,16597,14692,12,095
"Osceola County, Florida",289449,141991,147458,220205,32506,799,7690,211,17699,10339,2914,7425,150937,138512,0.4175,18996,19898,25493,14350,16369,10286,24861,7172,13459,14074,12,097
"Palm Beach County, Florida",1359074,657406,701668,1025542,241136,2506,33688,702,28167,27333,4531,22802,1087550,271524,0.5099,33072,38013,43699,18306,16252,18572,29860,24544,18790,16306,12,099
"Pasco County, Florida",472745,229640,243105,421022,22473,1415,10715,332,5076,11712,2681,9031,413029,59716,0.4419,24076,24647,25542,17498,20523,21762,23452,25200,15814,14753,12,101
"Pinellas County, Florida",925030,443516,481514,767248,95649,2423,28733,765,9061,21151,2721,18430,846732,78298,0.4791,29617,31842,33096,17956,16967,24502,27440,19516,16065,15857,12,103
"Polk County, Florida",617323,302511,314812,486381,92931,1749,10449,222,12327,13264,2026,11238,502251,115072,0.4328,21157,23012,25278,13504,13637,18963,26735,25272,11813,10343,12,105
"Putnam County, Florida",73191,36168,37023,56857,11855,246,473,88,2038,1634,147,1487,66343,6848,0.4686,18587,20473,21217,10096,11514,21121,19135,14873,9811,14881,12,107
"St. Johns County, Florida",203402,98729,104673,182338,10965,395,4285,187,896,4336,316,4020,191773,11629,0.4825,37147,38632,39453,23943,17185,32736,47098,18920,32949,17399,12,109
"St. Lucie County, Florida",283988,138722,145266,206581,54271,1081,4525,64,8991,8475,1696,6779,235385,48603,0.4615,23422,26057,28520,13882,16191,17093,26809,,13269,15437,12,111
"Santa Rosa County, Florida",158240,80593,77647,137237,8450,995,3113,799,1337,6309,687,5622,150586,7654,0.4229,27478,28836,29137,18118,22576,16977,24431,16832,13983,11851,12,113
"Sarasota County, Florida",386944,184785,202159,352049,17680,1093,5732,91,3739,6560,553,6007,354542,32402,0.4811,33300,34723,36160,18137,15521,19682,31660,24963,26376,12618,12,115
"Seminole County, Florida",432135,208732,223403,345365,49538,733,17336,320,6584,12259,2300,9959,353218,78917,0.4530,28870,31069,33821,18315,18006,15453,30786,36832,16851,15169,12,117
"Sumter County, Florida",103708,53222,50486,91654,9070,269,813,51,665,1186,267,919,97683,6025,0.4185,28875,31305,32315,11254,10351,19249,9584,13588,4425,12553,12,119
"Suwannee County, Florida",43404,22040,21364,35871,5780,134,123,0,691,805,56,749,39556,3848,0.4480,18966,20435,21417,9649,11329,20596,19881,-666666666,24050,3597,12,121
"Taylor County, Florida",22690,12926,9764,17130,4899,209,55,24,111,262,0,262,21818,872,0.4075,16748,19339,19944,4379,8704,13232,3884,-666666666,3039,10618,12,123
"Union County, Florida",15258,10064,5194,11282,3066,172,105,2,259,372,46,326,14479,779,0.3982,13467,16482,16951,5054,4624,14053,14379,,4286,395,12,125
"Volusia County, Florida",498981,243169,255812,411057,52132,1927,8396,219,15286,9964,2013,7951,440423,58558,0.4592,23844,25794,26869,15394,13480,12743,24290,47332,15073,12341,12,127
"Wakulla County, Florida",31015,17272,13743,25417,4652,124,141,0,167,514,16,498,29907,1108,0.3965,21738,23813,24121,13572,11933,11860,23043,-666666666,3973,15644,12,129
"Walton County, Florida",57821,29335,28486,50115,3162,716,650,104,1962,1112,79,1033,54508,3313,0.4796,25854,27954,28255,13714,7916,21776,23375,11478,11607,12797,12,131
"Washington County, Florida",24660,13358,11302,19708,3640,247,40,0,128,897,66,831,23852,808,0.4363,17950,20377,20667,10836,9083,18593,6708,-666666666,7316,2468,12,133
"Appling County, Georgia",18421,9176,9245,14117,3451,27,165,8,432,221,46,175,16691,1730,0.4479,19440,20887,22152,8614,14892,,19920,,12913,9459,13,001
"Atkinson County, Georgia",8297,4098,4199,5523,1406,28,0,0,1147,193,33,160,6281,2016,0.4834,16228,17926,19700,7695,18215,15657,-666666666,-666666666,7956,2438,13,003
"Bacon County, Georgia",11196,5631,5565,8825,1755,0,138,9,420,49,0,49,10342,854,0.4405,18109,19259,19699,15615,12376,-666666666,16545,,20626,1971,13,005
"Baker County, Georgia",3342,1608,1734,1777,1552,8,0,0,0,5,0,5,3324,18,0.4761,22136,30695,30896,,12353,,-666666666,-666666666,-666666666,,13,007
"Baldwin County, Georgia",45854,22840,23014,25186,18942,93,701,39,423,470,104,366,44895,959,0.5123,18582,21969,22131,10172,14739,17414,17232,,5162,7669,13,009
"Banks County, Georgia",18317,9400,8917,17130,525,17,224,0,181,240,30,210,17193,1124,0.4094,20433,20656,21072,14668,20128,,11202,-666666666,24668,11863,13,011
"Barrow County, Georgia",70873,35103,35770,57049,8387,236,2480,0,1200,1521,120,1401,64343,6530,0.3726,21185,22494,23429,12211,16535,12911,16915,-666666666,17476,8917,13,013
"Bartow County, Georgia",100771,49832,50939,84464,10785,581,743,8,2801,1389,102,1287,92922,7849,0.4173,21715,23109,23490,14499,14273,24172,28732,,11248,10971,13,015
"Ben Hill County, Georgia",17547,8558,8989,10509,6141,0,4,8,364,521,259,262,16481,1066,0.4829,15497,18763,19430,6148,10695,-666666666,,,13535,7659,13,017
"Berrien County, Georgia",19091,9372,9719,16153,2070,14,112,0,290,452,219,233,18162,929,0.4526,16660,17319,17472,7919,16151,32821,2723,-666666666,7470,4320,13,019
"Bibb County, Georgia",155237,73338,81899,67556,81443,125,2599,38,750,2726,187,2539,150477,4760,0.5150,21276,30241,31243,13128,14041,28112,28203,16676,10939,11251,13,021
"Bleckley County, Georgia",12912,6189,6723,8960,3667,3,74,0,19,189,99,90,12772,140,0.5324,19191,24644,24629,18840,6174,,33158,-666666666,1895,9306,13,023
"Brantley County, Georgia",18463,9221,9242,17412,748,0,110,40,13,140,0,140,18081,382,0.4061,16774,17082,17098,11739,13033,-666666666,5857,,8300,6314,13,025
"Brooks County, Georgia",15766,7722,8044,9320,5595,24,70,0,571,186,30,156,14922,844,0.4828,19473,25116,25396,9253,11535,7267,11333,-666666666,10011,9223,13,027
"Bryan County, Georgia",32185,15999,16186,25308,4841,107,658,0,267,1004,155,849,30354,1831,0.4065,27941,29450,29389,24563,25695,12801,18892,-666666666,15479,11593,13,029
"Bulloch County, Georgia",71940,35699,36241,47288,20322,233,1219,16,1527,1335,226,1109,69361,2579,0.4998,18546,21823,22037,16430,12064,12101,11316,,18911,8650,13,031
"Burke County, Georgia",23136,11171,11965,11075,11596,7,32,0,281,145,49,96,22477,659,0.4637,16663,23180,23172,14088,10750,,31613,-666666666,9724,1975,13,033
"Butts County, Georgia",23469,12514,10955,16414,6570,13,113,12,165,182,0,182,22788,681,0.4143,20165,22820,23046,16212,13498,48377,61163,,5839,8273,13,035
"Calhoun County, Georgia",6549,3916,2633,2220,3948,23,42,0,273,43,0,43,6209,340,0.6064,15410,17831,17686,11362,14420,34604,24352,-666666666,8433,6698,13,037
"Camden County, Georgia",51193,26288,24905,38403,9685,265,684,147,248,1761,143,1618,48268,2925,0.4048,23833,26277,26742,16994,16716,15106,31135,36882,17534,7951,13,039
"Candler County, Georgia",11056,5417,5639,7539,2713,52,201,0,503,48,0,48,9831,1225,0.5024,16943,18484,19581,7219,14291,33594,9848,-666666666,10201,6958,13,043
"Carroll County, Georgia",111872,54455,57417,85295,20334,354,984,0,2431,2474,250,2224,104792,7080,0.4543,21384,23932,24710,9536,14527,12476,16288,-666666666,9077,5260,13,045
"Catoosa County, Georgia",64955,31699,33256,60604,1735,296,879,2,236,1203,374,829,63293,1662,0.3924,22415,22870,22998,15350,18198,13865,14284,,16606,14722,13,047
"Charlton County, Georgia",13098,7428,5670,9385,3419,82,19,0,102,91,45,46,11653,1445,0.4529,17586,19055,20177,11681,14663,7517,2089,-666666666,3319,4192,13,049
"Chatham County, Georgia",275303,132864,142439,148598,109299,595,7018,235,3718,5840,929,4911,259313,15990,0.4710,25636,33077,34209,17369,16676,18579,22892,12620,13966,15959,13,051
"Chattahoochee County, Georgia",11846,7665,4181,8276,2255,87,347,42,338,501,58,443,10147,1699,0.3433,19538,20635,20474,19926,17252,17605,18623,30914,21414,10461,13,053
"Chattooga County, Georgia",25484,13240,12244,21891,2882,17,135,12,260,287,30,257,24348,1136,0.4422,15932,17070,17390,8151,9790,12953,8150,,6990,3412,13,055
"Cherokee County, Georgia",221951,109320,112631,191990,14112,865,3819,56,7165,3944,696,3248,200051,21900,0.4112,30299,31826,33134,14219,24408,24749,25038,33386,13135,14470,13,057
"Clarke County, Georgia",119681,56906,62775,78002,31615,131,5011,7,2130,2785,281,2504,106999,12682,0.5398,19333,22221,24239,9348,14467,24689,12281,,11599,12069,13,059
"Clay County, Georgia",3110,1534,1576,933,1995,0,0,0,0,182,175,7,2972,138,0.4742,12446,22501,22580,1084,8556,-666666666,-666666666,-666666666,-666666666,3544,13,061
"Clayton County, Georgia",264221,125870,138351,58024,175863,694,13344,27,10036,6233,721,5512,228990,35231,0.4229,18074,18225,22546,11170,18813,12635,16831,,10167,11818,13,063
"Clinch County, Georgia",6777,3286,3491,4566,1820,59,18,0,191,123,6,117,6509,268,0.5403,18256,20082,20318,1763,16162,24871,8911,-666666666,,8024,13,065
"Cobb County, Georgia",708920,343796,365124,440344,185448,1357,34205,362,31923,15281,3318,11963,620255,88665,0.4566,33418,39124,42090,15289,24282,27391,35032,25064,14388,16727,13,067
"Coffee County, Georgia",42947,21925,21022,27757,11801,100,275,0,2684,330,30,300,38414,4533,0.4737,16796,20670,21675,8813,9384,23864,13329,-666666666,10614,7055,13,069
"Colquitt County, Georgia",45987,22765,23222,32028,10722,46,32,11,2595,553,95,458,37832,8155,0.4772,16972,19253,21210,9603,12321,9889,60134,,9580,8130,13,071
"Columbia County, Georgia",132362,64485,67877,100339,21669,315,5562,47,1505,2925,457,2468,124854,7508,0.4189,30411,32427,33154,17066,24588,15650,31629,,14479,11674,13,073
"Cook County, Georgia",17061,8278,8783,11794,4692,24,44,0,289,218,0,218,16051,1010,0.4688,18858,21817,22155,15272,12339,19704,7752,-666666666,12240,9978,13,075
"Coweta County, Georgia",131419,64309,67110,101697,23312,128,2035,28,1279,2940,263,2677,122586,8833,0.4175,27462,29806,30718,16848,19114,26601,33749,,15411,13463,13,077
"Crawford County, Georgia",12536,6365,6171,9282,2845,30,63,0,23,293,62,231,12401,135,0.4181,21128,21765,21817,16808,19174,37960,61440,-666666666,,7624,13,079
"Crisp County, Georgia",23403,11105,12298,12620,10080,32,237,37,119,278,17,261,22643,760,0.5032,19455,28235,28869,14073,9211,,6581,,9845,8061,13,081
"Dade County, Georgia",16533,8124,8409,15843,156,152,77,44,53,208,32,176,16203,330,0.4207,21760,22228,22345,13093,13897,6309,26656,,,6626,13,083
"Dawson County, Georgia",22500,11172,11328,21315,99,124,152,0,462,348,12,336,21611,889,0.4677,28138,29003,29349,13482,11298,11783,11595,-666666666,15674,9509,13,085
"Decatur County, Georgia",27508,13399,14109,14574,11426,99,100,0,1129,180,37,143,26020,1488,0.5228,18387,24445,24911,12013,11236,39076,15431,-666666666,11378,16166,13,087
"DeKalb County, Georgia",707185,337535,369650,250716,380615,2112,38619,329,20287,14507,1877,12630,641536,65649,0.4903,28971,44349,49819,14377,20390,13867,27169,12212,11504,20110,13,089
"Dodge County, Georgia",21365,11187,10178,14397,6174,11,108,0,169,506,8,498,20624,741,0.4458,17771,21348,21722,9561,10409,,33122,-666666666,11663,4915,13,091
"Dooly County, Georgia",14443,7959,6484,6629,7471,11,30,0,221,81,44,37,13472,971,0.4639,14411,20141,20995,5516,9488,30445,5710,-666666666,13329,3586,13,093
"Dougherty County, Georgia",93890,43646,50244,27277,63429,113,693,14,1008,1356,135,1221,91593,2297,0.5197,18770,30780,30704,19956,13699,19170,41992,,7262,11227,13,095
"Douglas County, Georgia",135037,64837,70200,70973,55739,151,2251,0,3454,2469,181,2288,123297,11740,0.4079,23356,25728,26856,15080,21257,12426,28775,-666666666,12081,14043,13,097
"Early County, Georgia",10662,5012,5650,5108,5343,0,50,0,139,22,0,22,10461,201,0.4844,19302,26143,25726,25295,13142,-666666666,136,-666666666,12718,12086,13,099
"Echols County, Georgia",4018,1907,2111,3220,62,11,44,0,581,100,9,91,2877,1141,0.4583,17350,19396,21502,9231,18634,,3870,-666666666,9406,2388,13,101
"Effingham County, Georgia",53673,26536,27137,44293,7455,158,487,42,550,688,11,677,51925,1748,0.3834,25481,27051,27365,18199,17001,13893,31305,,18629,19705,13,103
"Elbert County, Georgia",19694,9336,10358,13186,5982,7,31,0,435,53,0,53,18674,1020,0.4641,19709,23158,23842,9777,12907,,,-666666666,11694,7496,13,105
"Emanuel County, Georgia",22731,11138,11593,13916,7685,75,58,0,659,338,31,307,21725,1006,0.4855,16960,20369,20700,6340,11263,7692,117069,-666666666,8769,6976,13,107
"Evans County, Georgia",10868,5195,5673,6400,3301,1,43,0,1070,53,20,33,9540,1328,0.4651,19177,24753,25376,7557,12235,,35260,-666666666,7483,1696,13,109
"Fannin County, Georgia",23632,11495,12137,22955,57,206,111,2,12,289,15,274,23179,453,0.4404,19520,19777,19840,18797,4698,13590,4617,,,12185,13,111
"Fayette County, Georgia",107930,52252,55678,77218,22167,278,4329,74,1306,2558,249,2309,100630,7300,0.4196,35987,38656,39999,21185,31241,26032,27421,13873,26674,17531,13,113
"Floyd County, Georgia",96146,46493,49653,74782,13985,682,1268,18,3911,1500,135,1365,86686,9460,0.4612,20863,23137,24149,9524,13029,8016,23062,,8844,15864,13,115
"Forsyth County, Georgia",189314,94179,95135,161289,5621,461,14143,0,4473,3327,417,2910,171130,18184,0.4168,35118,36181,37545,18113,27697,27181,38229,-666666666,10269,17410,13,117
"Franklin County, Georgia",22051,10815,11236,18993,2039,5,133,0,617,264,26,238,21134,917,0.4278,18242,19181,19317,10411,13003,,30628,-666666666,10146,4100,13,119
"Fulton County, Georgia",967100,470642,496458,440901,426478,2251,59052,372,17354,20692,2918,17774,892517,74583,0.5400,36827,54679,58854,18367,20043,16680,37329,31607,16876,19969,13,121
"Gilmer County, Georgia",28441,14419,14022,26335,284,35,115,0,1296,376,55,321,25505,2936,0.4577,21260,22184,22686,11525,5541,51637,15288,-666666666,9255,8789,13,123
"Glascock County, Georgia",3086,1521,1565,2743,238,0,0,0,8,97,11,86,3042,44,0.3916,19134,20014,20151,3364,16118,-666666666,-666666666,-666666666,,,13,125
"Glynn County, Georgia",80937,38182,42755,53668,20848,262,1096,85,2923,2055,557,1498,75732,5205,0.4881,26667,32943,33371,13319,13757,21373,42408,,11385,7422,13,127
"Gordon County, Georgia",55666,27514,28152,49401,2580,155,617,0,2190,723,312,411,47531,8135,0.4362,19595,20648,21906,9841,13268,10143,20122,-666666666,7552,8316,13,129
"Grady County, Georgia",25239,12491,12748,15970,7148,19,65,29,1501,507,0,507,22583,2656,0.4735,16286,20645,21651,4775,9534,23326,16648,,3928,5946,13,131
"Greene County, Georgia",16190,7938,8252,9420,5999,5,84,0,463,219,22,197,15195,995,0.5503,28179,40598,42010,10448,10724,5340,15943,-666666666,11337,12944,13,133
"Gwinnett County, Georgia",842091,413437,428654,442511,208408,3087,91934,402,73280,22469,3775,18694,670949,171142,0.4248,26060,31505,35745,13150,22396,18665,23032,31337,11483,13656,13,135
"Habersham County, Georgia",43342,20398,22944,38237,1651,89,1029,0,1743,593,58,535,37649,5693,0.4226,18816,19854,21290,9221,5930,29103,19804,-666666666,11189,6924,13,137
"Hall County, Georgia",185318,92553,92765,152338,13981,660,3178,42,11572,3547,793,2754,135562,49756,0.4461,23551,25634,30145,11023,15635,14372,21623,23595,10141,12478,13,139
"Hancock County, Georgia",9043,4923,4120,2219,6612,16,32,0,108,56,24,32,8845,198,0.4712,12661,19831,20515,1117,10553,,,-666666666,2048,5129,13,141
"Haralson County, Georgia",28563,13950,14613,26216,1487,34,228,0,245,353,41,312,28198,365,0.4388,20468,20913,21007,13997,18014,42982,10604,-666666666,18776,3107,13,143
"Harris County, Georgia",32539,16173,16366,25849,5419,112,214,0,299,646,69,577,31550,989,0.4300,32002,34189,34550,40681,20585,,27458,-666666666,82076,12189,13,145
"Hart County, Georgia",25406,12568,12838,19597,5041,12,98,5,465,188,29,159,24530,876,0.4686,20881,23256,23607,8751,13439,-666666666,13411,,11879,872,13,147
"Heard County, Georgia",11674,5808,5866,10179,1186,7,4,0,4,294,0,294,11414,260,0.4092,19360,19895,20117,9933,17534,,,-666666666,,8730,13,149
"Henry County, Georgia",209069,100271,108798,113118,80262,376,6424,58,3200,5631,320,5311,196281,12788,0.3976,25123,27283,27908,17589,23848,13656,20254,,14958,12224,13,151
"Houston County, Georgia",145622,70889,74733,90066,42491,269,3760,48,4641,4347,453,3894,136360,9262,0.4163,24613,28458,28561,18904,19254,19311,21086,17175,14890,11178,13,153
"Irwin County, Georgia",9482,4893,4589,6537,2767,0,6,0,35,137,21,116,9406,76,0.4848,18614,21035,21108,5913,13827,-666666666,,-666666666,9100,1877,13,155
"Jackson County, Georgia",60928,30207,30721,54052,4419,194,1011,71,374,807,155,652,56946,3982,0.4194,23076,24205,25016,12100,14332,13607,14819,18025,13635,12762,13,157
"Jasper County, Georgia",13647,6718,6929,10103,2881,268,54,0,47,294,0,294,13101,546,0.4510,21526,23735,23970,8940,16620,9356,11720,-666666666,12838,7959,13,159
"Jeff Davis County, Georgia",15028,7635,7393,11581,2370,32,57,0,948,40,0,40,13398,1630,0.4245,17898,19488,20034,8628,14689,,15965,-666666666,7182,,13,161
"Jefferson County, Georgia",16554,7974,8580,7182,9044,15,36,0,126,151,58,93,16018,536,0.4608,14795,21761,22398,5470,9521,5967,16547,-666666666,8189,5342,13,163
"Jenkins County, Georgia",8794,4231,4563,5418,3033,0,9,0,141,193,0,193,8283,511,0.4985,18351,20607,21544,7499,15039,-666666666,,-666666666,5574,,13,165
"Johnson County, Georgia",9850,5523,4327,6168,3377,1,192,0,33,79,12,67,9771,79,0.4594,17078,19382,19489,1759,13632,,12403,-666666666,-666666666,3178,13,167
"Jones County, Georgia",28783,13918,14865,21021,7333,0,199,0,96,134,0,134,28414,369,0.4378,25526,26874,26774,23433,22118,-666666666,32710,-666666666,,5325,13,169
"Lamar County, Georgia",18128,8660,9468,11936,5579,41,114,0,56,402,97,305,17752,376,0.4305,19137,23145,23233,19531,11178,20951,17152,-666666666,2959,13191,13,171
"Lanier County, Georgia",10356,5182,5174,7353,2539,0,68,0,224,172,18,154,9826,530,0.4482,16860,19949,20193,8114,9399,-666666666,23435,-666666666,,13783,13,173
"Laurens County, Georgia",48028,22890,25138,29475,17443,13,496,0,122,479,117,362,46856,1172,0.5039,19002,23124,23309,15695,12088,,24157,-666666666,12180,13216,13,175
"Lee County, Georgia",28805,14525,14280,21780,5767,19,676,0,183,380,39,341,28141,664,0.4193,26886,29415,29667,19969,19710,,17057,-666666666,19357,11175,13,177
"Liberty County, Georgia",64489,32332,32157,30597,26088,289,1301,321,2945,2948,323,2625,57313,7176,0.4224,20308,22270,22856,15723,19578,23755,27069,17236,14792,8931,13,179
"Lincoln County, Georgia",7800,3830,3970,5117,2497,9,35,0,0,142,0,142,7777,23,0.4532,21579,25266,25348,7135,15082,,4294,-666666666,-666666666,8577,13,181
"Long County, Georgia",15967,7861,8106,10199,4204,72,27,14,961,490,39,451,14044,1923,0.3670,18206,19472,20436,10732,17412,6992,,,10874,15384,13,183
"Lowndes County, Georgia",112515,55178,57337,65134,40703,109,1741,40,1798,2990,617,2373,106652,5863,0.4734,19353,24214,24838,10484,12849,37221,18302,15708,10475,7324,13,185
"Lumpkin County, Georgia",30719,15121,15598,29096,707,243,95,0,67,511,37,474,29315,1404,0.4362,20333,20955,21328,10309,5629,11597,16891,-666666666,27224,9108,13,187
"McDuffie County, Georgia",21563,10234,11329,12303,8948,0,12,0,145,155,12,143,21028,535,0.4652,18743,23516,23978,8677,12240,-666666666,134633,-666666666,2388,21690,13,189
"McIntosh County, Georgia",14172,6575,7597,8678,4812,93,59,0,233,297,17,280,13911,261,0.4570,23286,25195,25222,21680,20946,15701,,-666666666,22268,2773,13,191
"Macon County, Georgia",14232,7806,6426,4835,8865,55,221,0,177,79,7,72,14016,216,0.4655,13546,20372,20906,4113,9845,956,26712,-666666666,1894,9128,13,193
"Madison County, Georgia",28142,13880,14262,24113,2328,101,280,0,897,423,68,355,26920,1222,0.4088,20661,21807,21925,7245,15637,26066,23143,-666666666,7346,8270,13,195
"Marion County, Georgia",8751,4425,4326,5168,2727,0,95,146,437,178,26,152,8144,607,0.4550,19420,21667,21789,31988,13429,-666666666,9429,18881,35627,11969,13,197
"Meriwether County, Georgia",21434,10078,11356,12458,8354,4,119,0,162,337,27,310,21028,406,0.4537,18441,21481,21647,11026,14305,,15977,-666666666,7771,14820,13,199
"Miller County, Georgia",6017,2897,3120,4189,1820,2,0,0,6,0,0,0,5950,67,0.4872,20641,25320,25597,8316,9856,,-666666666,-666666666,,-666666666,13,201
"Mitchell County, Georgia",23175,12102,11073,11210,11082,26,47,3,499,308,0,308,22160,1015,0.4712,15547,19303,19690,10523,12238,,14104,,9739,7350,13,205
"Monroe County, Georgia",26788,13410,13378,19713,6451,44,196,0,85,299,101,198,26191,597,0.4318,23196,26537,26495,18011,14279,6775,21024,-666666666,10441,2724,13,207
"Montgomery County, Georgia",9000,4551,4449,6408,2379,29,25,0,66,93,0,93,8475,525,0.4552,17378,20167,20905,8683,10659,7531,7428,-666666666,10380,7808,13,209
"Morgan County, Georgia",17866,8605,9261,13178,4323,15,18,0,105,227,95,132,17351,515,0.4438,25012,28410,28562,17672,15373,26467,13622,-666666666,12264,18044,13,211
"Murray County, Georgia",39416,19359,20057,37641,454,21,126,0,590,584,62,522,34059,5357,0.4066,16481,16809,17605,10512,8708,4638,20028,-666666666,9469,8123,13,213
"Muscogee County, Georgia",198247,96886,101361,92002,88878,557,4570,164,4995,7081,1085,5996,184229,14018,0.4900,23209,29930,31053,15906,17423,21543,28685,14440,16123,10305,13,215
"Newton County, Georgia",101503,48278,53225,54998,42003,341,1186,3,619,2353,281,2072,96705,4798,0.4207,21811,24468,25333,11963,19184,10337,23220,,13542,9748,13,217
"Oconee County, Georgia",33769,16411,17358,30199,1901,11,1295,7,42,314,65,249,32228,1541,0.4354,34086,34888,35310,24204,15312,49273,48563,,50295,8604,13,219
"Oglethorpe County, Georgia",14695,7275,7420,11477,2238,90,136,0,210,544,89,455,14128,567,0.4011,21764,23850,24007,13591,17422,19123,15132,-666666666,9724,2359,13,221
"Paulding County, Georgia",145565,71169,74396,114626,25683,334,1261,19,1322,2320,354,1966,137758,7807,0.3937,24868,26121,26674,15591,20493,39712,25885,,14899,14338,13,223
"Peach County, Georgia",27337,13266,14071,12992,12638,0,271,9,1115,312,59,253,25411,1926,0.4532,20256,27225,28081,10495,14370,-666666666,14734,,9792,10185,13,225
"Pickens County, Georgia",29550,14731,14819,28185,397,87,171,14,361,335,0,335,28676,874,0.4431,26444,26394,26438,24326,16813,53353,8084,19736,18643,53091,13,227
"Pierce County, Georgia",18860,9212,9648,16209,1641,38,83,0,559,330,20,310,17913,947,0.4682,21601,23223,23375,10418,14294,7082,10958,-666666666,7925,5806,13,229
"Pike County, Georgia",17821,8741,9080,15570,1953,0,70,0,25,203,0,203,17584,237,0.4204,23670,25096,25159,20302,14448,-666666666,12866,-666666666,32492,5633,13,231
"Polk County, Georgia",41250,20048,21202,31781,5465,42,341,10,3216,395,121,274,36080,5170,0.4311,18773,20717,21387,10360,13723,5883,12767,,9471,14262,13,233
"Pulaski County, Georgia",11693,5005,6688,7581,3844,0,14,0,177,77,40,37,11135,558,0.4273,17379,20572,21498,6374,11415,-666666666,,-666666666,,21382,13,235
"Putnam County, Georgia",21226,10433,10793,14929,5744,2,8,0,385,158,0,158,19837,1389,0.4594,24807,29658,30860,15258,13024,,,-666666666,21205,4757,13,237
"Quitman County, Georgia",2407,1180,1227,1094,1274,4,15,0,0,20,10,10,2407,0,0.4071,15644,19978,19978,-666666666,11939,,,-666666666,-666666666,13250,13,239
"Rabun County, Georgia",16267,7968,8299,15112,250,50,147,0,355,353,83,270,14938,1329,0.5062,22848,23707,24009,16728,10089,16174,9071,-666666666,7846,16836,13,241
"Randolph County, Georgia",7411,3631,3780,2606,4567,0,138,0,6,94,16,78,7354,57,0.6519,24084,22757,22511,49075,24328,-666666666,24236,-666666666,,39364,13,243
"Richmond County, Georgia",201244,97458,103786,79422,109683,674,3322,452,1961,5730,598,5132,192355,8889,0.4790,20549,27081,27733,16115,16351,22733,25223,2050,15620,10525,13,245
"Rockdale County, Georgia",86256,40972,45284,38777,41858,120,1612,188,2249,1452,235,1217,77740,8516,0.4171,23409,26472,28812,11812,21581,52431,22618,1918,14163,9912,13,247
"Schley County, Georgia",5054,2535,2519,3496,1319,0,10,0,113,116,75,41,4729,325,0.4790,20650,25066,25929,8512,10934,-666666666,,-666666666,9150,11021,13,249
"Screven County, Georgia",14281,6971,7310,7927,6018,17,6,0,32,281,80,201,14067,214,0.4796,18650,24238,24286,11057,12083,38106,,-666666666,8291,2025,13,251
"Seminole County, Georgia",8804,4159,4645,5642,2969,0,38,0,63,92,30,62,8557,247,0.4595,18939,23301,23522,9468,11381,-666666666,17700,-666666666,-666666666,8775,13,253
"Spalding County, Georgia",63946,30925,33021,40434,20973,253,520,12,661,1093,175,918,61287,2659,0.4629,19656,23744,24278,12596,13060,13119,6615,,11668,7729,13,255
"Stephens County, Georgia",25741,12423,13318,21666,3128,64,96,0,487,300,5,295,25033,708,0.4449,19624,21326,21447,7633,11270,11306,6889,-666666666,7266,9723,13,257
"Stewart County, Georgia",5900,3583,2317,1767,3197,5,74,0,743,114,69,45,4922,978,0.4647,13354,21596,21603,11304,9956,,8309,-666666666,8803,13681,13,259
"Sumter County, Georgia",31804,15038,16766,13829,16445,58,429,0,581,462,134,328,30152,1652,0.4814,17838,26232,27029,12263,11393,23307,10267,-666666666,8334,14289,13,261
"Talbot County, Georgia",6594,3217,3377,2697,3824,4,15,0,6,48,0,48,6479,115,0.4858,18545,26580,27014,19286,13055,,,-666666666,,,13,263
"Taliaferro County, Georgia",1700,832,868,762,906,0,8,0,5,19,0,19,1658,42,0.4115,13742,13985,14509,8843,13169,-666666666,,-666666666,,,13,265
"Tattnall County, Georgia",25356,14720,10636,15785,7329,129,52,0,1463,598,341,257,22709,2647,0.4575,14777,18714,19166,8415,8331,1391,36581,-666666666,8680,5760,13,267
"Taylor County, Georgia",8505,4107,4398,5048,3355,0,4,0,86,12,4,8,8323,182,0.4671,17311,21411,21589,6899,11467,-666666666,,-666666666,4085,,13,269
"Telfair County, Georgia",16493,9620,6873,10002,6346,18,15,0,108,4,0,4,14264,2229,0.4484,12156,15459,18160,2490,7026,-666666666,32467,-666666666,5480,,13,271
"Terrell County, Georgia",9304,4501,4803,3528,5607,13,39,0,26,91,0,91,9100,204,0.4664,16592,26140,25025,41619,10813,,17610,-666666666,19485,,13,273
"Thomas County, Georgia",44733,21217,23516,26765,16545,14,360,0,586,463,12,451,43311,1422,0.4927,19636,24237,24660,9615,12645,,18753,-666666666,8416,18438,13,275
"Tift County, Georgia",40721,19697,21024,25729,11911,65,560,20,1856,580,58,522,36382,4339,0.5123,19560,23684,24973,10493,12727,,25663,,6385,13653,13,277
"Toombs County, Georgia",27272,12947,14325,18521,6984,9,227,0,869,662,212,450,24190,3082,0.4970,18663,22224,23297,10534,11347,,9284,-666666666,9750,10231,13,279
"Towns County, Georgia",10670,5130,5540,10235,103,63,21,0,45,203,92,111,10422,248,0.4524,20620,21338,21345,6792,4670,4978,,-666666666,2489,3332,13,281
"Treutlen County, Georgia",6781,3293,3488,4554,2141,0,0,0,5,81,0,81,6718,63,0.4742,20643,25497,25565,18452,11117,-666666666,-666666666,-666666666,,,13,283
"Troup County, Georgia",68375,33107,35268,41551,23233,44,1170,11,932,1434,102,1332,65971,2404,0.4781,21386,25707,26102,11838,14570,9477,25926,,16027,6913,13,285
"Turner County, Georgia",8491,4311,4180,4679,3623,14,85,0,55,35,2,33,8152,339,0.4926,17215,23192,23235,9323,10287,,2496,-666666666,338,3117,13,287
"Twiggs County, Georgia",8612,4229,4383,4807,3740,9,0,0,0,56,0,56,8608,4,0.5104,17629,20801,20808,,13710,11133,-666666666,-666666666,-666666666,8186,13,289
"Union County, Georgia",21553,10477,11076,20847,155,5,131,8,136,271,0,271,20971,582,0.4270,21345,21702,22011,6182,1960,,3535,,1659,22092,13,291
"Upson County, Georgia",26681,12705,13976,18774,7560,34,51,0,0,262,17,245,26046,635,0.4307,17728,20189,20620,7791,11995,1897,15855,-666666666,-666666666,9268,13,293
"Walker County, Georgia",68445,33691,34754,63238,3008,292,242,0,534,1131,176,955,67231,1214,0.4468,20466,21206,21259,11936,12449,13871,21231,-666666666,11777,6025,13,295
"Walton County, Georgia",85378,41564,43814,67918,13328,239,1001,36,1049,1807,376,1431,82277,3101,0.4144,22987,25100,25399,12518,15226,11317,21440,,9871,10569,13,297
"Ware County, Georgia",35915,17881,18034,23600,10717,133,385,9,725,346,9,337,34646,1269,0.4661,18341,21449,21662,9858,12792,8608,16834,,10398,790,13,299
"Warren County, Georgia",5626,2657,2969,2098,3388,0,68,4,0,68,0,68,5623,3,0.4760,17344,27051,27051,,11561,-666666666,18482,,-666666666,2293,13,301
"Washington County, Georgia",20861,10527,10334,9565,10967,0,61,0,57,211,1,210,20428,433,0.4738,17330,25065,25696,15392,10487,-666666666,11751,-666666666,55449,13701,13,303
"Wayne County, Georgia",30170,15545,14625,22414,6372,126,25,0,688,545,167,378,28334,1836,0.4457,18139,20615,20945,9140,11346,5091,19500,-666666666,8151,11317,13,305
"Webster County, Georgia",2744,1374,1370,1329,1415,0,0,0,0,0,0,0,2744,0,0.4276,17740,22242,22242,-666666666,13513,-666666666,-666666666,-666666666,-666666666,-666666666,13,307
"Wheeler County, Georgia",7932,5684,2248,4615,3294,4,18,0,0,1,0,1,7795,137,0.4340,8200,12265,12535,1177,2413,,,-666666666,-666666666,,13,309
"White County, Georgia",27594,13619,13975,26257,944,25,30,0,161,177,0,177,26861,733,0.4301,22016,22441,22742,8484,13949,11360,3710,-666666666,5780,21359,13,311
"Whitfield County, Georgia",103132,51158,51974,90077,4239,284,1220,0,4955,2357,713,1644,69488,33644,0.4628,20124,21079,24869,11972,14816,23419,24258,-666666666,12598,6451,13,313
"Wilcox County, Georgia",9061,5331,3730,5409,3350,19,78,0,111,94,11,83,8891,170,0.4484,12919,16702,16833,1156,7396,7637,14564,-666666666,1770,4938,13,315
"Wilkes County, Georgia",10123,4797,5326,5452,4320,0,75,1,199,76,2,74,9747,376,0.4525,17753,23495,23761,16999,10811,-666666666,11335,,18273,5268,13,317
"Wilkinson County, Georgia",9455,4585,4870,5648,3560,8,1,0,20,218,0,218,9220,235,0.4229,18048,20644,21207,7491,14974,,,-666666666,19310,1293,13,319
"Worth County, Georgia",21365,10293,11072,14861,6143,30,72,0,37,222,11,211,20942,423,0.4351,19048,21620,21866,11761,13213,51713,10392,-666666666,,7638,13,321
"Hawaii County, Hawaii",189382,94864,94518,62903,1372,563,41858,23973,4377,54336,1559,52777,166613,22769,0.4647,24395,32773,33887,13647,17437,22653,27072,17821,15762,16421,15,001
"Honolulu County, Hawaii",975690,492281,483409,209847,24169,1747,421212,91544,9197,217974,8266,209708,888796,86894,0.4198,30735,41706,43342,20358,30884,34304,32786,19108,30288,21065,15,003
"Kalawao County, Hawaii",73,33,40,32,0,0,18,16,2,5,0,5,69,4,0.4378,43771,52275,52275,35950,-666666666,-666666666,42006,29538,,,15,005
"Kauai County, Hawaii",68745,34548,34197,23103,433,156,24250,6638,422,13743,319,13424,61732,7013,0.4259,27079,35027,36738,16902,27214,34199,25438,23340,24738,18407,15,007
"Maui County, Hawaii",158814,79680,79134,54749,939,259,42569,16564,1359,42375,957,41418,142009,16805,0.4423,29499,41225,42604,18477,22755,31857,28510,18910,33019,19504,15,009
"Ada County, Idaho",409239,204850,204389,374848,4336,2313,11069,832,5115,10726,1084,9642,378827,30412,0.4458,28318,29168,30004,15545,22731,16582,27017,12351,13297,13160,16,001
"Adams County, Idaho",3908,2052,1856,3728,0,56,6,0,16,102,0,102,3791,117,0.4430,21275,21658,21431,21411,-666666666,10473,,-666666666,36356,12101,16,003
"Bannock County, Idaho",83394,41560,41834,75381,621,2782,1054,187,963,2406,185,2221,77234,6160,0.4394,21891,22680,23153,13644,17265,14305,20310,14071,14703,11321,16,005
"Bear Lake County, Idaho",5941,2980,2961,5740,9,8,63,5,80,36,6,30,5704,237,0.3987,21867,21885,21804,20508,,15550,17811,,12819,52839,16,007
"Benewah County, Idaho",9149,4618,4531,7896,49,839,47,5,9,304,6,298,8867,282,0.4062,21131,22484,22599,11690,14031,12746,30491,,29333,8690,16,009
"Bingham County, Idaho",45558,22831,22727,39784,133,2474,339,22,1726,1080,170,910,37545,8013,0.4028,19647,20567,22168,11381,5749,13770,27975,,13136,8472,16,011
"Blaine County, Idaho",21269,10798,10471,19151,18,63,185,224,1441,187,18,169,16953,4316,0.4550,34517,35649,39310,17547,15111,32110,32242,17048,16696,81737,16,013
"Boise County, Idaho",6880,3620,3260,6569,28,146,28,19,8,82,8,74,6633,247,0.4572,25562,25607,25665,31304,56532,18278,81696,,,11670,16,015
"Bonner County, Idaho",40899,20450,20449,39195,49,338,220,53,163,881,47,834,39870,1029,0.4657,24333,24728,24645,24737,17184,14061,4807,9126,15352,18564,16,017
"Bonneville County, Idaho",106703,52951,53752,96550,579,481,737,69,5281,3006,724,2282,93805,12898,0.4291,23160,24224,24973,12099,24794,12850,34048,8174,9993,11111,16,019
"Boundary County, Idaho",10903,5578,5325,10292,15,218,12,0,60,306,0,306,10471,432,0.4456,20049,19978,20028,20844,,26903,,-666666666,38797,14569,16,021
"Butte County, Idaho",2734,1430,1304,2578,43,8,9,0,6,90,9,81,2629,105,0.4622,21444,22241,22759,12242,3544,,,-666666666,,8630,16,023
"Camas County, Idaho",1156,641,515,994,0,9,0,0,124,29,0,29,955,201,0.4507,22073,24389,25617,6734,-666666666,,-666666666,-666666666,6175,10397,16,025
"Canyon County, Idaho",195353,96721,98632,178003,868,1829,1476,206,7123,5848,1235,4613,147880,47473,0.4069,17954,18555,20755,10425,15989,11847,21191,15897,11133,9432,16,027
"Caribou County, Idaho",6857,3458,3399,6729,4,2,10,0,69,43,1,42,6495,362,0.4045,24279,24487,25020,12334,,,,-666666666,13706,14133,16,029
"Cassia County, Idaho",23275,11805,11470,21275,61,124,140,7,1235,433,126,307,17271,6004,0.4107,17942,18546,20650,10770,13282,25779,25444,,9553,8206,16,031
"Clark County, Idaho",823,405,418,775,0,0,0,0,38,10,6,4,469,354,0.3346,15734,16103,21633,7687,-666666666,-666666666,-666666666,-666666666,7918,,16,033
"Clearwater County, Idaho",8600,4738,3862,8128,22,160,65,9,31,185,0,185,8303,297,0.3978,20154,20629,20976,10004,23345,10046,17065,9389,10010,10950,16,035
"Custer County, Idaho",4284,2227,2057,4187,0,0,2,24,13,58,0,58,4176,108,0.4224,22537,22518,22396,26729,-666666666,-666666666,,,,19434,16,037
"Elmore County, Idaho",26349,13579,12770,22271,587,411,809,62,1241,968,149,819,22163,4186,0.4057,21016,22322,23315,12532,25901,12164,21927,9048,9772,6190,16,039
"Franklin County, Idaho",12853,6547,6306,12525,17,33,5,11,42,220,53,167,11986,867,0.3622,17694,17942,18382,11293,,945,,,26343,3418,16,041
"Fremont County, Idaho",13024,6751,6273,12293,42,89,12,0,324,264,101,163,11402,1622,0.3716,19348,19986,21091,9092,7031,11215,,-666666666,8138,8653,16,043
"Gem County, Idaho",16732,8356,8376,15766,4,105,332,43,266,216,31,185,15383,1349,0.4279,20623,21212,21739,12816,,26167,6926,24898,13436,4395,16,045
"Gooding County, Idaho",15241,7869,7372,12971,3,211,90,0,1677,289,68,221,10902,4339,0.4370,18965,20217,22119,11673,,14092,9083,-666666666,11346,13611,16,047
"Idaho County, Idaho",16315,8675,7640,15241,17,524,40,4,111,378,29,349,15844,471,0.3791,19527,20170,20299,11054,9712,9787,11163,,13892,10306,16,049
"Jefferson County, Idaho",26620,13407,13213,25066,50,92,48,59,700,605,186,419,23884,2736,0.3759,19515,19900,20633,10793,13998,22541,36779,,13664,8828,16,051
"Jerome County, Idaho",22580,11403,11177,20001,27,318,182,0,1662,390,23,367,15211,7369,0.3856,17474,18273,20698,11424,2870,15309,14648,-666666666,11436,6357,16,053
"Kootenai County, Idaho",142783,70471,72312,135067,480,2034,1616,150,454,2982,224,2758,136964,5819,0.4320,25190,25775,26185,13850,12363,16640,15462,10496,13796,14340,16,055
"Latah County, Idaho",37989,19512,18477,35341,210,197,795,16,236,1194,30,1164,36521,1468,0.4669,22575,22648,22866,13583,6986,20925,15373,13869,6309,31538,16,057
"Lemhi County, Idaho",7828,3926,3902,7522,6,47,20,0,33,200,18,182,7618,210,0.4664,24178,24452,24545,21480,,32321,13290,-666666666,24067,12542,16,059
"Lewis County, Idaho",3822,1904,1918,3489,3,157,19,11,9,134,3,131,3677,145,0.4288,21542,22145,22604,10267,,13391,24632,,,15901,16,061
"Lincoln County, Idaho",5246,2699,2547,4591,15,60,3,0,476,101,22,79,3713,1533,0.3650,16328,17264,18761,11203,,4488,,-666666666,9706,14678,16,063
"Madison County, Idaho",37754,18712,19042,35944,241,26,363,86,434,660,72,588,35335,2419,0.5116,15406,15785,16158,8585,10079,,10413,13187,7262,5013,16,065
"Autauga County, Alabama",55136,26774,28362,43011,10257,230,500,16,384,738,55,683,53745,1391,0.4100,24644,27261,27448,19842,15009,11613,26479,,15216,13458,01,001
"Baldwin County, Alabama",191205,93229,97976,165673,17907,999,1256,0,1843,3527,542,2985,182575,8630,0.4517,26851,28672,29290,14050,13845,25448,23337,-666666666,15645,14841,01,003
"Barbour County, Alabama",27119,14562,12557,12806,12565,48,204,0,954,542,46,496,25836,1283,0.4608,17350,22708,22956,10226,12159,83606,14338,-666666666,10240,18854,01,005
"Bibb County, Alabama",22653,12220,10433,17379,4797,160,19,0,6,292,0,292,22198,455,0.4365,18110,20472,20391,23028,10516,8189,,-666666666,,9066,01,007
"Blount County, Alabama",57645,28574,29071,54927,885,287,57,0,583,906,21,885,52765,4880,0.4134,20501,20817,21768,10239,9270,23320,9612,-666666666,19718,12665,01,009
"Bullock County, Alabama",10693,5799,4894,2803,7640,70,6,48,0,126,0,126,10262,431,0.4460,17706,29253,31382,17535,13490,15041,,,-666666666,21146,01,011
"Butler County, Alabama",20523,9590,10933,11204,8975,25,118,0,49,152,32,120,20290,233,0.4591,18115,22406,22669,9761,12341,4356,61293,-666666666,,12464,01,013
"Calhoun County, Alabama",117186,56478,60708,88125,24396,272,939,17,1294,2143,138,2005,113169,4017,0.4545,21306,23616,23872,12242,14721,21748,15931,,10259,10312,01,015
"Chambers County, Alabama",34091,16271,17820,19771,13722,61,214,8,31,284,17,267,33933,158,0.5023,21240,25685,25806,10521,13347,362346,24141,,27074,17161,01,017
"Cherokee County, Alabama",26042,12960,13082,24207,1283,97,90,3,36,326,5,321,25667,375,0.4658,22234,22720,22815,15656,14152,59502,8079,,42517,8614,01,019
"Chilton County, Alabama",43781,21573,22208,37018,4484,178,104,0,1693,304,16,288,40415,3366,0.4517,21718,23166,23557,14352,13834,27634,13844,-666666666,12640,11477,01,021
"Choctaw County, Alabama",13546,6469,7077,7558,5896,0,8,0,0,84,0,84,13490,56,0.4866,21268,26610,26581,11730,14506,-666666666,,-666666666,-666666666,16260,01,023
"Clarke County, Alabama",25331,11958,13373,13613,11401,0,51,93,35,138,10,128,25221,110,0.5249,20022,25791,25876,10197,13053,-666666666,62594,,,10184,01,025
"Clay County, Alabama",13617,6681,6936,11150,1986,103,0,0,175,203,21,182,13193,424,0.4373,18957,20106,20368,9354,15739,3744,-666666666,-666666666,7746,4749,01,027
"Cleburne County, Alabama",14990,7374,7616,14095,430,53,69,0,85,258,22,236,14659,331,0.4432,19736,20124,20338,5673,15977,11932,40064,-666666666,9665,4297,01,029
"Coffee County, Alabama",50726,25135,25591,39064,8671,445,696,0,291,1559,58,1501,47490,3236,0.4474,24204,26295,26951,16533,17433,21743,18596,-666666666,12341,14886,01,031
"Colbert County, Alabama",54491,26358,28133,43356,8712,360,190,38,744,1091,251,840,53215,1276,0.4361,21763,23028,23076,11296,17097,27969,35242,21608,8720,13238,01,033
"Conecuh County, Alabama",12985,6178,6807,6778,5821,71,10,0,0,305,0,305,12779,206,0.4952,15441,20207,20426,7575,10338,7273,,-666666666,-666666666,5541,01,035
"Coosa County, Alabama",11247,5754,5493,7549,3524,7,0,0,0,167,0,167,11009,238,0.4341,17749,20560,20768,14186,12333,,-666666666,-666666666,-666666666,4936,01,037
"Covington County, Alabama",37881,18323,19558,32025,4868,196,134,20,147,491,86,405,37317,564,0.4637,20941,22591,22637,16761,11778,14482,17183,,14077,10464,01,039
"Crenshaw County, Alabama",13938,6808,7130,10007,3269,107,228,0,145,182,0,182,13709,229,0.4589,20366,22386,22607,9131,15260,15827,21368,-666666666,8806,11630,01,041
"Cullman County, Alabama",80668,40068,40600,77079,1096,354,401,23,720,995,110,885,77187,3481,0.4582,21105,21580,22105,7170,12067,14834,14062,,9922,7817,01,043
"Dale County, Alabama",50013,24730,25283,37509,9712,192,599,5,486,1510,126,1384,47084,2929,0.4340,22368,24927,25395,16943,15154,20052,19488,,13246,9663,01,045
"Dallas County, Alabama",42743,19775,22968,12318,29758,42,55,20,66,484,7,477,42583,160,0.5281,17614,30885,30946,14104,12355,,13556,,12979,6169,01,047
"DeKalb County, Alabama",71074,35262,35812,62960,1279,893,206,3,3979,1754,216,1538,61152,9922,0.4431,18416,19267,20026,9425,16006,18491,36862,,6325,14817,01,049
"Elmore County, Alabama",80321,39310,41011,60602,16631,364,617,0,734,1373,139,1234,78141,2180,0.4103,24185,27523,27685,18700,14001,8734,21101,-666666666,20818,7496,01,051
"Escambia County, Alabama",38042,19634,18408,23633,12361,1262,52,0,212,522,97,425,37274,768,0.4742,16673,20102,20262,12384,10226,18187,6773,-666666666,15373,11931,01,053
"Etowah County, Alabama",104126,50316,53810,84904,16000,373,696,75,600,1478,120,1358,100457,3669,0.4458,20445,21564,21953,11483,14263,24696,47606,29541,15568,10706,01,055
"Fayette County, Alabama",17019,8457,8562,14663,2088,0,42,0,0,226,0,226,16891,128,0.4670,19040,20329,20413,7152,11503,-666666666,7436,-666666666,-666666666,7159,01,057
"Franklin County, Alabama",31663,15544,16119,28420,1545,206,23,28,1224,217,79,138,26781,4882,0.4386,18559,19343,20496,11244,12560,8860,,,11800,6770,01,059
"Geneva County, Alabama",26816,13125,13691,23215,2605,58,109,0,359,470,32,438,25869,947,0.4480,20027,21142,21467,8558,13250,25672,19006,-666666666,8318,11022,01,061
"Greene County, Alabama",8798,4118,4680,1559,7107,34,10,0,0,88,34,54,8759,39,0.4876,13956,25783,25783,,11494,,,-666666666,-666666666,,01,063
"Hale County, Alabama",15393,7260,8133,6133,8995,36,41,14,90,84,55,29,15229,164,0.5082,18774,25298,25311,16452,14476,14692,2846,,22231,3819,01,065
"Henry County, Alabama",17270,8226,9044,12050,4777,0,218,0,120,105,15,90,16852,418,0.4402,22682,25139,25390,14729,16961,-666666666,15041,-666666666,16705,23665,01,067
"Houston County, Alabama",103079,49416,53663,72001,26960,390,845,4,1021,1858,73,1785,99828,3251,0.4730,23492,27428,27746,14286,14030,17998,32931,,12281,11280,01,069
"Jackson County, Alabama",53012,26187,26825,48395,1715,974,219,49,552,1108,39,1069,51599,1413,0.4473,20055,20411,20585,10765,12622,20190,20779,67218,13572,16886,01,071
"Jefferson County, Alabama",658834,311540,347294,349052,278587,1568,10020,117,12637,6853,397,6456,633718,25116,0.4970,26896,35220,35910,12891,17359,23561,28129,68416,10794,18520,01,073
"Lamar County, Alabama",14268,6863,7405,12460,1659,37,2,0,5,105,0,105,14073,195,0.4345,19094,20105,20257,10288,11967,,,-666666666,,5317,01,075
"Lauderdale County, Alabama",92780,44459,48321,80695,9228,436,743,9,236,1433,133,1300,90606,2174,0.4615,23975,25234,25365,17447,15242,21993,24543,,10671,11891,01,077
"Lawrence County, Alabama",33835,16435,17400,26344,3751,1845,40,0,53,1802,55,1747,33172,663,0.4247,21093,21814,22022,7624,16748,19505,10888,-666666666,23085,21385,01,079
"Lee County, Alabama",147790,72908,74882,104328,34142,277,4567,102,2128,2246,76,2170,142356,5434,0.4937,24126,26733,26992,15690,17401,9264,28066,7279,15119,8388,01,081
"Limestone County, Alabama",87167,43986,43181,70843,11133,527,1089,33,1869,1673,117,1556,82233,4934,0.4541,25658,27840,28610,12118,16226,26704,22545,16773,15547,9183,01,083
"Lowndes County, Alabama",10918,5150,5768,2820,8060,0,0,0,0,38,0,38,10816,102,0.5281,18046,32467,32895,9735,13017,-666666666,-666666666,-666666666,-666666666,14492,01,085
"Macon County, Alabama",20505,9413,11092,3377,16738,67,38,0,155,130,5,125,20200,305,0.4703,17113,23230,23152,13196,15723,11288,26389,-666666666,23690,29642,01,087
"Madison County, Alabama",343229,168021,175208,236921,82307,2244,8415,330,3054,9958,605,9353,327245,15984,0.4701,32307,36888,37579,20973,21567,23524,31489,47756,15251,19464,01,089
"Marengo County, Alabama",20489,9550,10939,9623,10512,55,58,0,157,84,0,84,20064,425,0.5402,22529,32219,29380,82876,14066,9153,10672,-666666666,9910,12088,01,091
"Marion County, Alabama",30527,15151,15376,28674,1129,46,157,0,35,486,24,462,29821,706,0.4711,20125,20575,20532,19273,10656,27320,33259,-666666666,14974,11012,01,093
"Marshall County, Alabama",94121,46300,47821,87082,1703,632,512,7,2591,1594,220,1374,82291,11830,0.4659,20975,21701,23201,8152,11097,12129,15810,,7036,19712,01,095
"Mobile County, Alabama",414045,198288,215757,249439,144637,2801,7953,60,2472,6683,419,6264,403335,10710,0.4732,23009,27850,27911,22452,15194,18659,26410,31302,16689,11482,01,097
"Monroe County, Alabama",22509,10774,11735,12436,9449,221,114,0,74,215,0,215,22275,234,0.4920,16273,19862,20016,3596,11589,14424,23032,-666666666,7958,15742,01,099
"Montgomery County, Alabama",228850,108811,120039,90109,127389,593,5216,36,2388,3119,593,2526,220894,7956,0.4771,25089,36219,37050,17248,17642,27029,28468,,9865,12982,01,101
"Morgan County, Alabama",119744,58833,60911,99065,14413,915,746,83,1881,2641,151,2490,110440,9304,0.4488,24222,25953,27218,10343,15348,30175,31533,18960,11987,12459,01,103
"Perry County, Alabama",10203,4739,5464,3110,6974,2,32,0,12,73,0,73,10115,88,0.4924,12988,20443,20780,3661,9788,,20341,-666666666,,126,01,105
"Pickens County, Alabama",19629,9462,10167,11012,8387,0,0,0,39,191,25,166,19475,154,0.4608,17310,21954,22046,11190,11470,-666666666,-666666666,-666666666,15041,6413,01,107
"Pike County, Alabama",33216,15785,17431,19497,12103,258,724,0,43,591,164,427,32466,750,0.4938,19424,24292,24553,12689,12487,12817,16344,-666666666,28270,6946,01,109
"Randolph County, Alabama",22724,11091,11633,17491,4555,39,36,28,202,373,45,328,22066,658,0.4525,19324,21117,21302,8864,14512,,,15725,1058,5824,01,111
"Russell County, Alabama",56980,27662,29318,30610,23836,162,439,112,438,1383,174,1209,54388,2592,0.4535,19652,21834,21812,19949,17881,17054,17687,12333,10565,6278,01,113
"St. Clair County, Alabama",85242,42650,42592,75106,7952,350,577,4,436,817,16,801,83381,1861,0.4230,23863,24778,25005,11143,16533,21936,38051,,8612,10218,01,115
"Shelby County, Alabama",201168,98040,103128,164508,23050,590,4070,28,6497,2425,341,2084,189276,11892,0.4253,33135,35244,35771,14899,25178,33934,31526,,11736,24469,01,117
"Sumter County, Alabama",13433,6056,7377,3322,9811,48,205,0,21,26,2,24,13370,63,0.4762,14042,22415,22628,4832,11428,,3708,-666666666,2305,,01,119
"Talladega County, Alabama",81673,39727,41946,53259,26046,331,290,0,441,1306,142,1164,79931,1742,0.4514,19134,21815,21993,9748,14118,17750,46160,-666666666,10049,7266,01,121
"Tallapoosa County, Alabama",41295,19983,21312,29076,11457,92,5,0,383,282,0,282,40259,1036,0.4444,21034,24562,24826,12444,13004,9742,7080,-666666666,6393,7376,01,123
"Tuscaloosa County, Alabama",198670,96008,102662,132211,60376,368,2802,5,1122,1786,41,1745,192351,6319,0.4666,23124,26919,27364,15743,15202,24059,26111,,13273,11375,01,125
"Walker County, Alabama",66211,32202,34009,60224,3764,154,225,0,420,1424,55,1369,64773,1438,0.4635,20580,21274,21422,11585,15471,14467,19250,-666666666,11681,8224,01,127
"Washington County, Alabama",17137,8508,8629,11225,4169,1405,191,0,91,56,50,6,16937,200,0.4169,20737,22802,22793,9805,16972,17728,11679,-666666666,10657,9814,01,129
"Wilcox County, Alabama",11367,5336,6031,3082,8205,4,0,0,60,16,0,16,11299,68,0.5321,13881,24139,24139,3028,10140,,-666666666,-666666666,,,01,131
"Winston County, Alabama",24256,11793,12463,23330,168,167,30,12,20,529,62,467,23591,665,0.4564,19078,19582,19752,7476,7146,6941,12107,,,5895,01,133
"Aleutians East Borough, Alaska",3296,2299,997,747,342,877,1071,37,103,119,27,92,2855,441,0.3858,27122,36358,43176,25077,18968,24161,25638,32546,32566,21356,02,013
"Aleutians West Census Area, Alaska",5650,3481,2169,1849,295,751,1955,137,261,402,37,365,5054,596,0.3911,32700,49125,52727,29765,31754,21293,24733,28960,42998,12484,02,016
"Anchorage Municipality, Alaska",298178,151865,146313,195593,17607,20634,25280,6503,4658,27903,1873,26030,273491,24687,0.4156,36508,43973,45317,23027,30353,23224,22397,15788,24415,17521,02,020
"Bethel Census Area, Alaska",17576,9191,8385,2043,117,14303,195,56,52,810,11,799,17295,281,0.4427,18875,53519,52923,25264,25526,13490,45936,8534,25690,19388,02,050
"Bristol Bay Borough, Alaska",995,543,452,561,3,320,7,1,13,90,0,90,939,56,0.3476,37012,46844,48392,12611,,26760,2029,,6362,20476,02,060
"Denali Borough, Alaska",2048,1061,987,1780,39,69,96,0,0,64,0,64,1999,49,0.3756,36828,38978,39140,33239,59531,18649,10977,-666666666,-666666666,21594,02,068
"Dillingham Census Area, Alaska",4956,2567,2389,926,11,3571,56,1,21,370,0,370,4826,130,0.4345,21774,47159,49464,20092,25664,15267,35498,,97343,14582,02,070
"Fairbanks North Star Borough, Alaska",99319,52832,46487,76755,4483,6298,2665,513,897,7708,219,7489,92462,6857,0.4013,32906,35811,36609,23012,28522,21966,30950,15958,23265,18388,02,090
"Haines Borough, Alaska",2557,1396,1161,2076,1,169,49,0,11,251,7,244,2525,32,0.4171,32312,34403,34621,14194,,30390,41204,-666666666,,15314,02,100
"Hoonah-Angoon Census Area, Alaska",2126,1132,994,1065,12,777,42,4,15,211,0,211,2088,38,0.4472,30811,37953,38401,12132,,19570,98555,,33247,23652,02,105
"Juneau City and Borough, Alaska",32200,16585,15615,22362,384,3999,1951,312,377,2815,182,2633,30316,1884,0.3738,38057,45034,45387,30830,35807,23907,22262,16088,30919,17376,02,110
"Kenai Peninsula Borough, Alaska",56687,29664,27023,47751,335,4402,668,46,308,3177,116,3061,54705,1982,0.4190,31611,33820,34252,19630,28639,18348,22789,8333,42828,18205,02,122
"Ketchikan Gateway Borough, Alaska",13676,7086,6590,9349,55,2049,834,6,50,1333,14,1319,13040,636,0.4057,31494,37246,37838,22343,32322,20302,23528,,47346,12517,02,130
"Kodiak Island Borough, Alaska",13924,7332,6592,7606,115,2050,2913,156,288,796,269,527,12796,1128,0.3984,29993,37955,38855,20484,19576,19412,22047,8192,29519,16189,02,150
"Lake and Peninsula Borough, Alaska",1490,733,757,333,8,1060,18,7,1,63,2,61,1459,31,0.4362,21581,39474,40383,19639,,15831,19878,,,21948,02,164
"Matanuska-Susitna Borough, Alaska",93843,48911,44932,79273,845,5005,1294,243,653,6530,117,6413,89861,3982,0.4042,30013,32178,32460,22842,27523,20079,23075,23916,20357,14234,02,170
"Nome Census Area, Alaska",9792,5227,4565,1690,64,6959,92,19,19,949,11,938,9624,168,0.4427,19651,46582,47415,16983,38669,12594,31712,13547,52653,20445,02,180
"North Slope Borough, Alaska",9618,6112,3506,3156,43,5076,453,136,172,582,3,579,9300,318,0.3777,50267,96900,97433,45847,103965,22991,48721,36754,47327,36535,02,185
"Northwest Arctic Borough, Alaska",7672,4109,3563,921,24,6233,55,2,37,400,0,400,7560,112,0.4034,21543,57798,58240,32303,42250,15873,46362,,54719,18388,02,188
"Petersburg Borough, Alaska",3212,1665,1547,2373,74,233,56,14,130,332,10,322,2970,242,0.4422,36307,41738,42067,25584,19193,19897,22086,12093,22447,21666,02,195
"Prince of Wales-Hyder Census Area, Alaska",6356,3463,2893,3000,19,2625,39,20,12,641,19,622,6171,185,0.4319,24737,31642,31621,25483,17221,19361,17008,10170,33100,15423,02,198
"Sitka City and Borough, Alaska",8957,4568,4389,5897,89,1415,540,11,110,895,36,859,8454,503,0.3862,33920,40006,40885,18798,29009,19346,28224,,31575,21308,02,220
"Skagway Municipality, Alaska",996,506,490,792,0,33,116,0,2,53,0,53,965,31,0.3761,40986,43035,42886,40526,-666666666,21591,31662,-666666666,,44002,02,230
"Southeast Fairbanks Census Area, Alaska",7044,3909,3135,5675,75,787,73,39,60,335,4,331,6738,306,0.3944,30402,33594,34536,12240,12149,14278,66019,,27155,13313,02,240
"Valdez-Cordova Census Area, Alaska",9685,5165,4520,7086,29,1549,292,43,104,582,16,566,9274,411,0.4059,32610,36873,37445,21575,13124,24266,16304,11086,4694,18639,02,261
"Wade Hampton Census Area, Alaska",7778,4109,3669,317,21,6916,34,24,0,466,0,466,7758,20,0.4011,11257,33465,33672,9975,21833,10211,26238,10396,-666666666,10149,02,270
"Wrangell City and Borough, Alaska",2383,1207,1176,1714,4,398,80,0,2,185,0,185,2360,23,0.4157,30671,33784,33974,28174,,20990,22750,-666666666,,26541,02,275
"Yakutat City and Borough, Alaska",635,369,266,240,37,195,22,5,13,123,0,123,608,27,0.3488,33475,44888,44984,58733,,24875,26459,24460,113369,21955,02,282
"Yukon-Koyukuk Census Area, Alaska",5651,3032,2619,1265,17,3990,30,0,13,336,0,336,5560,91,0.4509,20149,34533,35196,7234,16941,15900,16103,-666666666,24508,16809,02,290
"Apache County, Arizona",72142,35823,36319,16881,422,52243,291,67,802,1436,164,1272,67714,4428,0.4693,12828,21307,22941,11334,9449,10217,13359,8370,13006,9110,04,001
"Cochise County, Arizona",130807,66768,64039,104360,5148,1599,2266,200,9948,7286,1963,5323,87030,43777,0.4496,23552,25074,28391,15718,23985,13495,29838,7968,15266,13425,04,003
"Coconino County, Arizona",135817,67166,68651,84667,2009,36504,2120,150,5584,4783,1236,3547,117134,18683,0.4701,23459,28703,30302,16168,22261,13481,25083,27978,19127,11489,04,005
"Gila County, Arizona",53242,26542,26700,42170,319,7896,326,8,1294,1229,185,1044,43435,9807,0.4274,20857,23464,24947,16433,13738,9282,22798,,16784,11500,04,007
"Graham County, Arizona",37311,20023,17288,28436,798,5209,186,58,1776,848,198,650,25639,11672,0.4242,17687,19404,21616,15321,11882,8637,16846,22278,20463,15218,04,009
"Greenlee County, Arizona",8800,4652,4148,7590,125,272,21,0,554,238,178,60,4639,4161,0.3889,22334,22563,25517,18517,23736,28979,52724,-666666666,18468,13026,04,011
"La Paz County, Arizona",20348,10396,9952,14617,49,2761,143,37,2411,330,78,252,15311,5037,0.4115,21772,24320,26439,13573,45455,15114,34670,5127,14316,11847,04,012
"Maricopa County, Arizona",3947382,1951241,1996141,3162279,203650,74454,144749,8138,235737,118375,25220,93155,2766282,1181100,0.4616,27477,29621,35507,14046,19352,15961,32262,16753,13701,13749,04,013
"Mohave County, Arizona",202482,101778,100704,180836,2193,3832,2365,341,5813,7102,1110,5992,171381,31101,0.4350,20709,21528,22845,11578,10609,13356,26577,28831,10659,12811,04,015
"Navajo County, Arizona",107489,53627,53862,52875,601,46892,565,273,3229,3054,504,2550,95710,11779,0.4702,16355,22603,23569,13531,9621,10071,18309,14023,13470,8905,04,017
"Pima County, Arizona",993144,488310,504834,782395,35426,31649,26796,1331,80977,34570,9108,25462,641815,351329,0.4691,25524,27888,33209,15446,20016,12779,27491,16890,14367,14270,04,019
"Pinal County, Arizona",390160,202711,187449,309920,18113,20698,6616,1658,22280,10875,2387,8488,277114,113046,0.4061,20983,22956,26264,13515,17518,9892,19563,3046,13393,10813,04,021
"Santa Cruz County, Arizona",47250,22651,24599,35779,216,108,416,27,10024,680,344,336,8116,39134,0.4662,17900,19192,34992,14469,20662,27087,33997,,12783,13123,04,023
"Yavapai County, Arizona",213689,104595,109094,196410,1188,4094,1783,15,5529,4670,780,3890,183987,29702,0.4362,25068,25763,27403,13373,23948,16727,30278,,12790,16005,04,025
"Yuma County, Arizona",201453,102508,98945,154867,4123,2569,2428,335,32075,5056,1697,3359,79183,122270,0.4312,18887,20164,28975,13311,19533,11591,24895,12333,13812,12700,04,027
"Arkansas County, Arkansas",18861,9084,9777,13643,4842,34,79,16,29,218,48,170,18312,549,0.4663,23237,26171,26656,8131,15516,44847,21127,,,10928,05,001
"Ashley County, Arkansas",21437,10328,11109,15124,5588,51,5,0,476,193,21,172,20363,1074,0.4573,19739,22626,22272,22691,12852,10516,31400,-666666666,13596,10126,05,003
"Baxter County, Arkansas",41154,19747,21407,39830,115,197,219,8,190,595,51,544,40394,760,0.4395,21693,21907,22030,15998,6490,14418,15970,,24963,13839,05,005
"Benton County, Arkansas",232611,115108,117503,204379,3131,3595,7606,674,7053,6173,678,5495,195790,36821,0.4370,27522,28040,30490,13686,27397,21763,34730,10748,17974,17634,05,007
"Boone County, Arkansas",37169,18104,19065,35846,60,344,200,0,24,695,50,645,36373,796,0.4486,21348,21529,21692,13270,4695,17210,19755,-666666666,70450,14271,05,009
"Bradley County, Arkansas",11316,5538,5778,6835,3240,19,0,0,1160,62,0,62,9765,1551,0.4891,20243,25066,25493,10645,13973,,-666666666,-666666666,9030,6366,05,011
"Calhoun County, Arkansas",5266,2740,2526,3895,1303,0,11,0,2,55,0,55,5221,45,0.4337,19755,22664,22781,10807,11767,-666666666,,-666666666,,7082,05,013
"Carroll County, Arkansas",27626,13403,14223,25845,225,273,76,16,527,664,66,598,23793,3833,0.4315,20604,21051,22206,12283,6198,18831,17618,,9767,17865,05,015
"Chicot County, Arkansas",11489,5612,5877,4844,6202,82,26,0,305,30,0,30,10895,594,0.5465,19311,28346,29238,9476,12961,11816,30596,-666666666,4914,30243,05,017
"Clark County, Arkansas",22800,10794,12006,16706,5496,32,140,0,102,324,26,298,21826,974,0.4804,18709,20559,21060,10739,14346,14481,5576,-666666666,1002,8986,05,019
"Clay County, Arkansas",15577,7710,7867,15101,14,31,14,0,159,258,5,253,15324,253,0.4192,18434,18624,18596,14151,17671,31516,,-666666666,9636,10534,05,021
"Cleburne County, Arkansas",25793,12857,12936,25026,112,124,58,0,115,358,0,358,25203,590,0.4735,24297,24576,24882,8818,2766,33791,17181,-666666666,13757,12757,05,023
"Cleveland County, Arkansas",8597,4284,4313,7367,996,29,16,0,18,171,0,171,8524,73,0.4447,21666,23447,23535,8892,11772,43886,,-666666666,,3094,05,025
"Columbia County, Arkansas",24400,11609,12791,14641,8784,75,156,0,312,432,335,97,23783,617,0.4634,19893,25522,25742,6844,11265,20681,22149,-666666666,10975,10022,05,027
"Conway County, Arkansas",21175,10488,10687,18145,2502,164,13,0,6,345,6,339,20388,787,0.4646,21742,22112,22755,7695,19227,26504,,-666666666,,18894,05,029
"Craighead County, Arkansas",99835,48723,51112,82354,13588,394,1171,156,646,1526,172,1354,95290,4545,0.4831,23244,25696,26392,10071,10702,22154,22204,8277,7455,11921,05,031
"Crawford County, Arkansas",61825,30361,31464,56515,871,983,984,0,559,1913,27,1886,57838,3987,0.4281,20104,20601,21131,11533,12477,16860,16227,-666666666,9241,15719,05,033
"Crittenden County, Arkansas",50172,23750,26422,23000,25693,73,99,112,409,786,74,712,49078,1094,0.4558,19732,27891,28131,16786,12621,26885,38989,37344,17424,9007,05,035
"Cross County, Arkansas",17595,8427,9168,13221,3943,53,106,0,44,228,2,226,17302,293,0.4468,18919,21110,21044,22729,12346,16515,14250,-666666666,,8750,05,037
"Dallas County, Arkansas",7954,3984,3970,4422,3306,0,159,0,32,35,0,35,7752,202,0.4288,18261,21519,21885,6718,14532,-666666666,12363,-666666666,,,05,039
"Desha County, Arkansas",12602,5847,6755,6209,6097,24,0,0,103,169,84,85,12027,575,0.5270,19300,26806,27731,9503,12051,,-666666666,-666666666,9962,12582,05,041
"Drew County, Arkansas",18705,9052,9653,12961,5377,31,10,0,117,209,0,209,18194,511,0.4840,17433,20627,20995,9852,10214,19252,22800,-666666666,15056,5924,05,043
"Faulkner County, Arkansas",117804,57760,60044,99701,12972,415,1400,20,971,2325,82,2243,113107,4697,0.4410,24703,26172,26575,16233,17246,17740,13952,,27340,10136,05,045
"Franklin County, Arkansas",17960,8917,9043,17093,173,314,59,0,16,305,17,288,17500,460,0.4332,20021,20285,20653,4559,14558,13909,13753,-666666666,16725,15997,05,047
"Fulton County, Arkansas",12218,6035,6183,11854,22,70,148,0,0,124,0,124,12086,132,0.4105,19216,19200,19272,11275,2600,16696,,-666666666,-666666666,12556,05,049
"Garland County, Arkansas",96804,46955,49849,82155,8024,611,838,26,3294,1856,38,1818,91869,4935,0.4763,23514,25192,25439,9149,13290,19168,36396,,8785,15087,05,051
"Grant County, Arkansas",18014,8832,9182,17064,459,75,63,3,176,174,25,149,17575,439,0.4040,22065,22576,22812,7215,12948,5712,25859,,9540,14716,05,053
"Greene County, Arkansas",42970,21256,21714,41459,362,107,41,24,317,660,51,609,41918,1052,0.4287,20188,20450,20585,11218,12012,13051,2488,,8112,16537,05,055
"Hempstead County, Arkansas",22419,10618,11801,14841,6629,55,4,0,320,570,132,438,19643,2776,0.4633,17866,19694,21622,8905,12954,31700,,-666666666,12630,29146,05,057
"Hot Spring County, Arkansas",33277,16977,16300,28644,3935,159,41,0,89,409,8,401,32263,1014,0.4241,19819,20730,21025,11895,14057,15595,,-666666666,1337,18441,05,059
"Howard County, Arkansas",13685,6649,7036,9398,2968,119,4,0,1126,70,2,68,12276,1409,0.4683,20341,23845,24273,9608,14185,8035,,-666666666,9305,10421,05,061
"Independence County, Arkansas",36861,18109,18752,34874,926,238,117,0,178,528,29,499,34678,2183,0.4578,20222,20488,21211,10061,16141,14417,25839,-666666666,35213,6116,05,063
"Izard County, Arkansas",13522,6935,6587,12939,151,62,81,91,35,163,7,156,13295,227,0.4442,18650,19186,19296,9543,3342,1742,2109,,306,17085,05,065
"Jackson County, Arkansas",17746,8857,8889,14208,2959,95,69,0,93,322,4,318,17269,477,0.4469,15860,17630,17935,5706,8408,31112,9214,-666666666,5656,6130,05,067
"Jefferson County, Arkansas",74655,36707,37948,31287,41448,128,613,109,249,821,49,772,73328,1327,0.4732,19847,25497,25921,8775,15628,4652,32834,4136,10328,15211,05,069
"Johnson County, Arkansas",25791,12713,13078,23793,489,131,228,44,442,664,156,508,22457,3334,0.4784,18993,19706,19777,17603,9510,15091,12394,,13654,7542,05,071
"Lafayette County, Arkansas",7391,3570,3821,4551,2787,0,14,0,0,39,2,37,7253,138,0.4594,17707,21819,21915,18581,10996,-666666666,40514,-666666666,-666666666,9233,05,073
"Lawrence County, Arkansas",17163,8437,8726,16716,137,61,0,0,8,241,3,238,16973,190,0.4238,17064,17089,17218,5738,6500,37510,-666666666,-666666666,12825,16300,05,075
"Lee County, Arkansas",10151,5692,4459,4283,5744,9,0,0,94,21,0,21,9931,220,0.4856,13297,19532,19604,12795,8735,,-666666666,-666666666,9527,6229,05,077
"Lincoln County, Arkansas",14113,8605,5508,9447,4172,72,0,0,207,215,14,201,13628,485,0.5077,14501,18221,18521,7816,6929,11140,-666666666,-666666666,9901,3550,05,079
"Little River County, Arkansas",12852,6396,6456,9558,2630,132,0,0,292,240,13,227,12468,384,0.4214,20073,22283,22275,11076,13770,23827,-666666666,-666666666,8168,13573,05,081
"Logan County, Arkansas",22129,10985,11144,20635,400,259,433,0,188,214,29,185,21585,544,0.4596,20114,19637,19727,9122,10271,41210,46227,-666666666,555,23266,05,083
"Lonoke County, Arkansas",70118,34532,35586,62852,4319,313,451,0,908,1275,139,1136,67527,2591,0.3871,23339,24308,24569,14870,14754,12368,18900,-666666666,15017,14830,05,085
"Madison County, Arkansas",15696,7826,7870,14956,59,67,80,0,108,426,12,414,14888,808,0.4481,19930,20143,20650,9423,16946,26469,21810,-666666666,12067,13449,05,087
"Marion County, Arkansas",16534,8204,8330,15979,44,110,121,0,59,221,15,206,16184,350,0.4025,17429,17533,17665,8460,7966,30719,9826,-666666666,7669,11962,05,089
"Miller County, Arkansas",43537,21450,22087,31251,10772,161,87,0,216,1050,117,933,42315,1222,0.4337,20853,23340,23534,14421,14610,22987,5707,-666666666,24833,10989,05,091
"Mississippi County, Arkansas",45385,22082,23303,28513,15651,83,134,9,309,686,0,686,43682,1703,0.4688,18732,22207,22605,12202,12632,17754,41506,,8448,13651,05,093
"Monroe County, Arkansas",7855,3778,4077,4431,3265,8,17,0,35,99,11,88,7701,154,0.4905,17571,22477,22734,9242,11059,,,-666666666,1849,16884,05,095
"Montgomery County, Arkansas",9296,4596,4700,8776,65,132,60,0,65,198,0,198,8959,337,0.4202,18698,18966,19227,8783,20822,19461,10500,-666666666,13377,9847,05,097
"Nevada County, Arkansas",8877,4363,4514,5978,2712,27,121,0,0,39,0,39,8610,267,0.4563,18254,21057,21876,2713,12626,24593,7840,-666666666,-666666666,7818,05,099
"Newton County, Arkansas",8131,4077,4054,7755,4,75,9,0,0,288,7,281,8053,78,0.4478,18127,18166,18289,6547,,16005,,-666666666,-666666666,18272,05,101
"Ouachita County, Arkansas",25421,12089,13332,14580,10115,40,54,0,42,590,4,586,24952,469,0.4582,19358,23842,24226,10492,13212,14975,38602,-666666666,13462,12870,05,103
"Perry County, Arkansas",10350,5171,5179,9784,311,20,10,0,111,114,0,114,10075,275,0.4287,22534,23266,23588,6341,9193,,,-666666666,9254,10461,05,105
"Phillips County, Arkansas",20847,9839,11008,7606,12908,17,25,0,13,278,0,278,20535,312,0.5069,17848,26243,26354,22784,13199,,44952,-666666666,,1861,05,107
"Pike County, Arkansas",11187,5518,5669,10026,327,8,51,0,533,242,8,234,10451,736,0.4508,18695,19573,19642,10003,19801,,10920,-666666666,7342,7988,05,109
"Poinsett County, Arkansas",24359,11966,12393,21807,1919,75,11,0,225,322,3,319,23754,605,0.4259,17110,17804,17952,6485,13035,25136,,-666666666,2979,2187,05,111
"Polk County, Arkansas",20454,9966,10488,18949,46,324,78,0,508,549,34,515,19213,1241,0.4558,19412,20049,20406,9966,11822,12703,26138,-666666666,9044,10675,05,113
"Pope County, Arkansas",62687,31290,31397,56921,1969,296,397,0,1150,1954,89,1865,57880,4807,0.4377,20465,21065,21545,11602,14710,13860,28318,-666666666,11927,13192,05,115
"Prairie County, Arkansas",8475,4165,4310,7321,1048,6,13,0,15,72,2,70,8387,88,0.4121,18977,19976,20122,5207,12770,,,-666666666,,7589,05,117
"Pulaski County, Arkansas",388752,186547,202205,230370,138101,1291,8139,109,3334,7408,513,6895,365907,22845,0.4810,27506,34312,35976,14684,17269,24328,27660,42687,12986,13360,05,119
"Randolph County, Arkansas",17794,8691,9103,17160,128,50,6,1,113,336,0,336,17485,309,0.4552,19528,19850,19972,5888,14422,11874,,,5527,10825,05,121
"St. Francis County, Arkansas",27642,15171,12471,12228,14261,111,57,14,474,497,11,486,26462,1180,0.4704,16076,20362,20884,12893,12894,9149,,,10764,7943,05,123
"Saline County, Arkansas",111811,54977,56834,101651,6079,437,929,14,646,2055,201,1854,107369,4442,0.3818,26179,26901,27265,16188,21874,18925,21953,,14270,10209,05,125
"Scott County, Arkansas",11024,5577,5447,9866,29,119,355,0,288,367,0,367,10212,812,0.4451,18525,18341,18942,7085,366,13152,36363,-666666666,7767,17838,05,127
"Searcy County, Arkansas",8036,4048,3988,7721,26,75,65,0,0,149,2,147,7891,145,0.4383,17590,18004,17976,18362,6912,8267,-666666666,-666666666,-666666666,10356,05,129
"Sebastian County, Arkansas",126801,62180,64621,104542,7710,1551,5561,119,1813,5505,563,4942,110471,16330,0.4991,23768,25472,27382,12885,13913,21352,22029,12697,13778,11176,05,131
"Sevier County, Arkansas",17250,8543,8707,11255,817,262,87,0,4453,376,19,357,11744,5506,0.4064,16266,19112,20180,9817,13808,17415,9215,-666666666,10333,7495,05,133
"Sharp County, Arkansas",17117,8401,8716,16417,57,78,216,14,51,284,53,231,16793,324,0.4103,16906,16993,17131,12679,12975,10401,16511,,23935,14270,05,135
"Stone County, Arkansas",12531,6241,6290,12350,19,10,42,0,20,90,0,90,12339,192,0.4937,19985,20135,20215,14264,,,22129,-666666666,,4403,05,137
"Union County, Arkansas",40954,19786,21168,26552,13496,226,225,0,62,393,67,326,39489,1465,0.4719,21911,25853,26760,8352,14646,16890,13889,-666666666,9597,14441,05,139
"Van Buren County, Arkansas",17090,8516,8574,16347,147,81,15,0,117,383,15,368,16606,484,0.4571,18727,19141,19226,13944,7624,15753,19020,-666666666,8005,9203,05,141
"Washington County, Arkansas",212238,106170,106068,166745,7287,2352,5152,4671,20579,5452,803,4649,178498,33740,0.4924,24018,26954,28069,11290,14039,16373,21308,8434,10486,17850,05,143
"White County, Arkansas",78275,38540,39735,71425,3390,146,377,20,1095,1822,155,1667,75142,3133,0.4667,22132,22962,23254,11524,11274,10323,27537,,13234,15071,05,145
"Woodruff County, Arkansas",7094,3415,3679,4951,1937,10,0,8,20,168,4,164,7053,41,0.4767,17296,19518,19578,6568,12420,,-666666666,,,7705,05,147
"Yell County, Arkansas",21934,10965,10969,18599,246,56,163,0,2720,150,74,76,17763,4171,0.4342,18170,19324,20002,11377,9089,18448,10123,-666666666,11770,14665,05,149
"Alameda County, California",1559308,763965,795343,707017,184785,9315,424061,12923,126476,94731,19007,75724,1206808,352500,0.4692,36439,44253,52729,19694,25935,27534,37029,24597,18562,22319,06,001
"Alpine County, California",1202,665,537,854,11,208,12,14,34,69,6,63,1116,86,0.4036,24375,30485,30853,8714,,9915,17833,14471,5376,8738,06,003
"Amador County, California",37159,19966,17193,32551,812,744,501,80,1191,1280,125,1155,32435,4724,0.4568,27373,29341,30781,12130,3085,25790,21239,23270,8100,14234,06,005
"Butte County, California",221578,109745,111833,185077,3248,2667,9384,370,6586,14246,1758,12488,188610,32968,0.4713,24430,26401,27744,14496,14351,17659,16175,19697,13885,12818,06,007
"Calaveras County, California",44921,22257,22664,41129,292,361,526,131,671,1811,192,1619,40020,4901,0.4354,29296,30478,31834,17790,21003,14436,22098,11264,24448,11938,06,009
"Colusa County, California",21424,11156,10268,17439,198,286,283,19,2407,792,259,533,9269,12155,0.4335,22211,23566,35659,12829,38669,22947,34525,28637,13895,8703,06,011
"Contra Costa County, California",1081232,527174,554058,671384,97035,5482,161381,5133,77416,63401,10490,52911,813373,267859,0.4618,38770,44691,52429,19974,26074,26938,40059,24277,18132,19622,06,013
"Del Norte County, California",28066,15563,12503,21437,1007,1407,602,46,1103,2464,70,2394,22835,5231,0.4621,19424,21654,24664,6771,13658,20275,9071,19259,9472,8882,06,015
"El Dorado County, California",181465,90744,90721,158367,1781,1629,6885,191,6368,6244,681,5563,159054,22411,0.4530,35128,36539,38017,19284,26793,22418,42431,16013,14608,18488,06,017
"Fresno County, California",948844,473427,475417,555967,48276,9890,92096,1710,201491,39414,13517,25897,462930,485914,0.4726,20231,24334,33206,12894,15587,15166,19804,13754,11940,12964,06,019
"Glenn County, California",28019,14204,13815,23858,249,560,658,106,1740,848,334,514,17113,10906,0.4897,21698,23347,29551,12159,17853,15445,7166,15725,12483,11508,06,021
"Humboldt County, California",134876,67533,67343,110595,1755,7514,3057,422,4218,7315,1056,6259,120936,13940,0.4576,23516,25307,26005,13877,16191,15675,20528,16524,13036,13938,06,023
"Imperial County, California",177026,90736,86290,120826,5205,2477,2623,152,37347,8396,4419,3977,32936,144090,0.4590,16409,18114,32464,13861,12823,15275,24535,4989,12460,9659,06,025
"Inyo County, California",18439,9268,9171,15267,202,2005,250,59,303,353,43,310,14709,3730,0.4315,27028,28843,31722,18055,11164,18760,18766,24586,19742,17071,06,027
"Kern County, California",857730,440712,417018,632452,48412,10612,37886,1078,97625,29665,8491,21174,425360,432370,0.4562,20467,21900,31027,12921,15662,17326,25160,14268,14445,12944,06,029
"Kings County, California",151390,84233,67157,106922,9843,2022,5530,351,20287,6435,1783,4652,72479,78911,0.4479,18518,20303,29330,11706,16328,14727,23079,16003,11924,10397,06,031
"Lake County, California",64209,32299,31910,51591,1497,2276,767,172,5999,1907,331,1576,52608,11601,0.4604,21310,23181,23967,13353,11021,11936,30642,23881,12160,14762,06,033
"Lassen County, California",33356,22357,10999,24131,2905,1167,510,232,3338,1073,395,678,27316,6040,0.4210,19847,24535,25911,6633,6337,13617,7361,11417,4632,12859,06,035
"Dearborn County, Indiana",49840,24807,25033,48486,357,159,231,40,227,340,8,332,49284,556,0.4151,27746,28103,28189,16753,14912,12671,25152,,17071,7586,18,029
"Decatur County, Indiana",26112,12853,13259,25177,321,0,137,0,180,297,99,198,25647,465,0.3836,22609,22746,22818,12283,16633,-666666666,61615,-666666666,10453,6842,18,031
"DeKalb County, Indiana",42321,21071,21250,41049,68,27,181,0,259,737,42,695,41244,1077,0.4077,23768,24029,23994,22572,20672,14581,12823,-666666666,21499,13356,18,033
"Delaware County, Indiana",117441,56296,61145,104481,6300,239,1389,10,695,4327,124,4203,115128,2313,0.4674,21360,22439,22598,13097,13964,15480,14258,,14399,9717,18,035
"Dubois County, Indiana",42170,20998,21172,40688,147,69,157,0,763,346,55,291,39506,2664,0.4042,25841,26507,27149,11461,7337,,5646,-666666666,8730,5123,18,037
"Elkhart County, Indiana",199544,98488,101056,172004,11492,283,2030,86,8141,5508,959,4549,170394,29150,0.4146,21403,22763,24348,11065,12371,17002,27605,15528,13361,7678,18,039
"Fayette County, Indiana",23955,11794,12161,23204,403,0,105,0,49,194,0,194,23721,234,0.4374,19633,19839,19911,12935,13784,-666666666,14181,-666666666,19047,10339,18,041
"Floyd County, Indiana",75431,36590,38841,68342,3638,176,826,0,648,1801,46,1755,73321,2110,0.4401,27449,28499,28707,14856,19229,17887,32796,-666666666,11827,8277,18,043
"Fountain County, Indiana",17002,8446,8556,16572,74,61,19,0,55,221,64,157,16600,402,0.3935,23153,23510,23636,13147,15336,5467,29800,-666666666,13695,5624,18,045
"Franklin County, Indiana",22980,11514,11466,22540,46,35,116,0,54,189,25,164,22744,236,0.3964,23741,23815,23883,15372,14741,25523,8828,-666666666,30104,24067,18,047
"Fulton County, Indiana",20638,10314,10324,19601,217,110,63,9,421,217,52,165,19677,961,0.4252,21523,21775,21946,12141,19836,17858,85059,,10902,3867,18,049
"Gibson County, Indiana",33586,16786,16800,31926,583,31,83,0,285,678,2,676,33093,493,0.4087,24256,24786,24876,17567,20306,6523,21902,-666666666,21755,4864,18,051
"Grant County, Indiana",69313,33287,36026,61655,4598,82,467,0,362,2149,186,1963,66656,2657,0.4293,20442,21177,21252,16606,15262,20700,20469,-666666666,14485,11450,18,053
"Greene County, Indiana",32978,16393,16585,32332,95,3,150,63,83,252,3,249,32604,374,0.4269,22491,22683,22776,13175,12715,,17888,,14225,9837,18,055
"Hamilton County, Indiana",289722,141509,148213,254565,10115,343,14834,39,2806,7020,902,6118,279223,10499,0.4282,40012,40929,41294,24310,32246,22827,46218,,20968,13427,18,057
"Hancock County, Indiana",70851,34618,36233,67613,1388,263,422,17,81,1067,135,932,69508,1343,0.3861,28722,29091,29069,27842,16274,5302,34255,,4454,27023,18,059
"Harrison County, Indiana",39216,19722,19494,38227,218,38,165,0,92,476,62,414,38570,646,0.3941,24469,24610,24763,10792,22179,42403,49338,-666666666,1816,8517,18,061
"Hendricks County, Indiana",150977,75210,75767,135302,8269,206,3347,42,1084,2727,506,2221,146017,4960,0.3758,30018,30818,31213,21914,26208,15816,21793,,26412,14563,18,063
"Henry County, Indiana",49227,25394,23833,46816,794,119,208,6,291,993,33,960,48465,762,0.4326,20165,20839,20950,5412,8264,19202,15807,,6263,2942,18,065
"Howard County, Indiana",82914,40037,42877,73230,5845,232,1035,55,647,1870,160,1710,80514,2400,0.4434,23897,24815,25077,13787,17603,26846,28317,4340,20252,6626,18,067
"Huntington County, Indiana",36959,18188,18771,35853,255,75,287,3,99,387,79,308,36256,703,0.3900,22875,23145,23270,12747,8479,29556,14679,,15540,14153,18,069
"Jackson County, Indiana",43127,21579,21548,40153,262,112,506,0,1435,659,133,526,40527,2600,0.3931,22556,23116,23454,11301,13504,15635,31479,-666666666,12625,7961,18,071
"Jasper County, Indiana",33443,16570,16873,32523,325,63,78,0,94,360,12,348,31550,1893,0.3716,24501,24839,25387,15126,14324,,4008,-666666666,19049,10079,18,073
"Jay County, Indiana",21279,10434,10845,20919,105,31,43,0,4,177,0,177,20665,614,0.3971,19812,19932,20189,10813,8598,23635,43037,-666666666,,6024,18,075
"Jefferson County, Indiana",32447,15676,16771,30836,673,50,272,0,276,340,42,298,31674,773,0.4049,22218,22746,22951,8221,10256,24952,21894,-666666666,5964,11008,18,077
"Jennings County, Indiana",28223,14155,14068,27409,279,0,54,0,155,326,32,294,27600,623,0.4038,20812,21113,21323,9832,8373,-666666666,7252,-666666666,17300,10085,18,079
"Johnson County, Indiana",143789,70764,73025,134480,2700,253,2753,14,1274,2315,670,1645,139073,4716,0.4137,28500,29215,29506,13265,20348,9580,23777,,9779,12300,18,081
"Knox County, Indiana",38181,19281,18900,36032,1200,11,179,80,281,398,38,360,37521,660,0.4281,21801,22363,22498,13667,9743,,13452,,20013,17264,18,083
"Kosciusko County, Indiana",77790,38820,38970,72008,612,241,962,0,2969,998,284,714,71832,5958,0.4214,25531,26554,27014,12419,11807,7847,20262,-666666666,11992,9757,18,085
"LaGrange County, Indiana",37759,19042,18717,36924,21,9,68,0,73,664,161,503,36339,1420,0.4157,19863,20056,20362,10592,9671,,18509,-666666666,18044,10029,18,087
"Lake County, Indiana",493140,238275,254865,305599,124511,1721,6260,164,42620,12265,4192,8073,407333,85807,0.4461,24294,28630,29842,16782,17283,19224,37339,5138,15871,10991,18,089
"LaPorte County, Indiana",111293,57672,53621,94111,11765,283,587,29,1711,2807,411,2396,104872,6421,0.4325,23074,25386,26011,11706,10317,15279,20841,24845,12291,6808,18,091
"Lawrence County, Indiana",45970,22747,23223,44568,170,69,270,0,292,601,46,555,45315,655,0.4191,23046,23303,23341,14929,15637,38946,23192,-666666666,12653,9224,18,093
"Madison County, Indiana",130688,65321,65367,115204,9413,210,559,57,1612,3633,168,3465,126201,4487,0.4285,22049,23390,23716,11047,13668,10226,16003,3484,11634,7757,18,095
"Marion County, Indiana",919336,442866,476470,580939,247316,2361,20765,327,41857,25771,2796,22975,831165,88171,0.4730,24145,28803,29844,12803,17098,14569,23749,13261,10323,10558,18,097
"Marshall County, Indiana",47032,23472,23560,43837,380,142,262,20,1762,629,128,501,42812,4220,0.4160,22580,23275,23875,10245,15139,21389,34053,,9445,11475,18,099
"Martin County, Indiana",10294,5171,5123,10067,19,29,62,16,7,94,0,94,10255,39,0.4061,23038,23366,23350,19121,,5634,,,,5419,18,101
"Miami County, Indiana",36394,19626,16768,33187,1819,376,66,32,274,640,176,464,35457,937,0.4158,21209,21780,21851,11217,16235,16098,4261,,9242,16219,18,103
"Monroe County, Indiana",141101,70032,71069,122835,4155,528,8404,35,1234,3910,283,3627,136655,4446,0.5106,23837,25148,25434,12441,20237,23921,14427,39509,11810,10339,18,105
"Montgomery County, Indiana",38183,19257,18926,36732,405,86,168,5,323,464,44,420,36455,1728,0.3998,22392,22609,23113,9847,14280,15931,62935,22420,10303,7223,18,107
"Morgan County, Indiana",69343,34369,34974,67620,218,43,426,0,214,822,67,755,68423,920,0.3960,25245,25606,25718,13779,13573,4819,13295,-666666666,17378,8009,18,109
"Newton County, Indiana",14140,7134,7006,13782,28,20,35,12,81,182,4,178,13356,784,0.4151,24389,24804,25540,10518,31671,,5737,,9864,5342,18,111
"Noble County, Indiana",47497,23749,23748,45824,163,31,277,4,529,669,112,557,42846,4651,0.4012,22821,22895,23798,15596,15015,16113,13814,,31332,16840,18,113
"Ohio County, Indiana",6073,3004,3069,5927,112,0,0,0,6,28,0,28,6045,28,0.3841,23906,24009,24016,22421,19780,-666666666,-666666666,-666666666,,,18,115
"Orange County, Indiana",19756,9832,9924,19134,285,30,23,0,74,210,0,210,19526,230,0.4010,19023,19128,19255,4971,22867,10637,10778,-666666666,7922,10289,18,117
"Owen County, Indiana",21321,10790,10531,20835,128,84,81,0,62,131,0,131,21088,233,0.3954,21636,21748,21849,10846,10020,11112,13675,-666666666,10597,31963,18,119
"Parke County, Indiana",17200,8117,9083,16585,386,45,15,38,6,125,0,125,16976,224,0.4547,22131,22596,22768,9305,2339,26484,6313,,14000,13685,18,121
"Perry County, Indiana",19452,10440,9012,18475,585,6,55,0,75,256,56,200,19228,224,0.4017,21050,21909,21936,9227,1243,,13478,-666666666,17713,7120,18,123
"Pike County, Indiana",12733,6391,6342,12652,23,0,29,0,0,29,10,19,12724,9,0.3922,22974,22975,22991,,13435,-666666666,38724,-666666666,-666666666,14410,18,125
"Porter County, Indiana",165819,81521,84298,153218,5722,513,2352,43,1704,2267,321,1946,150890,14929,0.4145,29043,29730,30705,18628,18400,16083,33667,19649,19309,15113,18,127
"Posey County, Indiana",25641,12731,12910,24803,287,0,66,0,222,263,16,247,25380,261,0.4295,29426,29994,30023,11546,24009,-666666666,8591,-666666666,9130,4203,18,129
"Pulaski County, Indiana",13130,6637,6493,12727,54,7,51,0,66,225,0,225,12778,352,0.4202,21725,22024,22183,11977,19924,,5418,-666666666,13948,10838,18,131
"Putnam County, Indiana",37728,20016,17712,35218,1525,162,394,0,103,326,28,298,37081,647,0.3874,21541,22764,22972,5941,1260,20973,8567,-666666666,4439,5719,18,133
"Randolph County, Indiana",25801,12625,13176,25012,106,25,9,0,240,409,10,399,24993,808,0.4536,22386,22805,23031,11081,13035,18604,30344,-666666666,4747,9592,18,135
"Ripley County, Indiana",28601,13946,14655,27814,137,38,229,0,132,251,23,228,28141,460,0.3842,23206,23420,23526,14396,15972,42616,11190,-666666666,26820,9502,18,137
"Rush County, Indiana",17147,8507,8640,16704,161,0,27,0,75,180,17,163,16939,208,0.4176,23872,24024,24025,32765,16104,-666666666,,-666666666,10004,25979,18,139
"St. Joseph County, Indiana",266916,129133,137783,212899,34549,1085,5152,111,5309,7811,1220,6591,246288,20628,0.4591,24039,26484,27343,12725,13560,16386,29135,22400,13416,8707,18,141
"Scott County, Indiana",23897,11871,12026,23360,133,33,17,0,109,245,17,228,23504,393,0.4263,21575,21797,21915,11825,3013,,,-666666666,15497,10005,18,143
"Shelby County, Indiana",44428,21793,22635,41793,507,138,299,48,1276,367,27,340,42744,1684,0.3800,24200,24825,24823,14685,11276,5540,36369,,10768,14609,18,145
"Spencer County, Indiana",20893,10589,10304,20050,146,62,108,17,418,92,12,80,20348,545,0.3881,24346,24676,24744,11372,30351,32800,8124,,13287,6555,18,147
"Starke County, Indiana",23215,11383,11832,22283,109,23,96,0,326,378,160,218,22422,793,0.4163,20292,20602,20612,17130,6647,8739,10273,-666666666,17879,11262,18,149
"Steuben County, Indiana",34190,17273,16917,31736,235,94,485,8,42,1590,0,1590,33131,1059,0.4057,24345,25108,25564,11486,11360,13422,22898,,8771,12651,18,151
"Sullivan County, Indiana",21227,11588,9639,19885,1124,24,25,0,73,96,0,96,20881,346,0.4187,20193,21403,21621,8261,61,43963,,-666666666,17568,5709,18,153
"Switzerland County, Indiana",10514,5383,5131,10222,24,12,15,0,110,131,0,131,10350,164,0.3779,19255,19513,19534,13841,25350,,,-666666666,12943,4831,18,155
"Tippecanoe County, Indiana",178135,90913,87222,152528,7761,170,12244,51,1662,3719,518,3201,164238,13897,0.4735,23337,24430,25260,13919,14753,21759,20752,427,13123,9867,18,157
"Tipton County, Indiana",15688,7803,7885,15289,43,0,14,47,122,173,19,154,15300,388,0.3870,26350,26598,26908,10236,22228,-666666666,,28385,16932,11947,18,159
"Union County, Indiana",7382,3704,3678,7124,20,5,52,0,2,179,27,152,7350,32,0.3758,21805,21750,21737,13391,1250,,70862,-666666666,,10668,18,161
"Vanderburgh County, Indiana",180877,87455,93422,155829,16454,425,1845,136,1649,4539,281,4258,176613,4264,0.4528,24426,26152,26296,13722,13242,19726,28520,4304,9216,10609,18,163
"Vermillion County, Indiana",15952,7851,8101,15681,40,62,41,0,19,109,0,109,15792,160,0.4326,23475,23562,23703,9471,42185,10702,48393,-666666666,,6035,18,165
"Vigo County, Indiana",108264,54915,53349,94863,7044,253,2065,6,909,3124,281,2843,105629,2635,0.4639,21766,22404,22403,17109,13304,9360,50823,,10026,6676,18,167
"Wabash County, Indiana",32492,15805,16687,31189,176,269,122,0,414,322,42,280,31764,728,0.4066,21943,22260,22308,17274,514,21308,18838,-666666666,17915,9788,18,169
"Warren County, Indiana",8421,4242,4179,8236,9,23,13,0,56,84,0,84,8326,95,0.4106,28574,28851,28890,12955,,,,-666666666,6525,16498,18,171
"Warrick County, Indiana",60538,29770,30768,57344,905,130,1060,15,255,829,37,792,59531,1007,0.4137,30197,30364,30429,21167,16244,27147,50708,,20862,9264,18,173
"Washington County, Indiana",28017,13917,14100,27517,107,30,35,0,26,302,38,264,27659,358,0.4021,20317,20477,20542,12519,3417,,,-666666666,,13565,18,175
"Wayne County, Indiana",68360,33212,35148,61682,3151,23,681,0,842,1981,61,1920,66546,1814,0.4548,21130,21781,22013,8664,17254,5904,32333,-666666666,14219,6291,18,177
"Wells County, Indiana",27732,13613,14119,27057,88,53,147,0,98,289,4,285,27094,638,0.3968,24126,24390,24621,11955,8219,23066,26229,-666666666,9054,8511,18,179
"White County, Indiana",24485,12057,12428,23296,45,34,66,0,617,427,99,328,22677,1808,0.3928,24116,24558,25288,11687,2993,4541,16588,-666666666,17322,14817,18,181
"Whitley County, Indiana",33307,16726,16581,32235,108,125,86,0,240,513,14,499,32719,588,0.3867,26120,26529,26570,16242,13559,31589,14831,-666666666,10478,10966,18,183
"Adair County, Iowa",7543,3732,3811,7447,36,4,24,0,0,32,0,32,7429,114,0.3919,25657,25801,25735,28927,11833,14100,19908,-666666666,-666666666,13306,19,001
"Adams County, Iowa",3937,1953,1984,3837,32,1,8,0,9,50,7,43,3898,39,0.4079,25169,25585,25654,11810,9116,,,-666666666,,4812,19,003
"Allamakee County, Iowa",14152,7201,6951,13697,73,15,69,1,49,248,0,248,13383,769,0.4119,25622,25981,26852,10150,6766,26847,9277,,16759,17396,19,005
"Appanoose County, Iowa",12754,6314,6440,12452,42,5,31,0,13,211,10,201,12557,197,0.4358,22744,22953,23113,14236,10440,,33797,-666666666,30008,11278,19,007
"Audubon County, Iowa",5935,2873,3062,5810,12,35,13,0,0,65,11,54,5893,42,0.4745,30714,30969,31041,,,,4008,-666666666,-666666666,33769,19,009
"Benton County, Iowa",25895,12978,12917,25194,162,7,44,0,189,299,53,246,25581,314,0.3884,28177,28723,28808,11439,5564,28543,19455,-666666666,10047,7192,19,011
"Black Hawk County, Iowa",131947,64336,67611,113211,12200,290,2265,10,1201,2770,502,2268,126733,5214,0.4297,24771,26468,26775,14903,13007,13668,27950,,18556,8595,19,013
"Boone County, Iowa",26326,13185,13141,25635,270,85,136,0,14,186,0,186,25752,574,0.4099,27160,27557,27936,11709,2079,22602,30512,-666666666,20143,9028,19,015
"Bremer County, Iowa",24481,12096,12385,23710,268,40,135,70,60,198,50,148,24191,290,0.4223,29632,29996,30095,19299,16557,13328,33390,,53772,7719,19,017
"Buchanan County, Iowa",20947,10421,10526,20458,112,43,112,0,71,151,6,145,20669,278,0.4258,28193,28635,28729,14848,14421,5512,12523,-666666666,7017,6638,19,019
"Buena Vista County, Iowa",20460,10451,10009,16533,533,31,1270,315,1281,497,184,313,15535,4925,0.4282,23707,25728,28975,12589,9694,10955,21097,13184,13474,12024,19,021
"Butler County, Iowa",14966,7381,7585,14723,54,21,62,0,9,97,0,97,14812,154,0.4015,26327,26332,26438,13400,34435,,47347,-666666666,,11600,19,023
"Calhoun County, Iowa",9980,5091,4889,9617,147,59,21,0,22,114,36,78,9819,161,0.4511,26486,27087,27331,7776,7450,8420,24619,-666666666,13682,12473,19,025
"Carroll County, Iowa",20702,10103,10599,20090,293,33,27,6,117,136,79,57,20296,406,0.4263,26479,27001,27105,12405,11390,11458,16896,,11230,1492,19,027
"Cass County, Iowa",13694,6701,6993,13393,57,23,53,11,39,118,27,91,13384,310,0.4257,25555,25814,26073,11857,36435,8491,6300,,12308,6294,19,029
"Cedar County, Iowa",18434,9010,9424,17957,39,9,94,0,51,284,30,254,18120,314,0.3647,27566,27823,27929,16244,68077,,15781,-666666666,16110,12506,19,031
"Cerro Gordo County, Iowa",43707,21297,22410,41605,541,80,530,0,246,705,86,619,41923,1784,0.4442,27605,28160,28590,13762,13732,23146,27839,-666666666,17731,9256,19,033
"Cherokee County, Iowa",11982,5954,6028,11627,27,53,31,0,75,169,0,169,11639,343,0.4275,28150,28750,29263,8221,9830,9892,12994,-666666666,10340,6182,19,035
"Chickasaw County, Iowa",12329,6168,6161,12124,45,23,52,0,21,64,22,42,12046,283,0.4117,25137,25317,25557,15944,4776,29409,13575,-666666666,,6991,19,037
"Clarke County, Iowa",9284,4703,4581,8993,108,0,21,0,55,107,0,107,8254,1030,0.4584,23743,24239,25990,9049,1472,-666666666,37514,-666666666,12518,7643,19,039
"Clay County, Iowa",16555,8077,8478,15913,25,12,118,44,240,203,7,196,16069,486,0.4684,29138,29931,30057,13471,2936,5667,16882,8402,7663,8588,19,041
"Clayton County, Iowa",17900,8892,9008,17477,124,9,32,0,37,221,79,142,17578,322,0.4135,25853,26197,26403,11743,7462,12411,7294,-666666666,9222,14985,19,043
"Clinton County, Iowa",48663,23960,24703,45660,1406,199,318,0,280,800,75,725,47312,1351,0.4354,26751,27612,27772,15804,13432,15746,33952,-666666666,12571,5850,19,045
"Crawford County, Iowa",17259,8821,8438,15800,247,40,51,11,668,442,0,442,12696,4563,0.4329,23066,24094,28206,11078,7636,40858,5404,,13230,9658,19,047
"Dallas County, Iowa",72124,35472,36652,66408,801,66,2213,65,1094,1477,187,1290,67638,4486,0.4289,36677,37609,38432,20108,20056,17558,31179,,16701,16918,19,049
"Davis County, Iowa",8765,4314,4451,8641,14,7,37,0,0,66,0,66,8664,101,0.4558,23046,23156,23319,9382,,,38857,-666666666,-666666666,6617,19,051
"Decatur County, Iowa",8286,4136,4150,7915,144,51,62,9,4,101,9,92,8073,213,0.4379,19321,19815,20179,4040,6183,4641,12142,2533,,13332,19,053
"Delaware County, Iowa",17578,8780,8798,17299,35,2,10,0,7,225,10,215,17405,173,0.3824,26776,27084,27237,8202,4977,,,-666666666,39143,7365,19,055
"Des Moines County, Iowa",40265,19614,20651,36712,2386,79,140,0,99,849,3,846,39163,1102,0.4367,23724,24964,25144,17914,8662,12941,43394,-666666666,13601,11375,19,057
"Dickinson County, Iowa",16877,8425,8452,16461,23,43,46,34,31,239,49,190,16635,242,0.4394,32869,33231,33359,13028,37183,20842,10991,,,11008,19,059
"Dubuque County, Iowa",95166,46852,48314,89409,1503,75,1287,152,83,2657,68,2589,93196,1970,0.4156,26791,27659,27872,12938,10606,15912,21106,18463,7522,10899,19,061
"Emmet County, Iowa",10068,5015,5053,9571,113,56,11,16,49,252,8,244,9159,909,0.4824,28293,29070,30268,13831,7488,,1527,,16800,16227,19,063
"Fayette County, Iowa",20693,10373,10320,19958,156,91,121,0,30,337,51,286,20267,426,0.4061,24236,24916,25082,10625,6254,6308,8410,-666666666,10007,4092,19,065
"Floyd County, Iowa",16153,7992,8161,15428,409,0,88,6,49,173,13,160,15807,346,0.4438,25142,25741,26004,12661,10559,-666666666,31300,,16290,6332,19,067
"Franklin County, Iowa",10572,5366,5206,10020,85,3,22,0,316,126,49,77,9369,1203,0.4350,25719,26627,28302,8240,3392,,12191,-666666666,8406,14507,19,069
"Fremont County, Iowa",7200,3578,3622,7018,25,37,0,0,19,101,0,101,7016,184,0.4415,28656,29142,29478,10552,4488,14716,-666666666,-666666666,4126,10590,19,071
"Greene County, Iowa",9232,4482,4750,9052,4,3,36,2,0,135,1,134,9005,227,0.4549,27140,27522,27969,10035,10600,,16164,,-666666666,5535,19,073
"Grundy County, Iowa",12403,6101,6302,12182,26,11,37,0,39,108,11,97,12262,141,0.4243,30701,31031,31180,12013,,,7814,-666666666,17369,16101,19,075
"Guthrie County, Iowa",10794,5371,5423,10535,47,12,7,12,78,103,0,103,10572,222,0.4411,28746,29183,29416,11306,9206,24125,17929,,9262,8212,19,077
"Hamilton County, Iowa",15363,7579,7784,14400,71,0,315,0,379,198,7,191,14569,794,0.4387,25531,26052,26540,7352,19631,-666666666,36803,-666666666,5639,9865,19,079
"Hancock County, Iowa",11175,5583,5592,10829,51,30,33,0,100,132,8,124,10778,397,0.3911,27025,27566,28033,11172,4443,,18448,-666666666,13046,7567,19,081
"Hardin County, Iowa",17406,8639,8767,16754,159,41,148,0,107,197,27,170,16736,670,0.4017,25792,26442,26806,16038,1390,18088,8134,-666666666,23450,6340,19,083
"Harrison County, Iowa",14600,7246,7354,14261,10,42,44,3,33,207,62,145,14400,200,0.3926,26217,26494,26621,14838,20120,5174,27889,,29436,10631,19,085
"Henry County, Iowa",20197,10366,9831,18570,489,58,450,0,265,365,4,361,19329,868,0.4245,23679,24117,24725,14165,10284,10205,27943,-666666666,32314,9954,19,087
"Howard County, Iowa",9529,4694,4835,9371,37,1,25,0,8,87,0,87,9390,139,0.4208,25040,25327,25651,3896,,,25588,-666666666,,4407,19,089
"Humboldt County, Iowa",9731,4786,4945,9466,14,5,26,0,90,130,0,130,9367,364,0.4176,26592,27098,27517,11729,,,24235,-666666666,8730,6083,19,091
"Ida County, Iowa",7085,3570,3515,6946,33,17,21,0,17,51,3,48,6958,127,0.4393,26712,26946,27167,14240,10176,17035,19810,-666666666,17012,14804,19,093
"Iowa County, Iowa",16316,8098,8218,16024,107,4,34,15,5,127,0,127,15963,353,0.3759,28249,28641,28850,17743,6670,,338,,,7858,19,095
"Jackson County, Iowa",19656,9760,9896,19156,41,14,66,92,8,279,0,279,19404,252,0.4241,24988,25325,25532,9192,18524,14207,17523,14973,,8863,19,097
"Jasper County, Iowa",36715,18891,17824,35336,513,173,174,13,23,483,38,445,36121,594,0.4067,25825,26403,26631,4769,9893,5211,28316,,8135,7475,19,099
"Jefferson County, Iowa",17102,8966,8136,14806,261,19,1512,0,179,325,27,298,16641,461,0.5057,27408,29976,30677,7242,19484,,10644,-666666666,1238,7974,19,101
"Johnson County, Iowa",136802,68238,68564,116059,7021,316,7855,224,2371,2956,166,2790,129756,7046,0.4837,31131,33119,33436,20445,15894,19571,27204,29286,15101,13915,19,103
"Jones County, Iowa",20607,10717,9890,19698,435,125,90,0,143,116,2,114,20300,307,0.4122,26671,27687,27781,8168,1468,4680,11144,-666666666,5675,10324,19,105
"Keokuk County, Iowa",10361,5197,5164,10170,9,0,20,5,28,129,0,129,10225,136,0.4011,23544,23761,23822,17507,,-666666666,,,24511,9054,19,107
"Kossuth County, Iowa",15347,7605,7742,15030,15,9,57,0,42,194,14,180,15086,261,0.4323,29229,29521,29854,9839,10160,21244,31065,-666666666,21731,9575,19,109
"Lee County, Iowa",35552,17824,17728,33202,1071,44,187,0,143,905,110,795,34398,1154,0.4162,22960,23640,23415,26609,13655,9139,31063,-666666666,20434,8406,19,111
"Linn County, Iowa",214927,105930,108997,193587,9407,547,4157,15,2142,5072,279,4793,208898,6029,0.4251,30949,32489,32755,15177,15369,24273,29709,,15951,9096,19,113
"Louisa County, Iowa",11305,5753,5552,10387,92,12,206,10,432,166,14,152,9484,1821,0.4060,25411,26501,28243,13757,15450,,16083,,12122,7981,19,115
"Lucas County, Iowa",8785,4405,4380,8637,13,42,13,0,0,80,0,80,8728,57,0.4173,22060,22268,22326,13546,8538,14983,,-666666666,-666666666,7734,19,117
"Lyon County, Iowa",11680,5887,5793,11421,3,49,29,2,102,74,6,68,11413,267,0.4070,25578,25889,25922,16998,,26445,3717,,12206,4946,19,119
"Madison County, Iowa",15629,7806,7823,15277,69,15,96,0,39,133,0,133,15412,217,0.4186,27848,28072,28221,17274,3323,33967,15053,-666666666,45464,18268,19,121
"Mahaska County, Iowa",22420,11250,11170,21389,312,39,164,7,148,361,2,359,22022,398,0.4392,24875,25282,25370,13653,16409,6151,42967,,17072,5363,19,123
"Marion County, Iowa",33308,16479,16829,32138,209,84,409,0,65,403,14,389,32734,574,0.4013,26161,26601,26812,11518,17190,10048,15065,-666666666,5420,13677,19,125
"Marshall County, Iowa",40922,20592,20330,35280,652,146,1003,0,3198,643,81,562,33287,7635,0.3965,24549,26382,28526,11848,15167,12445,13738,-666666666,13734,6927,19,127
"Mills County, Iowa",14946,7438,7508,14556,77,9,15,0,18,271,12,259,14563,383,0.3669,27942,28327,28654,16453,9473,27000,,-666666666,25056,12560,19,129
"Mitchell County, Iowa",10744,5319,5425,10577,32,0,29,31,11,64,4,60,10636,108,0.3940,24629,24842,24999,8094,1169,-666666666,1686,,,7145,19,131
"Monona County, Iowa",9149,4562,4587,8841,32,19,8,0,19,230,40,190,9008,141,0.4301,24645,24917,24949,15150,23194,12821,19150,-666666666,,15973,19,133
"Monroe County, Iowa",8019,4006,4013,7927,16,5,13,0,23,35,0,35,7979,40,0.3929,23983,24047,24011,35230,3225,48300,41769,-666666666,,,19,135
"Montgomery County, Iowa",10549,5146,5403,10228,0,0,3,0,37,281,34,247,10211,338,0.4326,23342,23716,23993,9890,-666666666,-666666666,,-666666666,,10066,19,137
"Muscatine County, Iowa",42857,21235,21622,39584,646,153,495,14,1261,704,146,558,35735,7122,0.4067,25007,25764,27721,14192,11281,36784,21932,,15831,11162,19,139
"O'Brien County, Iowa",14173,7044,7129,13470,42,33,106,0,347,175,26,149,13598,575,0.4774,30213,31298,31601,7710,1964,2185,14186,-666666666,9588,9403,19,141
"Osceola County, Iowa",6279,3117,3162,6033,25,23,22,0,146,30,0,30,5871,408,0.3800,25239,25576,26275,12455,9264,,,-666666666,16540,35453,19,143
"Page County, Iowa",15737,8045,7692,14844,265,108,180,0,79,261,20,241,15290,447,0.4197,23630,24301,24558,11922,9885,9767,22103,-666666666,6467,11414,19,145
"Palo Alto County, Iowa",9263,4681,4582,9049,88,9,53,0,0,64,7,57,9089,174,0.4275,26111,26344,26705,7849,23355,,10009,-666666666,-666666666,7238,19,147
"Plymouth County, Iowa",24899,12295,12604,24056,65,40,82,83,252,321,69,252,24040,859,0.3959,27848,28350,28742,10737,,104973,14911,1648,12191,7313,19,149
"Pocahontas County, Iowa",7191,3594,3597,6970,95,3,4,7,34,78,11,67,6978,213,0.4395,26144,26639,27005,10597,11014,,,,28206,2117,19,151
"Polk County, Iowa",445136,218905,226231,379579,27429,1073,17234,285,8111,11425,1237,10188,410301,34835,0.4392,30863,33337,34591,14128,14978,12442,25205,21422,13340,9737,19,153
"Pottawattamie County, Iowa",93153,45790,47363,88114,1054,341,598,5,1114,1927,108,1819,86746,6407,0.4328,26821,27490,27955,20157,11815,16226,28572,,21211,8979,19,155
"Poweshiek County, Iowa",18765,8969,9796,17786,202,25,396,29,121,206,0,206,18262,503,0.4310,26855,27713,28145,5463,8076,6448,15420,,12938,5834,19,157
"Ringgold County, Iowa",5082,2479,2603,4970,10,31,31,0,1,39,0,39,5012,70,0.4542,24553,24655,24862,8551,,12697,40094,-666666666,,,19,159
"Sac County, Iowa",10162,5004,5158,9966,81,2,19,4,30,60,10,50,9918,244,0.4162,27224,27486,27820,11627,8604,,,,17670,7900,19,161
"Scott County, Iowa",168714,82789,85925,145421,13293,507,3641,9,1688,4155,509,3646,158651,10063,0.4505,29243,31181,31967,16164,16936,16646,23277,,19782,11428,19,163
"Shelby County, Iowa",12034,5877,6157,11621,10,16,55,0,168,164,35,129,11788,246,0.4338,27178,27551,27613,12776,20040,8819,9778,-666666666,15921,20321,19,165
"Sioux County, Iowa",34261,17270,16991,31754,149,71,271,5,1590,421,182,239,31060,3201,0.4035,25343,26564,27372,9660,6697,20328,11838,,10068,7048,19,167
"Story County, Iowa",91939,47698,44241,81347,2250,142,5707,30,451,2012,115,1897,89076,2863,0.4594,26113,27239,27456,17459,18846,14139,19669,,16336,10192,19,169
"Tama County, Iowa",17568,8666,8902,15738,103,1244,50,5,141,287,61,226,16195,1373,0.4119,26247,27780,29106,10203,13317,13588,10942,,17410,8757,19,171
"Taylor County, Iowa",6225,3131,3094,6019,20,6,21,0,83,76,0,76,5793,432,0.4160,24044,24512,25130,11641,32320,,12424,-666666666,9924,4504,19,173
"Union County, Iowa",12554,6082,6472,12249,166,32,18,0,1,88,0,88,12271,283,0.4166,23647,23933,23980,21703,4809,62838,9322,-666666666,,8336,19,175
"Van Buren County, Iowa",7487,3795,3692,7359,9,20,10,0,7,82,0,82,7394,93,0.4011,23045,23243,23313,16406,244,10460,,-666666666,,14337,19,177
"Wapello County, Iowa",35406,17395,18011,32875,554,46,329,0,1071,531,15,516,32000,3406,0.4297,21909,22474,23339,12318,12406,24541,22569,-666666666,15849,8440,19,179
"Warren County, Iowa",47058,22999,24059,45614,283,43,190,36,170,722,64,658,46018,1040,0.3781,29449,29573,29829,14942,9006,19351,25674,,21154,34342,19,181
"Washington County, Iowa",21906,10843,11063,20888,185,7,99,11,390,326,60,266,20729,1177,0.3863,27051,27570,28085,12350,17357,,35475,,14092,12627,19,183
"Wayne County, Iowa",6385,3077,3308,6247,14,15,23,0,0,86,0,86,6328,57,0.4277,22433,22703,22904,860,14193,26927,8543,-666666666,-666666666,7121,19,185
"Webster County, Iowa",37399,19170,18229,34453,1556,134,308,0,271,677,17,660,35872,1527,0.4518,24213,25361,25807,10034,9040,16781,29930,-666666666,11152,4731,19,187
"Winnebago County, Iowa",10645,5210,5435,10238,79,69,67,1,36,155,58,97,10264,381,0.4093,25387,25715,26082,12903,8251,14084,21191,,32219,17648,19,189
"Winneshiek County, Iowa",20957,10364,10593,20288,184,66,207,0,49,163,59,104,20536,421,0.3898,25709,25574,25527,23865,13262,16211,71991,-666666666,18453,3731,19,191
"Woodbury County, Iowa",102372,50449,51923,86770,2896,1872,2596,0,5319,2919,500,2419,87480,14892,0.4358,23221,24974,26360,11869,15651,18332,17493,-666666666,12377,6629,19,193
"Worth County, Iowa",7567,3771,3796,7395,44,5,14,0,13,96,16,80,7386,181,0.3990,24886,25211,25458,12792,2882,,16464,-666666666,,12715,19,195
"Wright County, Iowa",13007,6471,6536,12505,44,34,64,10,189,161,39,122,11729,1278,0.4556,25964,26331,27652,11750,11884,,48109,,16431,10122,19,197
"Allen County, Kansas",13212,6382,6830,12282,258,89,72,12,95,404,19,385,12810,402,0.4126,20105,20791,20810,15770,17793,12642,4432,,14305,7118,20,001
"Anderson County, Kansas",7962,4038,3924,7607,16,30,0,0,0,309,33,276,7904,58,0.4188,22122,22335,22376,4345,7319,18593,-666666666,-666666666,-666666666,17980,20,003
"Atchison County, Kansas",16737,8078,8659,15217,747,103,39,12,65,554,19,535,16296,441,0.4513,22446,23546,23760,12994,15591,27168,8933,,4797,3905,20,005
"Barber County, Kansas",4898,2482,2416,4736,11,20,12,0,19,100,10,90,4754,144,0.4369,27785,27972,28138,22161,11091,,20967,-666666666,22495,21297,20,007
"Barton County, Kansas",27566,13641,13925,25151,526,71,48,8,1169,593,16,577,23751,3815,0.4729,25750,26650,28650,7466,11153,170679,43327,,8567,15536,20,009
"Bourbon County, Kansas",14913,7320,7593,13916,581,62,114,0,20,220,0,220,14583,330,0.4414,20798,21370,21649,9661,14593,23558,10631,-666666666,3425,7043,20,011
"Brown County, Kansas",9926,4804,5122,8526,171,921,56,7,14,231,0,231,9574,352,0.4367,22284,23190,23615,10769,21926,17670,18346,16143,5179,9661,20,013
"Butler County, Kansas",65927,33152,32775,61638,1176,504,630,7,426,1546,199,1347,63147,2780,0.4134,27431,28304,28534,19823,10142,20201,23097,,18913,12206,20,015
"Chase County, Kansas",2746,1371,1375,2633,34,42,0,0,13,24,0,24,2642,104,0.4255,23653,24202,24708,9750,6391,11931,-666666666,-666666666,13115,14154,20,017
"Chautauqua County, Kansas",3572,1832,1740,3198,19,194,0,0,26,135,0,135,3474,98,0.4511,23325,24313,24303,14908,,15921,-666666666,-666666666,7238,15921,20,019
"Cherokee County, Kansas",21179,10481,10698,19252,103,890,51,11,18,854,6,848,20721,458,0.3919,19849,20298,20469,12113,25757,15581,22333,,10050,13304,20,021
"Cheyenne County, Kansas",2695,1359,1336,2625,0,0,31,0,18,21,0,21,2528,167,0.3896,24309,24553,25414,11880,-666666666,-666666666,14181,-666666666,,18133,20,023
"Clark County, Kansas",2170,1065,1105,1991,17,27,13,6,41,75,0,75,1903,267,0.4200,25116,25785,27463,11237,21394,756,,,3305,34980,20,025
"Clay County, Kansas",8460,4147,4313,8177,77,19,50,0,22,115,2,113,8255,205,0.4236,26143,26671,26928,11111,6399,,8994,-666666666,,14245,20,027
"Cloud County, Kansas",9414,4611,4803,9123,32,19,80,0,31,129,0,129,9113,301,0.3847,21265,21697,22028,10243,2263,19126,13169,-666666666,5106,4692,20,029
"Coffey County, Kansas",8493,4270,4223,8209,47,85,42,8,1,101,8,93,8293,200,0.4142,29044,29297,29775,10042,7623,20895,4476,,,34738,20,031
"Comanche County, Kansas",1911,940,971,1847,0,32,6,0,16,10,0,10,1827,84,0.3661,22107,22259,21562,34542,-666666666,,,-666666666,,,20,033
"Cowley County, Kansas",36201,18165,18036,31518,1081,995,640,5,893,1069,85,984,32694,3507,0.4365,21848,23279,24035,11448,13181,11329,14324,,13233,9753,20,035
"Crawford County, Kansas",39277,19570,19707,36317,782,259,581,0,180,1158,11,1147,37384,1893,0.4613,20854,21469,21961,11226,14659,21965,15665,-666666666,9736,9827,20,037
"Decatur County, Kansas",2915,1470,1445,2823,12,14,0,6,1,59,27,32,2856,59,0.5123,28094,28520,28594,15646,13408,34457,-666666666,,,10346,20,039
"Dickinson County, Kansas",19641,9705,9936,18636,60,78,70,0,134,663,126,537,18800,841,0.4085,24754,25478,25801,15355,16198,39081,6487,-666666666,14306,7551,20,041
"Doniphan County, Kansas",7904,4022,3882,7265,280,92,29,19,8,211,4,207,7707,197,0.3928,23246,24400,24692,8139,8527,24452,345,,,6798,20,043
"Douglas County, Kansas",113703,56775,56928,96047,4463,2432,4768,19,753,5221,384,4837,107463,6240,0.4653,26790,28398,28873,17531,19801,13587,22668,2195,28987,12868,20,045
"Edwards County, Kansas",3006,1570,1436,2818,32,5,17,0,107,27,5,22,2434,572,0.4084,24899,25730,28146,13913,3188,31940,29335,-666666666,13766,3896,20,047
"Elk County, Kansas",2734,1347,1387,2586,16,23,34,0,16,59,9,50,2643,91,0.3782,21693,21969,22406,7802,,9630,36250,-666666666,28325,9986,20,049
"Ellis County, Kansas",28878,14331,14547,27089,294,57,390,36,541,471,80,391,27366,1512,0.4580,25310,26336,26827,10180,15763,26089,8819,,7783,7718,20,051
"Ellsworth County, Kansas",6443,3632,2811,5847,260,75,6,0,78,177,13,164,6076,367,0.4236,23458,25284,26023,9252,1955,4764,,-666666666,14153,7528,20,053
"Finney County, Kansas",37099,18890,18209,29341,871,301,1364,0,4001,1221,489,732,19444,17655,0.4164,22179,24109,31227,14340,15098,16590,20197,-666666666,14396,9948,20,055
"Ford County, Kansas",34604,17854,16750,30298,765,148,454,6,2040,893,190,703,16546,18058,0.4187,21269,22058,32411,12527,11442,13558,37908,,13048,14502,20,057
"Franklin County, Kansas",25834,12813,13021,23989,326,139,106,0,594,680,71,609,24848,986,0.4070,23980,24927,25025,12904,12321,14873,8847,-666666666,10172,12434,20,059
"Geary County, Kansas",36458,18745,17713,25289,6102,179,1072,288,449,3079,380,2699,31430,5028,0.4030,21318,22987,24654,12467,20996,34051,20825,9649,12436,10058,20,061
"Gove County, Kansas",2786,1400,1386,2702,29,3,2,0,4,46,3,43,2764,22,0.4389,27571,27836,27876,23668,32324,43733,,-666666666,37075,8250,20,063
"Graham County, Kansas",2602,1276,1326,2391,128,6,19,0,0,58,0,58,2530,72,0.4645,28290,29414,30150,6442,12380,,30074,-666666666,-666666666,12238,20,065
"Grant County, Kansas",7856,3994,3862,6103,2,103,0,1,1455,192,63,129,4304,3552,0.4565,26386,29664,35042,16838,,18969,-666666666,,14345,17661,20,067
"Gray County, Kansas",6043,2956,3087,5919,0,0,7,0,83,34,9,25,5168,875,0.3773,25585,25647,27359,14897,-666666666,-666666666,,-666666666,18031,23594,20,069
"Greeley County, Kansas",1223,586,637,1071,10,0,2,0,108,32,4,28,977,246,0.3977,25766,28590,30661,9654,16290,-666666666,,-666666666,4484,7263,20,071
"Greenwood County, Kansas",6495,3194,3301,6232,12,22,2,0,29,198,0,198,6259,236,0.4606,24123,24615,24991,12470,4192,22627,,-666666666,,13135,20,073
"Hamilton County, Kansas",2632,1369,1263,2361,1,15,0,0,217,38,2,36,1780,852,0.4757,23360,24039,29649,10785,,20820,-666666666,-666666666,17158,17979,20,075
"Harper County, Kansas",5906,2973,2933,5666,10,78,3,3,51,95,3,92,5556,350,0.4623,24913,25375,26092,12119,7640,20705,,,17418,6184,20,077
"Harvey County, Kansas",34797,16745,18052,32201,514,207,240,0,833,802,14,788,30935,3862,0.4023,23846,24610,25730,13409,18002,10828,18598,-666666666,13524,12535,20,079
"Haskell County, Kansas",4198,2113,2085,3570,0,78,45,1,435,69,18,51,3022,1176,0.3984,25213,26566,29804,12515,-666666666,13624,73511,,13146,13235,20,081
"Hodgeman County, Kansas",1941,976,965,1915,0,0,0,0,0,26,4,22,1750,191,0.4339,30474,30856,32369,16526,-666666666,-666666666,-666666666,-666666666,-666666666,2323,20,083
"Jackson County, Kansas",13464,6738,6726,11798,94,887,67,15,3,600,31,569,12917,547,0.3844,25030,26326,26546,15693,19672,17127,12958,19187,,13667,20,085
"Jefferson County, Kansas",18932,9633,9299,18134,85,141,4,0,26,542,33,509,18511,421,0.3645,26259,26603,26672,16831,29348,25628,,-666666666,19346,14966,20,087
"Jewell County, Kansas",3060,1569,1491,2971,5,4,17,0,18,45,0,45,2991,69,0.4085,23393,23905,24127,6164,,32550,,-666666666,2606,4564,20,089
"Johnson County, Kansas",560025,273931,286094,487931,24670,1686,24266,186,5641,15645,1550,14095,519271,40754,0.4461,39447,41295,42906,18625,24566,25650,38722,34688,19385,15183,20,091
"Kearny County, Kansas",3950,2081,1869,3422,34,30,0,0,340,124,15,109,2792,1158,0.3864,23719,25203,28128,13862,29059,9840,-666666666,-666666666,12188,16266,20,093
"Kingman County, Kansas",7820,3903,3917,7601,22,68,0,0,15,114,0,114,7602,218,0.3939,24892,25066,25527,10123,5600,37291,-666666666,-666666666,35067,8305,20,095
"Kiowa County, Kansas",2529,1234,1295,2440,17,15,16,0,1,40,0,40,2397,132,0.4387,22301,22700,23587,7184,8859,19427,14606,-666666666,,8330,20,097
"Labette County, Kansas",21225,10569,10656,18741,717,260,69,4,111,1323,9,1314,20332,893,0.4069,20506,21485,21879,8888,17426,20587,18358,26825,8695,9382,20,099
"Lane County, Kansas",1652,808,844,1569,7,17,0,0,45,14,0,14,1528,124,0.4444,31892,32947,33356,15417,,9124,-666666666,-666666666,6578,20221,20,101
"Leavenworth County, Kansas",77687,41440,36247,65238,6461,666,1219,99,857,3147,352,2795,72751,4936,0.3991,26902,28959,29649,14978,18575,16328,22831,41183,16244,7624,20,103
"Lincoln County, Kansas",3180,1568,1612,3109,20,13,24,0,0,14,0,14,3104,76,0.4314,24509,24902,25213,11430,,,9813,-666666666,-666666666,5393,20,105
"Linn County, Kansas",9551,4728,4823,9203,66,92,24,0,24,142,4,138,9348,203,0.4602,25525,25572,25867,11362,50939,24326,4750,-666666666,,13374,20,107
"Logan County, Kansas",2783,1404,1379,2676,0,4,71,0,9,23,0,23,2670,113,0.4445,27296,27738,28564,8381,-666666666,,17131,-666666666,,10478,20,109
"Lyon County, Kansas",33510,16312,17198,29829,705,96,718,0,942,1220,71,1149,26692,6818,0.4361,20272,21218,23361,11831,16198,18365,8907,-666666666,11845,12850,20,111
"McPherson County, Kansas",29308,14574,14734,27915,276,194,249,0,288,386,10,376,28214,1094,0.4031,27979,28417,28529,25688,14440,18225,27114,-666666666,31106,9106,20,113
"Marion County, Kansas",12401,6133,6268,11913,143,115,37,0,17,176,18,158,12058,343,0.4074,23152,23629,23974,9799,6254,9865,13565,-666666666,1894,17297,20,115
"Marshall County, Kansas",10042,4987,5055,9742,35,22,50,0,59,134,0,134,9823,219,0.4475,25828,26290,26489,10904,26026,,28040,-666666666,5112,3907,20,117
"Meade County, Kansas",4444,2273,2171,3943,60,8,48,0,362,23,14,9,3827,617,0.3505,22727,23192,23861,15165,25985,,21188,-666666666,16310,,20,119
"Miami County, Kansas",32765,16268,16497,31383,411,219,74,0,38,640,32,608,31835,930,0.4088,28822,29329,29539,20705,11195,18506,42074,-666666666,2826,18844,20,121
"Mitchell County, Kansas",6324,3219,3105,6177,10,42,44,0,27,24,0,24,6214,110,0.4478,27271,27631,27944,8408,4410,14879,7380,-666666666,23011,7200,20,123
"Montgomery County, Kansas",34602,17068,17534,29451,1850,793,270,109,254,1875,12,1863,32624,1978,0.4329,20912,22013,22556,12296,12761,21426,12440,9772,17243,13797,20,125
"Morris County, Kansas",5808,2867,2941,5589,15,33,26,0,45,100,9,91,5571,237,0.3837,24558,24885,25138,17092,8853,5109,9412,-666666666,13551,23971,20,127
"Morton County, Kansas",3159,1615,1544,2583,52,10,31,0,385,98,29,69,2526,633,0.4270,23486,22425,23273,16205,25244,,199287,-666666666,19094,12878,20,129
"Nemaha County, Kansas",10136,5077,5059,9875,93,43,17,1,14,93,0,93,9988,148,0.4313,25319,25616,25634,22420,12933,8565,23441,,,17023,20,131
"Neosho County, Kansas",16453,8107,8346,15608,165,126,12,6,72,464,0,464,15686,767,0.4300,22474,22850,23436,10633,9871,14749,6042,,27713,16192,20,133
"Ness County, Kansas",3104,1523,1581,3007,17,3,0,0,44,33,9,24,2813,291,0.4449,29713,30318,32332,8309,11653,,-666666666,-666666666,16455,2676,20,135
"Norton County, Kansas",5628,3130,2498,5120,158,12,37,19,76,206,45,161,5358,270,0.3935,23323,25125,25583,7442,2617,6108,-666666666,,12007,3570,20,137
"Osage County, Kansas",16165,8046,8119,15592,28,158,59,0,38,290,30,260,15775,390,0.3993,24199,24769,24985,10976,4904,12231,8986,-666666666,9784,6919,20,139
"Osborne County, Kansas",3811,1890,1921,3725,11,18,36,0,7,14,1,13,3755,56,0.4945,27104,27235,27421,11639,11682,31783,24675,-666666666,,17971,20,141
"Ottawa County, Kansas",6075,3179,2896,5896,10,11,0,0,19,139,0,139,5921,154,0.3997,27899,28455,28788,14492,,7673,-666666666,-666666666,18411,8809,20,143
"Pawnee County, Kansas",6959,4014,2945,6304,319,21,0,0,106,209,10,199,6461,498,0.4107,22191,23513,24146,11660,5792,6595,-666666666,-666666666,9440,15377,20,145
"Phillips County, Kansas",5560,2741,2819,5352,9,17,18,1,26,137,17,120,5413,147,0.4124,25146,25688,25954,13054,6000,11824,19628,,,9614,20,147
"Pottawatomie County, Kansas",22338,11058,11280,20991,327,124,184,0,181,531,28,503,21249,1089,0.3880,25469,25873,26309,14719,30006,35819,17565,-666666666,8461,12814,20,149
"Pratt County, Kansas",9758,4881,4877,9284,77,163,5,5,62,162,18,144,9153,605,0.4534,26807,27530,28384,11620,25639,5193,,,4026,16345,20,151
"Rawlins County, Kansas",2553,1288,1265,2490,12,11,2,0,14,24,0,24,2450,103,0.4269,27719,28147,28802,10952,14217,6845,,-666666666,,15504,20,153
"Reno County, Kansas",64223,32180,32043,58596,1814,382,367,37,1198,1829,325,1504,58765,5458,0.4241,23378,24512,25173,13924,10310,17149,21184,4024,15551,7266,20,155
"Republic County, Kansas",4868,2388,2480,4744,0,9,29,0,0,86,22,64,4801,67,0.4227,25642,26134,26215,5575,-666666666,9500,12545,-666666666,-666666666,4629,20,157
"Rice County, Kansas",10050,4972,5078,9155,121,111,40,24,354,245,32,213,8976,1074,0.4356,23633,24595,25358,13815,23561,8143,8288,12329,17075,7812,20,159
"Riley County, Kansas",74478,39458,35020,62412,4752,397,3423,287,509,2698,287,2411,68913,5565,0.4892,23872,25444,26314,14144,18456,23028,14294,7756,17264,12287,20,161
"Rooks County, Kansas",5174,2572,2602,4970,23,20,49,1,15,96,0,96,5129,45,0.4201,23829,23950,23928,24529,2630,15875,33790,,32793,16990,20,163
"Rush County, Kansas",3222,1598,1624,3118,29,21,0,0,3,51,0,51,3188,34,0.4099,24642,25084,25220,10847,,11729,-666666666,-666666666,,15127,20,165
"Russell County, Kansas",6959,3518,3441,6653,143,40,0,7,1,115,0,115,6808,151,0.4793,26641,27068,27378,9437,23960,16648,-666666666,,,9945,20,167
"Saline County, Kansas",55793,27569,28224,49138,1606,264,1344,29,1531,1881,218,1663,50021,5772,0.4460,25577,27053,28454,10766,18790,7614,22512,,12554,8458,20,169
"Scott County, Kansas",4965,2375,2590,4819,0,50,20,0,20,56,18,38,4112,853,0.3579,26991,26321,29272,12512,-666666666,79002,,-666666666,,45966,20,171
"Sedgwick County, Kansas",503788,249267,254521,399555,46296,4247,20633,67,12765,20225,2121,18104,435933,67855,0.4468,25897,28211,30325,13543,16908,19789,21918,33825,14826,13045,20,173
"Seward County, Kansas",23319,11915,11404,13869,1091,185,658,0,6632,884,529,355,9816,13503,0.3957,19872,23650,31602,12706,20533,23767,23122,-666666666,13094,7413,20,175
"Shawnee County, Kansas",178600,86533,92067,146429,14338,1584,2036,49,4834,9330,1078,8252,158477,20123,0.4468,26682,28912,30334,12993,17582,22813,30222,36778,14437,11841,20,177
"Sheridan County, Kansas",2540,1323,1217,2436,8,44,0,0,3,49,0,49,2451,89,0.3994,27102,27916,28520,12019,,,-666666666,-666666666,,,20,179
"Sherman County, Kansas",6078,3008,3070,5667,130,0,21,0,203,57,14,43,5366,712,0.4024,20944,21495,22312,11306,20922,-666666666,,-666666666,7580,8175,20,181
"Smith County, Kansas",3779,1884,1895,3652,20,0,7,0,3,97,7,90,3744,35,0.4842,26964,27803,27907,9091,1940,-666666666,,-666666666,,2864,20,183
"Stafford County, Kansas",4363,2197,2166,4141,38,27,11,0,79,67,25,42,3802,561,0.4071,24169,24577,26497,11351,7774,24093,25964,-666666666,15968,17669,20,185
"Stanton County, Kansas",2187,1036,1151,1520,21,9,15,0,481,141,10,131,1392,795,0.4029,22623,27580,29183,12806,23629,,36947,-666666666,12334,2250,20,187
"Stevens County, Kansas",5744,2864,2880,4443,22,40,28,7,1040,164,0,164,3829,1915,0.4438,25126,29040,31947,11920,26473,21088,13711,,9642,21102,20,189
"Sumner County, Kansas",23763,11759,12004,22466,47,450,44,31,146,579,105,474,22584,1179,0.4070,23670,24116,24549,16296,10896,16491,1884,,32616,13378,20,191
"Thomas County, Kansas",7947,3883,4064,7650,123,21,10,6,36,101,18,83,7547,400,0.4890,28364,28889,29724,11211,9423,10352,12020,,23692,18396,20,193
"Trego County, Kansas",2959,1465,1494,2844,12,25,8,0,16,54,0,54,2915,44,0.3833,24860,25540,25531,7550,2517,21356,,-666666666,12756,1181,20,195
"Wabaunsee County, Kansas",7034,3540,3494,6796,40,4,11,0,10,173,23,150,6814,220,0.3515,24980,25009,25258,21735,53193,,11382,-666666666,,17865,20,197
"Wallace County, Kansas",1569,806,763,1556,2,7,3,0,0,1,0,1,1506,63,0.4914,28254,28369,28825,15195,,7529,,-666666666,-666666666,,20,199
"Washington County, Kansas",5717,2883,2834,5583,35,18,13,0,10,58,9,49,5552,165,0.4020,22910,23189,23533,11752,15189,18317,8308,-666666666,28370,4467,20,201
"Wichita County, Kansas",2220,1169,1051,2133,0,17,4,0,48,18,0,18,1664,556,0.3675,25191,25446,29716,11626,-666666666,25635,19125,-666666666,12890,28650,20,203
"Wilson County, Kansas",9177,4583,4594,8717,13,59,63,0,63,262,0,262,8937,240,0.4033,20235,20551,20529,16563,54069,20422,31767,-666666666,4281,9063,20,205
"Woodson County, Kansas",3246,1624,1622,3099,19,13,8,0,4,103,3,100,3167,79,0.4480,22912,23407,23630,4087,,14815,,-666666666,,9685,20,207
"Wyandotte County, Kansas",159466,78574,80892,98930,39631,1144,4934,210,9757,4860,1120,3740,116665,42801,0.4299,18753,20745,25083,11592,16804,12903,13276,4415,13977,11260,20,209
"Adair County, Kentucky",19032,9452,9580,18061,520,12,48,0,103,288,11,277,18690,342,0.4393,17772,18066,18194,8961,15288,,3302,-666666666,11036,9177,21,001
"Allen County, Kentucky",20219,9911,10308,19555,375,16,33,0,147,93,0,93,19880,339,0.4285,19651,19781,19931,8714,16637,,,-666666666,14719,13474,21,003
"Anderson County, Kentucky",21664,10554,11110,20721,521,5,54,0,79,284,31,253,21348,316,0.3720,23566,24031,24181,11157,16510,,1985,-666666666,,9630,21,005
"Ballard County, Kentucky",8274,4137,4137,7840,293,25,53,0,0,63,6,57,8173,101,0.4473,23417,24217,24256,19804,10587,7036,4389,-666666666,-666666666,6057,21,007
"Barren County, Kentucky",42691,20675,22016,39908,1861,130,218,3,127,444,31,413,41487,1204,0.4423,19907,20275,20488,11371,15283,18832,28610,,4813,6709,21,009
"Bath County, Kentucky",11870,5932,5938,11434,226,0,0,0,106,104,0,104,11706,164,0.4921,17137,17200,17283,17160,15373,-666666666,-666666666,-666666666,25957,5028,21,011
"Bell County, Kentucky",28234,13648,14586,26780,734,58,171,0,68,423,13,410,28119,115,0.4729,14657,14853,14815,16846,12106,6586,19788,-666666666,8140,6752,21,013
"Boone County, Kentucky",123030,60790,62240,113086,3760,356,2901,0,878,2049,109,1940,118352,4678,0.4001,29656,29594,30030,20868,23265,102124,43738,-666666666,13653,19116,21,015
"Bourbon County, Kentucky",19972,9886,10086,17990,1438,26,10,0,354,154,10,144,18612,1360,0.4571,23267,24378,25053,11060,15492,,,-666666666,7299,6418,21,017
"Boyd County, Kentucky",49242,24321,24921,46653,1313,144,208,0,100,824,44,780,48496,746,0.4949,24446,25071,25065,20592,10804,5107,48109,-666666666,8132,10233,21,019
"Boyle County, Kentucky",29150,14434,14716,25992,2009,20,236,0,118,775,11,764,28286,864,0.4685,22394,23064,23484,8656,15483,4455,54604,-666666666,4131,11275,21,021
"Bracken County, Kentucky",8459,4227,4232,8382,1,0,0,0,59,17,0,17,8340,119,0.4310,21742,21827,21910,7198,,-666666666,-666666666,-666666666,4003,,21,023
"Breathitt County, Kentucky",13663,6867,6796,13379,69,23,53,14,5,120,12,108,13596,67,0.4604,15574,15555,15581,7049,2242,34213,44842,,,10239,21,025
"Breckinridge County, Kentucky",20076,9950,10126,19214,508,0,26,0,64,264,10,254,19849,227,0.4026,18151,18412,18445,10641,14803,-666666666,,-666666666,3177,9312,21,027
"Bullitt County, Kentucky",76093,37724,38369,73541,496,79,331,61,379,1206,19,1187,74904,1189,0.3684,24364,24559,24611,17706,27273,22168,27602,49685,13309,12730,21,029
"Butler County, Kentucky",12797,6362,6435,12544,134,25,0,0,70,24,0,24,12369,428,0.4519,18747,18780,19031,14057,24451,20816,-666666666,-666666666,1266,18325,21,031
"Caldwell County, Kentucky",12880,6228,6652,11943,771,0,5,28,11,122,15,107,12709,171,0.4472,21194,21637,21735,14301,15934,-666666666,,,,8912,21,033
"Calloway County, Kentucky",37981,18317,19664,34755,1474,120,800,9,140,683,95,588,37039,942,0.4736,21093,21883,22097,11074,17459,13087,8395,,9694,7603,21,035
"Campbell County, Kentucky",91268,44770,46498,85686,2757,69,669,42,408,1637,254,1383,89670,1598,0.4337,27479,28494,28689,14616,9685,25987,19835,,21451,9432,21,037
"Carlisle County, Kentucky",5031,2412,2619,4877,70,44,4,0,4,32,8,24,4923,108,0.4141,21959,22330,22585,8596,16677,4784,,-666666666,,,21,039
"Carroll County, Kentucky",10871,5584,5287,10211,187,14,119,0,173,167,26,141,10123,748,0.4447,19711,20340,20963,10166,7225,,8233,-666666666,13776,11163,21,041
"Carter County, Kentucky",27439,13513,13926,26685,213,68,64,0,10,399,25,374,27298,141,0.4263,19536,19671,19712,7498,2675,30832,19156,-666666666,,18116,21,043
"Casey County, Kentucky",16002,7901,8101,15592,177,21,48,0,52,112,40,72,15576,426,0.4482,15949,16104,16227,10743,6868,,22504,-666666666,9179,9380,21,045
"Christian County, Kentucky",74459,38720,35739,54035,14838,367,1096,244,690,3189,180,3009,69300,5159,0.4512,19704,21868,22612,11529,15321,14393,18704,20447,13285,5714,21,047
"Clark County, Kentucky",35633,17419,18214,33140,1865,12,198,0,78,340,0,340,34681,952,0.4392,24787,25138,25434,13670,17865,,34825,-666666666,13897,26126,21,049
"Clay County, Kentucky",21446,11520,9926,19959,996,109,11,8,135,228,59,169,21154,292,0.4915,14574,14930,14931,9261,12330,8144,,,2295,4767,21,051
"Clinton County, Kentucky",10192,5056,5136,9827,74,0,20,0,81,190,141,49,9929,263,0.4806,17171,17646,17629,5190,2695,-666666666,,-666666666,5831,1289,21,053
"Crittenden County, Kentucky",9254,4637,4617,9028,82,18,3,0,5,118,0,118,9189,65,0.4628,20548,20907,21027,4351,7220,16061,,-666666666,,3691,21,055
"Cumberland County, Kentucky",6829,3367,3462,6496,229,0,0,0,0,104,0,104,6807,22,0.4628,17245,17632,17605,25595,10800,-666666666,-666666666,-666666666,-666666666,7238,21,057
"Daviess County, Kentucky",97631,47288,50343,89538,4507,152,791,20,549,2074,178,1896,95005,2626,0.4276,23140,24001,24348,10253,15285,15170,22026,,20091,5016,21,059
"Edmonson County, Kentucky",12137,6072,6065,11830,175,17,14,0,0,101,22,79,11928,209,0.4307,20652,20987,21168,7996,8933,,-666666666,-666666666,-666666666,5075,21,061
"Elliott County, Kentucky",7781,4372,3409,7523,240,0,4,0,14,0,0,0,7743,38,0.4708,15159,15516,15522,12547,4803,-666666666,,-666666666,5643,-666666666,21,063
"Estill County, Kentucky",14547,7160,7387,14259,76,12,0,0,0,200,0,200,14541,6,0.4463,16449,16661,16662,,2134,23200,-666666666,-666666666,-666666666,6373,21,065
"Fayette County, Kentucky",304473,149579,154894,231482,43918,961,10662,128,8811,8511,986,7525,283646,20827,0.4929,29168,32508,33294,13446,17799,14339,35672,27495,10860,9478,21,067
"Fleming County, Kentucky",14505,7081,7424,14023,226,18,6,0,72,160,62,98,14334,171,0.5028,20719,20868,20902,6644,25423,,,-666666666,8382,4351,21,069
"Floyd County, Kentucky",39087,19301,19786,38297,347,61,72,0,21,289,43,246,38826,261,0.4789,17958,18104,18163,6294,15068,18367,4153,-666666666,,5441,21,071
"Franklin County, Kentucky",49509,24022,25487,41146,5176,109,711,0,985,1382,165,1217,48094,1415,0.4323,26592,28760,28821,17000,15591,15247,27722,-666666666,16845,10523,21,073
"Fulton County, Kentucky",6550,3246,3304,4767,1606,6,11,0,3,157,5,152,6467,83,0.4650,18892,20380,20580,6924,15705,,20564,-666666666,,4929,21,075
"Gallatin County, Kentucky",8554,4261,4293,7975,132,0,92,0,70,285,0,285,8378,176,0.3904,20507,20925,20970,16227,14235,-666666666,13330,-666666666,14093,15606,21,077
"Garrard County, Kentucky",16880,8288,8592,16154,257,7,5,0,141,316,8,308,16482,398,0.4207,22334,22730,22988,9467,15632,,,-666666666,16804,10372,21,079
"Grant County, Kentucky",24667,12262,12405,23479,54,13,17,178,545,381,9,372,24065,602,0.4023,19872,20247,20329,15445,9135,,,5943,13933,14438,21,081
"Graves County, Kentucky",37451,18162,19289,34426,1751,33,112,0,187,942,10,932,35243,2208,0.4567,21367,22207,22446,15244,12999,18182,40584,-666666666,9611,6396,21,083
"Grayson County, Kentucky",25934,12868,13066,25075,230,25,91,13,166,334,11,323,25616,318,0.4806,19404,19699,19738,8232,13863,3128,37688,,4165,5620,21,085
"Green County, Kentucky",11186,5459,5727,10642,331,0,56,0,10,147,11,136,11128,58,0.4705,19465,19723,19791,4053,11886,-666666666,38813,-666666666,,8905,21,087
"Greenup County, Kentucky",36656,17714,18942,35586,272,118,142,0,43,495,3,492,36306,350,0.4439,22360,22482,22520,16658,26945,22818,28425,-666666666,29491,8669,21,089
"Hancock County, Kentucky",8654,4434,4220,8393,84,8,0,3,50,116,2,114,8540,114,0.3970,22637,22708,22774,13281,42463,,-666666666,,9672,8297,21,091
"Hardin County, Kentucky",107565,53607,53958,85922,13358,337,2349,161,1115,4323,396,3927,101678,5887,0.4256,24559,25040,25296,16765,25242,18077,31331,12001,21886,10855,21,093
"Harlan County, Kentucky",28744,14081,14663,27463,642,67,108,75,176,213,14,199,28514,230,0.4792,15543,15804,15830,2253,11193,8216,3819,,2323,16748,21,095
"Harrison County, Kentucky",18643,9137,9506,17675,395,53,24,0,254,242,19,223,18280,363,0.4804,21488,22178,22259,7609,12415,5806,34225,-666666666,6009,4311,21,097
"Hart County, Kentucky",18427,9094,9333,17196,887,37,30,5,41,231,8,223,18140,287,0.4653,18289,18840,18884,12580,12320,,9673,,,6078,21,099
"Henderson County, Kentucky",46394,22448,23946,41066,3329,122,153,0,574,1150,126,1024,45420,974,0.4563,22968,24221,24413,14820,16350,9366,18420,-666666666,13945,3955,21,101
"Henry County, Kentucky",15427,7643,7784,14387,504,48,0,0,277,211,16,195,14937,490,0.4188,21288,21804,21912,8677,18352,19448,-666666666,-666666666,5851,13818,21,103
"Hickman County, Kentucky",4790,2289,2501,4207,458,0,31,0,8,86,0,86,4754,36,0.3723,20051,21048,21099,,14730,-666666666,,-666666666,,3713,21,105
"Hopkins County, Kentucky",46684,22596,24088,42155,2841,105,279,0,185,1119,79,1040,45875,809,0.4417,22632,23484,23557,15039,17887,19904,18357,-666666666,5627,6732,21,107
"Jackson County, Kentucky",13370,6638,6732,13216,3,4,0,0,0,147,0,147,13292,78,0.4663,15760,15819,15873,6674,400,,-666666666,-666666666,-666666666,11189,21,109
"Jefferson County, Kentucky",751485,362452,389033,549890,155105,1121,17745,290,5847,21487,1516,19971,717096,34389,0.4847,28464,32332,33029,16925,17459,18993,29692,26364,16571,11668,21,111
"Jessamine County, Kentucky",49601,24327,25274,45945,1544,264,558,51,379,860,5,855,48219,1382,0.4869,26235,27059,27388,8801,17846,13750,27441,22261,6831,9161,21,113
"Johnson County, Kentucky",23390,11505,11885,22941,67,9,163,0,39,171,0,171,23261,129,0.4549,18380,18427,18392,21583,16299,,31908,-666666666,,739,21,115
"Kenton County, Kentucky",161915,79822,82093,146730,7508,425,1751,39,2159,3303,311,2992,157368,4547,0.4433,27788,29168,29275,15996,14423,12403,24872,,13208,9733,21,117
"Knott County, Kentucky",16139,8001,8138,15772,143,0,6,12,11,195,82,113,16022,117,0.4710,18304,18501,18487,8058,8354,-666666666,,,,9425,21,119
"Knox County, Kentucky",31857,15504,16353,31003,501,64,1,79,8,201,0,201,31540,317,0.4707,15013,15193,15300,4584,7363,19520,,,,10138,21,121
"Larue County, Kentucky",14149,7014,7135,13126,482,31,15,0,146,349,31,318,13720,429,0.4314,20051,19951,19883,16511,34215,,,-666666666,11007,6170,21,123
"Laurel County, Kentucky",59535,29121,30414,57866,507,119,312,0,101,630,59,571,58736,799,0.4682,19375,19142,19251,10959,9880,7492,101975,-666666666,8372,11509,21,125
"Lawrence County, Kentucky",15850,7878,7972,15535,17,0,100,0,9,189,33,156,15798,52,0.4710,19037,19181,19188,,21624,-666666666,18136,-666666666,,8372,21,127
"Lee County, Kentucky",7681,4206,3475,7375,101,12,61,0,13,119,0,119,7605,76,0.4913,15059,15072,15084,7164,22151,,5751,-666666666,,14814,21,129
"Leslie County, Kentucky",11128,5379,5749,10937,26,7,14,0,113,31,7,24,11023,105,0.4840,16708,16929,16929,-666666666,1246,,45179,-666666666,477,,21,131
"Letcher County, Kentucky",23965,11793,12172,23604,140,8,45,0,29,139,19,120,23818,147,0.4668,18163,18287,18259,18126,8319,,18289,-666666666,,10906,21,133
"Lewis County, Kentucky",13848,6934,6914,13619,18,42,10,0,60,99,0,99,13762,86,0.4767,15764,15919,15935,3258,11222,7721,,-666666666,,8141,21,135
"Lincoln County, Kentucky",24546,11848,12698,23452,611,56,146,0,80,201,6,195,24173,373,0.4471,18192,18483,18374,20599,15108,15455,,-666666666,5316,12717,21,137
"Livingston County, Kentucky",9443,4643,4800,9235,29,18,35,0,5,121,0,121,9307,136,0.4263,20700,20432,20500,14369,11759,,,-666666666,,21684,21,139
"Logan County, Kentucky",26844,13317,13527,24330,1764,75,10,0,139,526,43,483,26153,691,0.4354,19063,19761,19910,12431,13618,13860,,-666666666,14619,6766,21,141
"Lyon County, Kentucky",8415,4599,3816,7749,533,0,31,0,22,80,0,80,8345,70,0.4239,23621,24572,24610,12626,13502,-666666666,4235,-666666666,,12869,21,143
"McCracken County, Kentucky",65545,31485,34060,55944,7064,222,603,42,153,1517,199,1318,64083,1462,0.4857,26571,28427,28674,14152,15405,24580,37638,,7587,8333,21,145
"McCreary County, Kentucky",18073,9818,8255,16640,1090,60,0,26,93,164,32,132,17777,296,0.4666,11287,11616,11654,6079,6918,17042,-666666666,,10260,5998,21,147
"McLean County, Kentucky",9510,4703,4807,9299,45,24,26,0,12,104,25,79,9390,120,0.4112,20789,20891,21074,6284,21033,6879,,-666666666,,16882,21,149
"Madison County, Kentucky",85485,41532,43953,78414,3736,290,920,41,437,1647,91,1556,83587,1898,0.4557,21535,22192,22312,14173,14164,14039,25201,,6068,10089,21,151
"Magoffin County, Kentucky",13076,6525,6551,12941,2,47,0,0,0,86,0,86,12957,119,0.4638,15838,15908,15923,14270,,,-666666666,-666666666,-666666666,13420,21,153
"Marion County, Kentucky",19965,10303,9662,17627,1928,0,12,0,203,195,14,181,19472,493,0.4471,18741,19631,19760,10109,12039,-666666666,40158,-666666666,10928,11338,21,155
"Marshall County, Kentucky",31223,15363,15860,30662,89,34,73,0,19,346,44,302,30838,385,0.4153,23595,23885,24018,10226,7454,,21207,-666666666,18000,4791,21,157
"Martin County, Kentucky",12750,7070,5680,12001,549,10,2,5,65,118,8,110,12476,274,0.4915,15406,15953,16072,6845,6569,,,,4618,8744,21,159
"Mason County, Kentucky",17398,8477,8921,15647,1166,20,41,0,8,516,8,508,17326,72,0.5156,23694,24758,24834,6796,15968,,,-666666666,,8647,21,161
"Meade County, Kentucky",29203,14632,14571,26800,1276,30,184,0,215,698,49,649,28119,1084,0.4321,23229,23810,24059,15078,16374,,24260,-666666666,20106,12732,21,163
"Menifee County, Kentucky",6337,3235,3102,6127,34,1,26,0,86,63,0,63,6218,119,0.4365,16464,16825,16761,7978,5159,,,-666666666,,,21,165
"Mercer County, Kentucky",21311,10483,10828,19823,823,20,87,0,235,323,0,323,20804,507,0.4374,22614,23373,23409,17131,13221,,31263,-666666666,12828,5220,21,167
"Metcalfe County, Kentucky",10025,4983,5042,9588,127,27,34,20,139,90,0,90,9884,141,0.4533,17265,17651,17689,13391,8033,,,,5829,15647,21,169
"Monroe County, Kentucky",10837,5444,5393,10418,224,0,15,0,53,127,0,127,10528,309,0.4580,17571,17638,17729,13865,23638,-666666666,,-666666666,12940,3829,21,171
"Montgomery County, Kentucky",26983,13169,13814,25398,817,45,11,0,411,301,31,270,26281,702,0.4852,21057,21416,21574,8682,21536,,,-666666666,9172,9609,21,173
"Morgan County, Kentucky",13522,7566,5956,12753,416,10,121,0,51,171,0,171,13395,127,0.4680,16379,16522,16499,12235,7756,,47511,-666666666,7029,7778,21,175
"Muhlenberg County, Kentucky",31391,15923,15468,29141,1431,69,48,68,160,474,116,358,30987,404,0.4265,19200,20043,20090,8544,8688,9828,4090,-666666666,17007,5490,21,177
"Nelson County, Kentucky",44254,21862,22392,41057,2260,92,148,0,62,635,2,633,43349,905,0.4454,23531,24489,24792,9519,13004,8063,5628,-666666666,2902,7509,21,179
"Nicholas County, Kentucky",7064,3503,3561,7034,27,0,0,0,3,0,0,0,7041,23,0.4283,21276,21336,21386,3339,8089,-666666666,-666666666,-666666666,,-666666666,21,181
"Ohio County, Kentucky",23956,11901,12055,22896,572,9,32,0,115,332,164,168,23128,828,0.4539,18991,19391,19558,8124,10938,10222,,-666666666,4618,11738,21,183
"Oldham County, Kentucky",61711,32384,29327,55775,2599,166,846,43,1080,1202,180,1022,59463,2248,0.4226,34113,35136,35445,16580,17761,19228,61195,46719,17723,19277,21,185
"Owen County, Kentucky",10740,5255,5485,10337,173,10,14,0,172,34,13,21,10483,257,0.4447,22346,22488,22565,10095,9664,,,-666666666,8576,116115,21,187
"Owsley County, Kentucky",4686,2248,2438,4525,37,9,33,0,9,73,0,73,4651,35,0.5201,14591,14764,14874,,13362,,,-666666666,,,21,189
"Pendleton County, Kentucky",14642,7286,7356,14389,75,24,0,0,0,154,6,148,14487,155,0.4446,23755,23946,24029,27372,7129,23917,-666666666,-666666666,-666666666,13990,21,191
"Perry County, Kentucky",28261,13752,14509,27179,343,95,164,12,0,468,2,466,28197,64,0.4841,18606,18498,18510,13100,21680,45846,45618,,-666666666,6554,21,193
"Pike County, Kentucky",64380,31527,32853,62810,558,28,352,11,259,362,57,305,63893,487,0.4821,19749,19632,19633,12640,29296,,30440,,7938,25504,21,195
"Powell County, Kentucky",12552,6205,6347,12224,25,28,13,0,44,218,1,217,12400,152,0.4951,16544,16745,16812,7377,8416,,,-666666666,12634,8484,21,197
"Pulaski County, Kentucky",63505,31016,32489,61149,723,131,350,64,365,723,15,708,62067,1438,0.5056,20348,20711,20757,14664,12591,10040,16226,,8026,8987,21,199
"Robertson County, Kentucky",2239,1095,1144,2220,0,3,0,0,0,16,0,16,2239,0,0.4562,17326,17418,17418,-666666666,-666666666,,-666666666,-666666666,-666666666,,21,201
"Rockcastle County, Kentucky",16965,8356,8609,16616,24,158,11,16,30,110,0,110,16898,67,0.4641,17146,17255,17209,16822,8363,18285,,,,9565,21,203
"Rowan County, Kentucky",23485,11325,12160,22329,389,13,156,0,149,449,0,449,23314,171,0.4463,18168,18551,18603,13047,12738,,25536,-666666666,12148,3764,21,205
"Russell County, Kentucky",17646,8676,8970,17134,86,43,10,131,118,124,0,124,17034,612,0.4684,17181,17453,17261,20151,20721,6802,,,7973,9048,21,207
"Scott County, Kentucky",49167,24160,25007,43688,2560,92,399,0,1336,1092,101,991,47103,2064,0.4094,27906,29039,29255,11929,19288,67315,21405,-666666666,10140,23586,21,209
"Shelby County, Kentucky",43581,21032,22549,37680,3204,18,453,0,1293,933,139,794,39719,3862,0.4189,27152,28963,30267,11258,18415,22383,20860,-666666666,11577,8734,21,211
"Simpson County, Kentucky",17551,8493,9058,15137,1685,113,152,0,195,269,56,213,17213,338,0.4048,18840,19835,19916,5062,14800,18380,15647,-666666666,4746,338,21,213
"Spencer County, Kentucky",17419,8744,8675,16720,309,50,64,0,38,238,15,223,17122,297,0.3469,26564,26845,27103,9732,19555,,14088,-666666666,,18477,21,215
"Taylor County, Kentucky",25059,12150,12909,23043,1160,37,184,0,91,544,46,498,24561,498,0.4289,18430,19106,19213,9858,13588,,13905,-666666666,4165,5225,21,217
"Todd County, Kentucky",12499,6275,6224,10821,1069,5,4,0,450,150,4,146,11994,505,0.4226,18592,19606,19619,8340,14819,,,-666666666,6999,6895,21,219
"Trigg County, Kentucky",14277,7093,7184,12819,1172,0,80,0,0,206,20,186,14064,213,0.4355,24982,24521,24743,11106,17401,-666666666,27173,-666666666,-666666666,95990,21,221
"Trimble County, Kentucky",8816,4398,4418,8603,119,0,2,0,37,55,17,38,8543,273,0.3879,22804,22998,23254,8972,1663,-666666666,,-666666666,,22385,21,223
"Union County, Kentucky",15192,7771,7421,12836,1971,57,70,0,39,219,0,219,14920,272,0.4435,19611,21519,21788,4810,9227,27570,637,-666666666,-666666666,8745,21,225
"Warren County, Kentucky",117169,57193,59976,96403,10871,389,3277,133,3608,2488,373,2115,111468,5701,0.4680,24012,26155,26440,9626,14914,18758,18981,7144,9724,9805,21,227
"Washington County, Kentucky",11871,5865,6006,10618,708,45,27,0,195,278,85,193,11438,433,0.4140,19818,20878,21079,6611,13279,,37585,-666666666,3588,5542,21,229
"Wayne County, Kentucky",20728,10296,10432,19632,438,12,0,16,365,265,3,262,20136,592,0.4571,15935,16276,16323,6538,12456,,-666666666,,6602,8243,21,231
"Webster County, Kentucky",13454,6715,6739,12348,640,33,10,0,246,177,35,142,12853,601,0.4366,20983,21646,21950,8761,16645,5842,,-666666666,7939,11656,21,233
"Whitley County, Kentucky",35557,17413,18144,34501,286,73,142,10,99,446,35,411,35212,345,0.4540,16406,16676,16749,4403,5414,15249,3736,,1440,10237,21,235
"Wolfe County, Kentucky",7273,3586,3687,7205,15,21,0,0,15,17,0,17,7259,14,0.5086,13455,13492,13518,,4913,,-666666666,-666666666,,,21,237
"Woodford County, Kentucky",25151,12206,12945,22279,1234,12,110,8,864,644,27,617,23482,1669,0.4518,29995,31995,32411,13039,18402,4375,15555,,12882,9016,21,239
"Acadia Parish, Louisiana",62031,30058,31973,48993,10937,97,101,87,533,1283,210,1073,60820,1211,0.4636,20264,22610,22712,11527,11780,20088,9418,2074,13051,8116,22,001
"Allen Parish, Louisiana",25691,14880,10811,18704,4879,628,221,0,303,956,351,605,24364,1327,0.4599,19259,22749,23252,6845,9365,15985,10886,-666666666,10510,8323,22,003
"Ascension Parish, Louisiana",112308,55492,56816,83573,25169,236,1242,0,564,1524,33,1491,106779,5529,0.4035,28834,31423,32321,17857,21832,24792,16480,-666666666,24089,14976,22,005
"Assumption Parish, Louisiana",23170,11115,12055,15742,6891,152,91,0,113,181,18,163,22640,530,0.4502,23085,27962,28262,16823,12188,10412,33577,-666666666,20488,20828,22,007
"Avoyelles Parish, Louisiana",41604,20852,20752,27881,12264,467,221,30,151,590,32,558,40928,676,0.4635,17899,21657,21769,10679,10136,15307,21331,22543,800,6575,22,009
"Beauregard Parish, Louisiana",36109,18433,17676,29708,4750,326,209,0,147,969,21,948,34943,1166,0.4515,23451,24798,25144,13623,17577,26969,15165,-666666666,16048,12677,22,011
"Bienville Parish, Louisiana",14122,6772,7350,7822,5980,36,1,0,78,205,87,118,13903,219,0.4980,20622,27131,26664,31763,12579,38950,,-666666666,11369,7303,22,013
"Bossier Parish, Louisiana",121918,60201,61717,88168,25859,870,1773,151,2434,2663,269,2394,114334,7584,0.4359,27199,31373,31977,17302,15919,24486,25430,14254,13083,14209,22,015
"Caddo Parish, Louisiana",255529,121370,134159,123126,121753,1121,2942,130,2807,3650,818,2832,248797,6732,0.5011,24673,33829,34238,18577,15611,18828,30557,113234,21779,14265,22,017
"Calcasieu Parish, Louisiana",194943,95043,99900,138373,48761,728,2431,71,852,3727,317,3410,189452,5491,0.4717,24521,27965,28129,20183,15695,32202,26043,,25268,9636,22,019
"Caldwell Parish, Louisiana",10008,5197,4811,8106,1754,44,9,0,25,70,21,49,9751,257,0.5141,22752,24068,24183,18552,17701,,,-666666666,,10329,22,021
"Cameron Parish, Louisiana",6713,3335,3378,6481,207,0,0,0,0,25,0,25,6573,140,0.4073,29450,30202,29845,46376,8645,-666666666,-666666666,-666666666,-666666666,6756,22,023
"Catahoula Parish, Louisiana",10273,5465,4808,6827,3249,10,11,0,8,168,46,122,10159,114,0.5277,21237,26627,26740,12847,10089,,,-666666666,,18273,22,025
"Claiborne Parish, Louisiana",16817,9516,7301,7896,8456,85,0,5,37,338,0,338,16606,211,0.4663,17672,25437,25692,642,10880,10368,-666666666,,1154,10106,22,027
"Concordia Parish, Louisiana",20609,10449,10160,11926,8439,30,75,23,25,91,13,78,20376,233,0.4886,16931,22622,22807,10397,9119,14420,8175,-666666666,13088,9010,22,029
"De Soto Parish, Louisiana",26968,12926,14042,15515,10403,195,68,17,357,413,111,302,26254,714,0.4674,22027,26587,26709,13676,15465,35384,18035,,14615,15984,22,031
"East Baton Rouge Parish, Louisiana",443598,212764,230834,216660,201724,712,13669,103,3278,7452,765,6687,426800,16798,0.4873,27558,37217,38077,20800,17829,38785,26353,19343,16952,16006,22,033
"East Carroll Parish, Louisiana",7602,4281,3321,2202,5310,0,11,0,9,70,18,52,7386,216,0.4998,12129,22561,23864,6671,7937,-666666666,,-666666666,,3281,22,035
"East Feliciana Parish, Louisiana",19964,10702,9262,10730,8976,59,22,0,23,154,0,154,19722,242,0.4504,21370,26120,26456,6564,14492,4229,,-666666666,,33453,22,037
"Evangeline Parish, Louisiana",33778,17188,16590,23196,9535,47,18,0,501,481,32,449,32968,810,0.4985,18535,22941,23089,5628,9103,27898,2856,-666666666,3119,8727,22,039
"Franklin Parish, Louisiana",20645,10036,10609,13733,6754,0,14,0,0,144,0,144,20569,76,0.4833,17816,22397,22426,17224,8721,-666666666,26664,-666666666,-666666666,6690,22,041
"Grant Parish, Louisiana",22363,12628,9735,17787,3526,215,26,34,219,556,193,363,21354,1009,0.4447,18415,20629,21120,6802,9957,3887,7196,,3666,14300,22,043
"Iberia Parish, Louisiana",73735,35979,37756,46012,23369,451,1724,0,368,1811,89,1722,71149,2586,0.4816,23562,28154,28508,18127,14572,19782,40228,-666666666,6961,11340,22,045
"Iberville Parish, Louisiana",33375,17041,16334,16424,16267,43,21,0,192,428,18,410,32602,773,0.4881,21576,29132,29512,18111,14156,14593,1381,-666666666,18480,16680,22,047
"Jackson Parish, Louisiana",16199,8278,7921,11035,4887,24,33,0,141,79,1,78,15963,236,0.4533,18875,22179,22465,10760,11841,,38124,-666666666,,5543,22,049
"Jefferson Parish, Louisiana",434528,210884,223644,276653,115490,2302,17851,154,14803,7275,1076,6199,377193,57335,0.4742,27067,31994,33752,20033,17144,19995,27024,22700,18734,16646,22,051
"Jefferson Davis Parish, Louisiana",31492,15447,16045,25038,5435,162,104,0,199,554,1,553,30871,621,0.4834,21656,23809,23882,24652,12420,11973,73405,-666666666,36387,2809,22,053
"Lafayette Parish, Louisiana",228084,111474,116610,159832,58715,445,3412,50,1283,4347,427,3920,218635,9449,0.4868,29332,34540,35183,19600,16208,53279,29225,,15702,14732,22,055
"Lafourche Parish, Louisiana",97235,48043,49192,77306,12976,2163,756,0,1748,2286,202,2084,93193,4042,0.4559,25010,27618,27699,23512,14211,17223,17805,-666666666,23435,9094,22,057
"LaSalle Parish, Louisiana",14874,7596,7278,12767,1872,142,8,0,6,79,0,79,14517,357,0.4628,21998,24101,24659,4208,8601,11749,,-666666666,,20720,22,059
"Lincoln Parish, Louisiana",47243,22889,24354,25798,19276,119,856,0,539,655,90,565,45997,1246,0.5434,21150,28846,29156,14370,11816,34024,11009,-666666666,17744,6435,22,061
"Livingston Parish, Louisiana",132160,65266,66894,120842,7802,567,577,2,1068,1302,356,946,127923,4237,0.4229,25508,26025,26170,18728,16983,52806,34965,,15487,20840,22,063
"Madison Parish, Louisiana",12008,6017,5991,4332,7361,109,11,0,127,68,0,68,11807,201,0.5058,14526,19799,19993,4815,11825,6467,,-666666666,2597,3299,22,065
"Morehouse Parish, Louisiana",27319,13064,14255,13889,12976,34,64,0,53,303,78,225,27017,302,0.5190,17969,21815,21996,5967,14357,11024,5984,-666666666,,2684,22,067
"Natchitoches Parish, Louisiana",39359,18762,20597,21554,16047,365,207,14,287,885,67,818,38571,788,0.5323,20607,27357,27060,30319,12085,17027,26011,,18623,11897,22,069
"Orleans Parish, Louisiana",368471,176743,191728,125296,219645,1030,10885,105,5418,6092,900,5192,348560,19911,0.5618,27255,47320,49515,23226,16264,19210,27243,25065,17899,20573,22,071
"Ouachita Parish, Louisiana",155285,74310,80975,93453,57577,470,1393,11,949,1432,82,1350,152140,3145,0.4963,22160,28106,28238,19035,12221,19677,34038,,17787,25720,22,073
"Plaquemines Parish, Louisiana",23545,11636,11909,16310,5006,397,778,0,520,534,78,456,22216,1329,0.4412,26672,30880,31094,16829,16281,34026,23439,-666666666,9734,11310,22,075
"Pointe Coupee Parish, Louisiana",22631,10845,11786,14029,8103,99,65,0,95,240,13,227,22096,535,0.4616,24552,31264,31753,13481,13779,6900,18246,-666666666,4874,12694,22,077
"Rapides Parish, Louisiana",132199,63758,68441,84675,42466,797,1945,68,372,1876,285,1591,128604,3595,0.4756,22106,25858,26124,17530,15131,17603,22036,61019,19649,11733,22,079
"Red River Parish, Louisiana",8937,4330,4607,5246,3506,12,7,14,47,105,0,105,8815,122,0.5081,21395,28009,28218,11077,12213,42783,,,11115,3987,22,081
"Richland Parish, Louisiana",20845,10043,10802,13071,7516,11,34,7,60,146,0,146,20442,403,0.4580,19440,24377,24759,12249,11113,,7882,,24773,6469,22,083
"Sabine Parish, Louisiana",24286,12024,12262,17017,4131,1797,84,11,170,1076,79,997,23415,871,0.5030,23058,27001,27106,20066,11201,18684,17956,,16366,14843,22,085
"St. Bernard Parish, Louisiana",41114,20604,20510,30375,8382,264,841,0,239,1013,90,923,37231,3883,0.4302,21079,23207,23685,17344,14695,11968,18406,-666666666,10097,17309,22,087
"St. Charles Parish, Louisiana",52616,25686,26930,37111,13817,107,517,11,291,762,168,594,49756,2860,0.4195,26623,30065,30802,19489,17583,24246,32239,,27610,18784,22,089
"St. Helena Parish, Louisiana",10937,5332,5605,4890,5764,113,0,0,1,169,0,169,10923,14,0.4897,19582,27351,27402,9457,13204,22524,-666666666,-666666666,,10412,22,091
"St. James Parish, Louisiana",21782,10536,11246,10589,10955,28,71,0,58,81,26,55,21467,315,0.4416,24757,32868,33239,10537,16860,,57800,-666666666,6362,8136,22,093
"St. John the Baptist Parish, Louisiana",44570,21667,22903,19094,24077,24,267,99,260,749,156,593,42309,2261,0.4227,22785,27832,28511,20369,17850,,18827,11509,22978,56188,22,095
"St. Landry Parish, Louisiana",83518,40012,43506,47161,34164,119,376,0,272,1426,80,1346,82055,1463,0.4973,19282,24646,24691,18789,12304,25586,13610,-666666666,20582,9756,22,097
"St. Martin Parish, Louisiana",52823,25944,26879,34873,16089,309,512,18,434,588,30,558,51589,1234,0.4611,22783,26411,26589,12827,15884,22565,9962,,14235,14674,22,099
"St. Mary Parish, Louisiana",53784,26544,27240,32281,16828,832,832,0,1031,1980,186,1794,50639,3145,0.4626,21616,26285,26875,15403,14131,22711,23058,-666666666,14766,11600,22,101
"St. Tammany Parish, Louisiana",239814,116624,123190,200799,28132,1099,3506,114,2266,3898,475,3423,227697,12117,0.4543,30948,33175,33798,19836,18545,15452,28722,15639,24789,16151,22,103
"Tangipahoa Parish, Louisiana",124125,60214,63911,83283,37162,370,887,8,477,1938,153,1785,119476,4649,0.4626,21262,25203,25658,15435,12978,17642,21044,,15621,12861,22,105
"Tensas Parish, Louisiana",5008,2396,2612,2150,2820,0,0,0,18,20,0,20,4926,82,0.4909,16819,26928,27356,9017,9226,-666666666,-666666666,-666666666,12200,,22,107
"Terrebonne Parish, Louisiana",112167,55553,56614,79717,21303,6328,1075,65,1292,2387,148,2239,107272,4895,0.4452,23999,27550,27953,18889,15145,15751,19947,23686,22387,8989,22,109
"Union Parish, Louisiana",22623,11265,11358,16151,5785,118,18,36,181,334,8,326,21656,967,0.4750,19437,23040,23802,8188,10498,15028,28472,,7600,5137,22,111
"Vermilion Parish, Louisiana",58784,28529,30255,47749,8245,313,1258,0,208,1011,30,981,57132,1652,0.4620,23303,25532,25877,11252,13019,13357,24625,-666666666,8963,6281,22,113
"Vernon Parish, Louisiana",52844,27489,25355,40725,7517,623,867,217,527,2368,117,2251,48328,4516,0.3996,21609,22399,22844,17005,20415,20782,25365,30954,20265,10096,22,115
"Washington Parish, Louisiana",46723,22945,23778,31547,14133,111,88,16,86,742,22,720,45786,937,0.4882,17459,20677,20865,13567,10706,6704,14795,,23927,10198,22,117
"Webster Parish, Louisiana",40890,19972,20918,26111,13929,193,174,0,157,326,23,303,40177,713,0.4766,20623,25240,25502,8209,12235,38466,10276,-666666666,7552,10439,22,119
"West Baton Rouge Parish, Louisiana",24347,11947,12400,14566,9090,77,129,0,177,308,2,306,23719,628,0.4380,25296,31435,31468,27394,16487,11153,17753,-666666666,19866,4708,22,121
"West Carroll Parish, Louisiana",11522,5835,5687,9425,1861,33,21,0,66,116,3,113,11197,325,0.4780,19296,21733,20708,47000,8256,11121,3100,-666666666,3526,12626,22,123
"West Feliciana Parish, Louisiana",15485,10119,5366,8192,7079,42,0,0,24,148,25,123,15246,239,0.4655,21916,32048,32681,7633,10730,6126,-666666666,-666666666,7604,2951,22,125
"Winn Parish, Louisiana",15000,7906,7094,10053,4650,107,0,0,28,162,6,156,14740,260,0.4912,17508,22199,22331,15612,7735,20061,-666666666,-666666666,13989,5814,22,127
"Androscoggin County, Maine",107470,52634,54836,99572,1740,208,912,21,191,4826,133,4693,105701,1769,0.4382,24734,25804,25965,11364,6897,11369,17829,,18195,11315,23,001
"Aroostook County, Maine",70653,34796,35857,67312,482,1046,322,29,202,1260,142,1118,69915,738,0.4411,21933,22251,22320,13576,11759,10977,54091,,26447,9151,23,003
"Cumberland County, Maine",284351,138066,146285,263363,7552,590,6137,44,1143,5522,213,5309,279054,5297,0.4657,33844,35232,35432,19769,10521,21195,25065,21500,19557,13716,23,005
"Franklin County, Maine",30569,14998,15571,29658,82,139,171,0,51,468,13,455,30225,344,0.4317,22576,22838,22888,16808,8915,14633,22615,-666666666,36057,9243,23,007
"Hancock County, Maine",54581,26687,27894,52848,246,199,514,2,43,729,11,718,53901,680,0.4624,28077,28369,28492,18377,20380,14051,29954,,33444,11778,23,009
"Kennebec County, Maine",121507,58916,62591,116863,941,709,978,27,424,1565,31,1534,119862,1645,0.4312,25636,25991,25994,22207,12109,16700,17200,,15858,16046,23,011
"Knox County, Maine",39653,19640,20013,38406,253,129,274,0,41,550,55,495,39257,396,0.4194,28062,28499,28619,10612,11070,22379,16412,-666666666,15449,13454,23,013
"Lincoln County, Maine",34237,16891,17346,33351,102,144,294,0,14,332,0,332,33929,308,0.4280,28798,29028,29069,23008,16215,14522,20732,-666666666,25379,22987,23,015
"Oxford County, Maine",57517,28535,28982,55729,234,188,366,17,114,869,7,862,56885,632,0.4227,21577,21910,21826,30085,12807,11779,11943,,21761,9086,23,017
"Penobscot County, Maine",153627,75770,77857,146249,1194,1650,1551,5,322,2656,86,2570,151850,1777,0.4421,24076,24367,24409,17851,24327,15173,27886,,17234,11911,23,019
"Piscataquis County, Maine",17271,8555,8716,16696,22,32,86,0,51,384,27,357,17077,194,0.4445,22796,23161,23219,12094,,18366,26645,-666666666,4188,10171,23,021
"Sagadahoc County, Maine",35102,16901,18201,33699,250,87,261,0,53,752,7,745,34602,500,0.4230,29879,30430,30646,11324,20646,20708,24905,-666666666,16417,11979,23,023
"Somerset County, Maine",51762,25444,26318,50216,197,232,203,20,34,860,47,813,51285,477,0.4308,21765,22017,22103,10413,18632,11781,17059,17650,7656,12218,23,025
"Waldo County, Maine",38904,19064,19840,37686,159,106,210,3,120,620,16,604,38495,409,0.4270,23729,24110,24200,8793,9542,16913,14019,,9935,11421,23,027
"Washington County, Maine",32397,15983,16414,29757,154,1445,148,20,129,744,15,729,31884,513,0.4322,21450,22155,22293,8406,12718,15227,20613,3375,3817,10850,23,029
"York County, Maine",198934,96721,102213,191412,1257,648,2183,10,319,3105,195,2910,196021,2913,0.4251,29741,30185,30344,15358,19858,17775,24273,26510,23201,13419,23,031
"Allegany County, Maryland",73976,38471,35505,65687,5991,99,632,38,157,1372,93,1279,72826,1150,0.4603,21653,23553,23696,7803,4536,13025,20691,37345,3052,8175,24,001
"Anne Arundel County, Maryland",550269,272197,278072,411659,86471,1118,19525,428,12536,18532,1506,17026,513603,36666,0.4133,41315,45220,46136,23486,32030,32339,37371,21737,19444,17818,24,003
"Baltimore County, Maryland",817720,386775,430945,522396,219268,2033,44399,375,9930,19319,2021,17298,779890,37830,0.4404,34701,38979,39802,20419,27443,28592,31804,27334,19189,16842,24,005
"Calvert County, Maryland",89793,44418,45375,73139,11806,161,1148,0,821,2718,40,2678,86985,2808,0.3745,38633,40904,41194,26082,29101,42049,60356,-666666666,15002,16679,24,009
"Caroline County, Maryland",32759,15932,16827,26447,4631,73,157,20,712,719,74,645,30839,1920,0.4202,25193,26508,27194,12143,20512,24411,17662,,18703,15675,24,011
"Carroll County, Maryland",167399,82760,84639,155306,5402,254,2671,33,675,3058,253,2805,162717,4682,0.3944,36936,37806,38120,24446,28620,45259,30310,30961,23173,15612,24,013
"Cecil County, Maryland",101803,50619,51184,90952,6975,253,1274,20,685,1644,73,1571,97951,3852,0.4022,29025,30068,30490,17363,20782,18832,27129,,13560,16116,24,015
"Charles County, Maryland",150960,72929,78031,74611,62796,1078,4700,174,1511,6090,476,5614,143716,7244,0.3821,37223,41384,42384,24453,34623,31082,35806,20067,29978,17513,24,017
"Dorchester County, Maryland",32614,15656,16958,21917,9118,34,385,0,656,504,19,485,31297,1317,0.4649,26755,31848,32291,14472,16105,,34199,-666666666,12222,10674,24,019
"Frederick County, Maryland",239253,117900,121353,195658,20907,996,10074,144,4447,7027,787,6240,220444,18809,0.3955,37254,39252,40224,23144,29308,34638,36601,30672,20203,17484,24,021
"Garrett County, Maryland",29945,14820,15125,29174,249,44,113,20,37,308,48,260,29685,260,0.4417,24974,25284,25333,12252,4609,16230,31768,,14741,10384,24,023
"Harford County, Maryland",248029,121465,126564,199354,32762,417,6381,66,3030,6019,490,5529,238420,9609,0.3999,35763,37953,38250,25550,27002,35743,36435,755,26249,15371,24,025
"Howard County, Maryland",299269,146787,152482,181806,54106,580,46603,124,5605,10445,668,9777,280925,18344,0.3967,48243,55536,57093,28257,37438,38176,41479,58799,19699,23205,24,027
"Kent County, Maryland",20016,9478,10538,16350,3110,89,180,0,95,192,1,191,19142,874,0.4293,28411,31075,31738,15624,16536,12010,17236,-666666666,11223,20506,24,029
"Montgomery County, Maryland",1005087,483505,521582,565216,174915,2754,143645,391,77094,41072,7548,33524,824690,180397,0.4558,48916,61474,67378,23761,32170,28028,43943,32739,17107,26065,24,031
"Prince George's County, Maryland",884764,425340,459424,189096,564068,3091,37653,207,68041,22608,3797,18811,744309,140455,0.3952,32637,34483,41686,18278,34524,27619,29817,30684,16430,24298,24,033
"Queen Anne's County, Maryland",48439,23842,24597,43387,3428,134,395,0,291,804,42,762,46848,1591,0.4022,38392,40126,40756,19181,25505,34311,23278,-666666666,12786,17144,24,035
"St. Mary's County, Maryland",108472,54031,54441,85737,15559,274,2668,33,664,3537,288,3249,103824,4648,0.3925,36602,39395,40076,25276,25358,41363,42427,16009,24817,16014,24,037
"Somerset County, Maryland",26197,14392,11805,13855,10904,55,317,6,204,856,225,631,25259,938,0.4491,16471,22319,22755,5491,10443,4593,13694,,3103,3721,24,039
"Talbot County, Maryland",37894,18015,19879,31185,5102,28,569,24,300,686,136,550,35666,2228,0.4935,37661,41514,42895,13537,20444,10168,24708,,16135,12250,24,041
"Washington County, Maryland",148913,75833,73080,125480,15490,379,2389,47,700,4428,311,4117,143169,5744,0.4317,27173,29289,29638,14446,16155,41297,25265,27749,13036,7802,24,043
"Wicomico County, Maryland",100376,47788,52588,68961,24399,314,2906,12,1122,2662,167,2495,95480,4896,0.4547,26298,29818,30550,14443,18353,15138,30019,,11352,11419,24,045
"Worcester County, Maryland",51558,24990,26568,42583,7386,77,642,33,116,721,107,614,49847,1711,0.4718,33376,36578,37034,21614,17928,28547,11840,,43238,20505,24,047
"Baltimore city, Maryland",622271,293295,328976,188380,392312,2094,15530,230,9540,14185,1028,13157,594520,27751,0.5056,25062,39701,41193,18127,18321,20624,32325,25154,15956,15950,24,510
"Barnstable County, Massachusetts",215167,102541,112626,200273,5384,910,2864,6,1998,3732,708,3024,209900,5267,0.4602,36964,38316,38576,21962,19790,28173,16478,,24474,13713,25,001
"Berkshire County, Massachusetts",130064,62674,67390,119613,3642,369,1791,0,1472,3177,391,2786,125157,4907,0.4723,30168,31295,31549,16862,12288,11536,32204,-666666666,16435,15599,25,003
"Bristol County, Massachusetts",551065,266758,284307,484654,20123,928,11094,213,19676,14377,3440,10937,515233,35832,0.4541,29173,30537,31079,14290,21297,17191,28200,42323,15648,14082,25,005
"Dukes County, Massachusetts",16915,8381,8534,15975,305,110,151,0,132,242,0,242,16852,63,0.4654,33738,34041,34062,19135,39212,19691,34291,-666666666,16508,22311,25,007
"Essex County, Massachusetts",757395,364322,393073,608088,28733,1274,25583,146,76723,16848,3941,12907,623909,133486,0.4761,36035,40192,41978,15378,21593,16486,31675,23934,14887,15101,25,009
"Franklin County, Massachusetts",71300,34939,36361,67082,764,194,1205,16,496,1543,202,1341,68798,2502,0.4257,29658,30346,30668,15773,17736,8481,18222,,12132,22657,25,011
"Hampden County, Massachusetts",466447,224668,241779,364666,40414,1578,9572,179,39132,10906,2668,8238,363288,103159,0.4668,26249,29166,32201,12270,17846,17292,24656,23797,12425,12170,25,013
"Hampshire County, Massachusetts",160328,74993,85335,142831,4337,219,8238,123,1289,3291,560,2731,152267,8061,0.4529,29884,31388,32033,17077,17377,25363,19488,17837,18842,12185,25,015
"Middlesex County, Massachusetts",1539832,750574,789258,1225379,73785,2135,155681,300,36759,45793,7703,38090,1430948,108884,0.4728,43667,46976,48116,22087,24217,25816,40160,20768,18644,19464,25,017
"Nantucket County, Massachusetts",10414,5390,5024,8765,847,1,130,0,198,473,20,453,9661,753,0.4697,47548,51806,53682,27783,25629,,22225,-666666666,21223,25940,25,019
"Norfolk County, Massachusetts",682860,327126,355734,555624,41899,622,64377,41,7323,12974,1705,11269,657830,25030,0.4757,45375,48517,48977,29429,28536,22199,36662,97205,21123,23049,25,021
"Plymouth County, Massachusetts",500772,243600,257172,427366,44084,891,5980,287,10909,11255,2458,8797,483703,17069,0.4409,35869,38519,38893,18309,19643,26784,36641,42008,17740,16540,25,023
"Suffolk County, Massachusetts",747928,360831,387097,416449,165781,2695,63043,85,55368,44507,6099,38408,591605,156323,0.5299,33522,43738,48287,17045,20013,17567,27667,23288,16633,18542,25,025
"Worcester County, Massachusetts",806804,397633,409171,690009,35694,1716,34933,249,23054,21149,3696,17453,726316,80488,0.4461,32072,33835,35145,14725,19611,23088,32780,59676,13723,14825,25,027
"Alcona County, Michigan",10657,5389,5268,10395,21,31,36,0,11,163,27,136,10517,140,0.4251,23304,23561,23644,14322,10876,20439,26011,-666666666,,7965,26,001
"Alger County, Michigan",9516,5252,4264,8186,665,296,15,0,22,332,6,326,9397,119,0.4151,20798,22763,22979,3673,548,21711,827,-666666666,,13779,26,003
"Allegan County, Michigan",112266,55910,56356,106218,1565,747,816,0,995,1925,480,1445,104505,7761,0.4188,24599,25078,25906,11283,17642,17188,24090,-666666666,13997,12384,26,005
"Alpena County, Michigan",29242,14382,14860,28330,159,173,98,5,57,420,45,375,28890,352,0.4292,21975,22164,22254,22828,6114,10893,19572,,95986,9950,26,007
"Antrim County, Michigan",23368,11672,11696,22538,62,192,64,0,90,422,66,356,22929,439,0.4387,25725,26276,26460,10854,2769,8606,10708,-666666666,8244,13457,26,009
"Arenac County, Michigan",15564,7934,7630,15024,182,119,39,0,50,150,9,141,15297,267,0.4269,20663,20996,21144,10670,4493,20411,18538,-666666666,15568,9441,26,011
"Baraga County, Michigan",8740,5331,3409,6478,1531,423,50,2,33,223,11,212,8633,107,0.4278,17319,21425,21541,8798,2742,11292,18804,,14655,8365,26,013
"Barry County, Michigan",59107,29739,29368,57148,281,120,269,11,433,845,76,769,57672,1435,0.3941,25264,25558,25735,13997,15843,29170,17594,,12025,15538,26,015
"Bay County, Michigan",107074,52661,54413,101200,1377,372,590,13,793,2729,271,2458,101841,5233,0.4349,24538,25184,25487,16748,16118,21418,20893,,13021,9414,26,017
"Benzie County, Michigan",17450,8686,8764,16756,92,215,45,0,29,313,33,280,17100,350,0.4065,25433,25759,25921,15823,7284,14622,65096,-666666666,30152,14628,26,019
"Berrien County, Michigan",155992,76101,79891,121768,23475,614,2832,50,3223,4030,301,3729,148426,7566,0.4573,24304,27583,28022,12567,11787,20032,25741,13674,10209,9185,26,021
"Branch County, Michigan",43965,22625,21340,41670,1077,124,189,0,257,648,36,612,42137,1828,0.4325,20823,21447,22025,6601,4567,14719,16905,-666666666,10625,14078,26,023
"Calhoun County, Michigan",135150,66037,69113,112033,14721,1003,2523,10,899,3961,205,3756,128871,6279,0.4452,23202,24627,25139,12939,16996,23978,23852,,12033,7674,26,025
"Cass County, Michigan",52001,26079,25922,46237,2580,459,434,16,622,1653,58,1595,50340,1661,0.4211,23222,24361,24696,9944,14391,18355,24909,,12330,10397,26,027
"Charlevoix County, Michigan",26038,12849,13189,24797,92,333,110,11,121,574,50,524,25620,418,0.4635,27231,27967,28052,14330,16170,15356,12022,,8195,11045,26,029
"Cheboygan County, Michigan",25821,12817,13004,24082,114,482,69,0,28,1046,14,1032,25534,287,0.4437,23648,23713,23794,10436,141375,15449,18661,-666666666,6996,13873,26,031
"Chippewa County, Michigan",38698,21273,17425,27669,2615,5785,293,11,82,2243,259,1984,38110,588,0.4443,20563,23417,23526,4998,4564,17669,17796,29991,4507,12380,26,033
"Clare County, Michigan",30786,15280,15506,29721,180,146,78,0,99,562,30,532,30251,535,0.4334,18572,18822,18936,11573,8529,23497,24991,-666666666,13421,7319,26,035
"Clinton County, Michigan",76479,37842,38637,71516,1221,212,1059,27,501,1943,200,1743,73282,3197,0.4158,28889,29671,30035,17525,22677,33345,24198,,15305,9603,26,037
"Crawford County, Michigan",13941,7055,6886,13460,68,32,75,0,62,244,57,187,13720,221,0.3998,21964,22552,22620,9975,293,20366,4092,-666666666,10969,4027,26,039
"Delta County, Michigan",36841,18235,18606,34754,121,707,89,18,44,1108,41,1067,36479,362,0.4212,22525,23035,23022,17069,11696,12681,52470,,17573,7333,26,041
"Dickinson County, Michigan",26097,12926,13171,25274,123,100,144,0,37,419,65,354,25777,320,0.4404,24948,25343,25369,16325,13514,8923,12413,-666666666,40678,11274,26,043
"Eaton County, Michigan",108081,52720,55361,94827,6692,447,2044,13,1146,2912,234,2678,102640,5441,0.3983,27089,27989,28449,16888,24900,23506,24795,-666666666,17493,8857,26,045
"Emmet County, Michigan",32922,16295,16627,30447,234,855,183,55,88,1060,67,993,32449,473,0.4865,30861,32176,32279,16350,10805,17889,14339,19393,12281,12968,26,047
"Genesee County, Michigan",418654,201815,216839,312922,85459,2088,4018,105,1956,12106,755,11351,405483,13171,0.4533,22536,24965,25243,15681,14837,13423,39593,20208,22126,10114,26,049
"Gladwin County, Michigan",25599,12860,12739,24988,131,139,100,0,66,175,9,166,25275,324,0.4321,20753,20834,20942,10355,12343,24164,12314,-666666666,13048,20379,26,051
"Gogebic County, Michigan",16042,8584,7458,14598,705,488,49,6,21,175,49,126,15871,171,0.4427,20570,21668,21744,8344,6709,11211,26073,,5614,11861,26,053
"Grand Traverse County, Michigan",88981,43778,45203,84269,1253,1196,630,0,346,1287,164,1123,86779,2202,0.4506,28400,29269,29592,13201,6596,19237,12140,-666666666,19698,11592,26,055
"Gratiot County, Michigan",42057,22322,19735,38412,2426,153,48,34,271,713,175,538,39733,2324,0.4219,18922,20143,20494,12817,3078,6580,51019,15721,12980,9919,26,057
"Hillsdale County, Michigan",46282,23044,23238,45001,287,266,176,0,69,483,25,458,45365,917,0.4205,20888,21125,21173,17911,9669,13556,11108,-666666666,34546,11150,26,059
"Houghton County, Michigan",36739,19980,16759,34401,301,206,1104,7,66,654,83,571,36247,492,0.4541,19883,20009,20119,25665,33253,27782,17064,,18376,9682,26,061
"Huron County, Michigan",32525,16157,16368,31695,110,148,196,0,106,270,22,248,31854,671,0.4207,22739,22873,23087,10860,10643,12768,32232,-666666666,14551,13764,26,063
"Ingham County, Michigan",282562,137168,145394,214888,31379,1222,15309,66,5108,14590,1148,13442,261432,21130,0.4760,25010,27725,28364,15677,16514,22784,21344,16659,17642,9939,26,065
"Ionia County, Michigan",63976,34023,29953,58182,2498,272,197,0,746,2081,590,1491,61035,2941,0.3957,20549,21724,21989,11154,7627,13388,9897,-666666666,13099,7823,26,067
"Iosco County, Michigan",25504,12753,12751,24574,168,325,127,0,26,284,32,252,25031,473,0.4514,23262,23459,23476,23459,14429,23711,12572,-666666666,16262,16293,26,069
"Iron County, Michigan",11615,5731,5884,11227,95,61,29,0,30,173,13,160,11434,181,0.4200,22092,22520,22647,9010,5129,23325,11848,-666666666,,7132,26,071
"Isabella County, Michigan",70506,34251,36255,62493,1754,2227,1174,8,232,2618,114,2504,68017,2489,0.4845,19698,19818,19943,14432,7933,32027,25817,,10909,12309,26,073
"Jackson County, Michigan",159927,81870,78057,140096,13562,742,1052,69,787,3619,522,3097,154824,5103,0.4373,22879,24392,24667,12509,10722,10159,44199,7897,13025,8696,26,075
"Kalamazoo County, Michigan",254870,124800,130070,208924,28714,924,6030,88,1656,8534,462,8072,243779,11091,0.4718,25943,28062,28428,16173,14328,20689,32854,10713,17476,10650,26,077
"Kalkaska County, Michigan",17204,8731,8473,16527,114,120,65,48,94,236,12,224,16935,269,0.4245,20445,20787,20849,12344,7483,17708,4657,,12811,15672,26,079
"Kent County, Michigan",615381,301930,313451,503211,59888,3170,15063,122,14120,19807,2685,17122,554345,61036,0.4476,26436,29102,30540,12232,14639,14835,20724,21457,13090,10110,26,081
"Keweenaw County, Michigan",2197,1175,1022,2157,22,1,1,6,1,9,0,9,2187,10,0.4284,25197,25563,25611,13630,6000,,,,,,26,083
"Lake County, Michigan",11431,5842,5589,9987,994,45,9,0,25,371,9,362,11163,268,0.4495,16275,17171,17245,11778,11103,11160,11867,-666666666,12176,6991,26,085
"Lapeer County, Michigan",88155,44429,43726,84453,1057,272,416,0,698,1259,239,1020,84348,3807,0.3907,24102,24615,25062,12343,1553,23372,18289,-666666666,15855,15304,26,087
"Leelanau County, Michigan",21739,10704,11035,20220,121,714,141,6,101,436,79,357,20905,834,0.4585,32883,34350,34953,11750,4518,13661,10348,,34350,11599,26,089
"Lenawee County, Michigan",99257,50285,48972,91829,2414,440,292,25,1668,2589,357,2232,91672,7585,0.4035,22834,23748,24295,13895,7220,17367,28549,,10609,12888,26,091
"Livingston County, Michigan",183264,91544,91720,177117,767,450,1558,97,431,2844,199,2645,179458,3806,0.3854,32681,32928,33110,20417,32132,23293,36785,16190,17842,19482,26,093
"Luce County, Michigan",6512,3817,2695,5207,614,491,19,4,8,169,7,162,6428,84,0.4123,17951,20237,20341,5930,1203,13054,42668,,,19814,26,095
"Mackinac County, Michigan",11080,5575,5505,8378,162,1772,65,0,61,642,16,626,10925,155,0.4206,23453,26165,26218,9968,6981,15655,18252,-666666666,,15829,26,097
"Macomb County, Michigan",849344,412934,436410,711927,83511,2336,28504,133,4862,18071,1439,16632,829135,20209,0.4187,27145,28768,28932,20089,18898,15620,22887,25686,20215,11422,26,099
"Manistee County, Michigan",24545,12689,11856,22598,738,456,69,0,47,637,64,573,23859,686,0.4413,22649,23647,23891,12205,4246,17425,27475,-666666666,15921,12282,26,101
"Marquette County, Michigan",67535,34154,33381,63123,1141,971,445,29,112,1714,200,1514,66645,890,0.4502,23760,24616,24717,8573,3352,16408,26824,6662,10519,10324,26,103
"Mason County, Michigan",28705,14258,14447,27317,237,257,175,0,161,558,140,418,27497,1208,0.4354,23563,24184,24628,10264,9203,15985,14970,-666666666,15314,7835,26,105
"Mecosta County, Michigan",43226,21753,21473,40279,1160,168,341,16,115,1147,50,1097,42381,845,0.4401,19783,20170,20247,12027,18917,28871,9774,,8138,10019,26,107
"Menominee County, Michigan",23838,12006,11832,22628,104,458,46,3,10,589,55,534,23499,339,0.4057,22705,23287,23379,12301,10917,13164,37363,,,9222,26,109
"Midland County, Michigan",83620,41069,42551,78495,1095,374,1927,25,459,1245,171,1074,81711,1909,0.4594,29408,29674,29855,18644,13757,15128,44372,,13355,12291,26,111
"Missaukee County, Michigan",14986,7659,7327,14524,47,98,49,0,57,211,15,196,14628,358,0.3988,20594,20799,21025,8895,3911,37964,14931,-666666666,14281,5142,26,113
"Monroe County, Michigan",150851,74367,76484,142767,3462,606,859,1,1007,2149,143,2006,145966,4885,0.4119,26617,27092,27395,15460,14748,26404,41380,,15369,13627,26,115
"Montcalm County, Michigan",63046,32568,30478,59373,1390,256,241,0,324,1462,357,1105,61036,2010,0.4100,19371,19819,19950,10774,12421,17330,42852,-666666666,7864,6798,26,117
"Montmorency County, Michigan",9506,4820,4686,9258,19,86,0,0,14,129,2,127,9396,110,0.3981,20209,20411,20490,10823,2621,20277,-666666666,-666666666,,9241,26,119
"Muskegon County, Michigan",171328,84953,86375,138488,23348,978,1056,53,1033,6372,544,5828,162640,8688,0.4419,21037,23177,23711,11844,11607,13061,27973,27240,16294,9883,26,121
"Newaygo County, Michigan",48126,24241,23885,45569,647,361,168,0,679,702,111,591,45379,2747,0.4321,20713,21072,21628,10712,11508,14369,18698,-666666666,19836,10485,26,123
"Oakland County, Michigan",1220798,592491,628307,937056,168133,3127,73384,287,7540,31271,2701,28570,1176486,44312,0.4672,37089,39272,39937,20725,27263,21558,42600,50452,20780,16904,26,125
"Oceana County, Michigan",26325,13227,13098,25061,118,289,66,0,307,484,117,367,22619,3706,0.4090,19459,19763,21389,8971,9916,16391,6024,-666666666,11670,14655,26,127
"Ogemaw County, Michigan",21373,10645,10728,20731,54,153,81,0,49,305,13,292,21013,360,0.4406,20600,20815,20757,21001,15252,17824,35989,-666666666,11416,5678,26,129
"Ontonagon County, Michigan",6448,3331,3117,6237,37,63,24,1,10,76,12,64,6383,65,0.3946,21364,21688,21626,26955,9465,15338,4879,,,12583,26,131
"Osceola County, Michigan",23327,11714,11613,22573,151,152,63,3,11,374,28,346,22966,361,0.4117,18670,18949,19107,9720,4629,13315,12981,,,10151,26,133
"Oscoda County, Michigan",8525,4386,4139,8250,28,45,0,19,17,166,3,163,8427,98,0.3987,18611,18711,18724,11370,15150,40020,-666666666,-666666666,7982,11642,26,135
"Otsego County, Michigan",24126,11876,12250,23162,72,116,139,0,126,511,19,492,23789,337,0.4179,24695,25291,25315,14207,11815,24547,20083,-666666666,9385,4560,26,137
"Ottawa County, Michigan",269795,132587,137208,242326,4296,1146,7550,6,8272,6199,1513,4686,245329,24466,0.4093,25919,27283,28017,13378,12235,17877,17732,,12942,10853,26,139
"Presque Isle County, Michigan",13128,6581,6547,12789,56,70,42,6,9,156,7,149,12999,129,0.3977,22938,23082,23170,12836,6829,22256,54024,,6933,10362,26,141
"Roscommon County, Michigan",24141,12071,12070,23419,65,159,119,7,52,320,19,301,23825,316,0.4780,23074,23110,23255,10155,6308,13526,74654,,3967,12998,26,143
"Saginaw County, Michigan",197727,95723,102004,149456,36583,560,2296,83,3233,5516,796,4720,181959,15768,0.4439,22891,25574,26403,14668,13929,16467,35376,,17031,8818,26,145
"St. Clair County, Michigan",161008,79793,81215,150979,3614,337,857,0,1116,4105,528,3577,156120,4888,0.4261,24820,25496,25737,13985,14624,18750,32140,-666666666,18617,9577,26,147
"St. Joseph County, Michigan",60998,30278,30720,56495,1686,221,426,0,979,1191,117,1074,56777,4221,0.4136,21122,21619,22307,10838,14235,12078,29067,-666666666,13703,12235,26,149
"Sanilac County, Michigan",42301,20922,21379,40982,266,170,71,2,164,646,98,548,40798,1503,0.4269,21298,21634,21814,13597,7561,15520,24544,,15549,8313,26,151
"Schoolcraft County, Michigan",8345,4143,4202,7264,40,499,108,0,17,417,11,406,8273,72,0.4513,21038,21970,22053,9185,7455,18679,11333,-666666666,13624,11759,26,153
"Shiawassee County, Michigan",69553,34354,35199,67486,404,281,290,44,106,942,71,871,67739,1814,0.4121,23206,23390,23426,20807,14180,22093,29012,,15422,14292,26,155
"Tuscola County, Michigan",54795,27520,27275,52840,617,206,183,0,239,710,58,652,53125,1670,0.3896,21449,21683,21921,13375,9502,22050,39648,-666666666,20812,9790,26,157
"Van Buren County, Michigan",75569,37381,38188,66608,2873,507,451,9,2939,2182,390,1792,67504,8065,0.4211,22034,23151,24026,11169,15495,16472,33141,,11681,9522,26,159
"Washtenaw County, Michigan",351454,173390,178064,260703,42489,981,28910,74,3401,14896,1248,13648,336491,14963,0.4730,34258,37381,37923,20759,20744,16031,35675,24999,15815,20855,26,161
"Wayne County, Michigan",1790078,860155,929923,951027,710343,6317,49414,256,31226,41495,4714,36781,1692443,97635,0.4867,22643,28378,29168,14866,15621,17746,27662,28271,12980,13430,26,163
"Wexford County, Michigan",32699,16380,16319,31547,138,237,201,5,33,538,12,526,32136,563,0.4308,20473,20661,20737,13459,11025,15997,19563,,19803,14168,26,165
"Aitkin County, Minnesota",15964,8103,7861,15225,68,346,53,1,21,250,0,250,15795,169,0.4339,25378,25849,25961,12582,15538,17452,24557,,15043,11478,27,001
"Anoka County, Minnesota",336316,168202,168114,289757,15995,2037,13369,72,5579,9507,696,8811,323502,12814,0.3874,31474,33487,33863,15442,16599,20965,27346,261764,15416,10876,27,003
"Becker County, Minnesota",32971,16556,16415,29021,147,2406,144,7,97,1149,41,1108,32451,520,0.4210,25899,27275,27420,11449,14361,16336,19276,25929,24036,13640,27,005
"Beltrami County, Minnesota",45236,22654,22582,33650,386,9109,415,49,118,1509,19,1490,44408,828,0.4422,22120,25174,25319,5483,12439,12168,46175,8341,7333,11566,27,007
"Benton County, Minnesota",38980,19473,19507,36841,954,195,438,0,42,510,43,467,38267,713,0.3981,24791,25538,25778,12050,11017,7979,22886,-666666666,27624,4419,27,009
"Big Stone County, Minnesota",5180,2529,2651,5084,14,13,2,0,7,60,2,58,5124,56,0.4395,27698,27973,28060,14363,6821,32254,,-666666666,14214,10382,27,011
"Blue Earth County, Minnesota",64720,32581,32139,59808,1970,234,1299,15,267,1127,40,1087,62911,1809,0.4472,26181,27006,27273,13956,9993,26950,31841,16573,11738,7548,27,013
"Brown County, Minnesota",25513,12648,12865,24882,99,29,99,16,193,195,20,175,24609,904,0.4298,27801,28256,28776,9666,4807,8276,11974,,9509,12079,27,015
"Carlton County, Minnesota",35430,18283,17147,31760,467,1933,232,5,92,941,29,912,34879,551,0.3975,24508,25879,25951,13922,6596,14841,8720,,5454,12786,27,017
"Carver County, Minnesota",94212,46728,47484,87324,1015,163,2485,74,1116,2035,308,1727,90407,3805,0.4140,38638,39902,40462,15459,22393,12340,38278,,9844,12171,27,019
"Cass County, Minnesota",28499,14542,13957,24352,106,2935,131,74,26,875,19,856,28070,429,0.4303,25525,27661,27805,10075,16448,12997,13315,20468,20446,11594,27,021
"Chippewa County, Minnesota",12235,6055,6180,11493,94,61,68,117,149,253,3,250,11572,663,0.4045,26402,27040,27703,8921,14032,30136,88578,5777,7902,4796,27,023
"Chisago County, Minnesota",53798,27799,25999,51396,613,293,374,7,256,859,33,826,52862,936,0.3710,29293,30035,30176,16092,10437,13531,24630,,11366,11258,27,025
"Clay County, Minnesota",60249,29807,30442,55694,960,765,690,20,467,1653,160,1493,57898,2351,0.4150,25398,26389,26783,12526,13819,14347,12451,5815,18783,11352,27,027
"Clearwater County, Minnesota",8735,4424,4311,7590,17,766,41,7,7,307,38,269,8601,134,0.4282,22773,24209,24347,5990,55853,11402,26844,20886,,13575,27,029
"Cook County, Minnesota",5197,2598,2599,4534,50,366,44,21,55,127,11,116,5113,84,0.4572,33598,35421,34880,63139,22982,23038,10305,,33487,12658,27,031
"Cottonwood County, Minnesota",11676,5645,6031,10657,65,51,257,26,422,198,12,186,10877,799,0.4338,24275,25703,26204,7794,17469,21969,19503,,4119,1685,27,033
"Crow Wing County, Minnesota",62900,31463,31437,60757,480,712,315,0,86,550,22,528,62139,761,0.4392,26974,27468,27656,10247,8719,13788,23557,-666666666,23292,7971,27,035
"Dakota County, Minnesota",405521,199214,206307,342532,20814,1402,18164,235,10740,11634,1015,10619,379885,25636,0.4094,35755,38545,39275,16719,19357,23525,30775,35167,13254,12974,27,037
"Dodge County, Minnesota",20246,10116,10130,19614,107,31,101,0,179,214,0,214,19284,962,0.3826,29786,30387,31106,11812,5625,35881,9251,-666666666,10490,11741,27,039
"Douglas County, Minnesota",36413,18199,18214,35590,191,100,82,2,61,387,0,387,35964,449,0.4286,28755,29049,29190,13606,15897,22753,45982,,10608,8996,27,041
"Faribault County, Minnesota",14337,7192,7145,14002,56,49,56,0,50,124,18,106,13481,856,0.4267,25834,25645,26442,11374,20570,18620,8179,-666666666,6606,68072,27,043
"Fillmore County, Minnesota",20842,10394,10448,20492,75,33,58,0,35,149,3,146,20619,223,0.4103,26051,26269,26411,12017,20303,22552,12703,-666666666,18877,6627,27,045
"Freeborn County, Minnesota",31034,15346,15688,29496,297,105,301,12,445,378,66,312,28197,2837,0.4307,26083,26838,28125,11137,7557,10669,21654,,10086,7486,27,047
"Goodhue County, Minnesota",46336,23190,23146,43999,557,514,257,0,233,776,136,640,44934,1402,0.4328,30408,31051,31509,13208,3970,39078,21585,-666666666,24177,11995,27,049
"Grant County, Minnesota",5977,2992,2985,5840,6,16,23,0,16,76,10,66,5872,105,0.4078,27195,27368,27462,16943,,22831,18378,-666666666,6444,23997,27,051
"Hennepin County, Minnesota",1184091,582534,601557,886047,141240,8458,77744,484,27761,42357,3450,38907,1103758,80333,0.4845,38125,44311,45806,16025,16399,18852,30858,14079,13856,14525,27,053
"Houston County, Minnesota",18859,9421,9438,18359,46,49,30,0,37,338,0,338,18720,139,0.4050,26719,27102,27130,20609,2611,26906,34590,-666666666,25965,8577,27,055
"Hubbard County, Minnesota",20518,10286,10232,19406,131,404,90,10,74,403,6,397,20169,349,0.4091,25050,25782,25653,24428,4494,16097,18900,,8139,10591,27,057
"Isanti County, Minnesota",38190,19245,18945,36720,235,199,279,6,73,678,23,655,37540,650,0.3749,26406,26887,27041,15917,8814,10942,27260,,20038,11352,27,059
"Itasca County, Minnesota",45303,22904,22399,42195,188,1406,182,32,157,1143,45,1098,44789,514,0.4106,24578,25240,25338,12111,6558,16039,23764,,14282,15485,27,061
"Jackson County, Minnesota",10260,5184,5076,9809,14,18,236,2,117,64,2,62,9938,322,0.4306,27942,28136,28520,10444,4143,9361,35631,,12384,8588,27,063
"Kanabec County, Minnesota",16084,8164,7920,15597,27,190,67,0,13,190,8,182,15831,253,0.3947,22705,22901,23087,10196,34974,22918,16260,-666666666,-666666666,8555,27,065
"Kandiyohi County, Minnesota",42316,21353,20963,38837,1239,213,193,0,1239,595,88,507,37553,4763,0.4328,27550,28964,30536,11854,11553,14318,18463,-666666666,11673,9296,27,067
"Kittson County, Minnesota",4501,2245,2256,4423,20,6,20,0,3,29,8,21,4417,84,0.4175,27867,27977,28312,9581,12430,,40725,-666666666,,15128,27,069
"Koochiching County, Minnesota",13138,6577,6561,12332,97,427,63,0,1,218,22,196,13104,34,0.4470,24993,25565,25573,5368,1887,15733,18244,-666666666,,22999,27,071
"Lac qui Parle County, Minnesota",7096,3562,3534,6885,34,26,62,0,9,80,26,54,6985,111,0.4413,28913,29419,29519,15940,9579,3685,18885,-666666666,,10965,27,073
"Lake County, Minnesota",10791,5468,5323,10478,11,30,0,0,46,226,4,222,10671,120,0.4328,28058,28419,28500,18806,13991,17303,-666666666,-666666666,24224,14239,27,075
"Lake of the Woods County, Minnesota",3976,2057,1919,3767,35,15,27,0,0,132,37,95,3934,42,0.3463,23073,23768,23768,,8314,,15211,-666666666,-666666666,10148,27,077
"Le Sueur County, Minnesota",27717,14045,13672,26493,162,106,145,0,478,333,61,272,26209,1508,0.3896,28179,28825,29190,15058,11127,29501,21387,-666666666,8046,16544,27,079
"Lincoln County, Minnesota",5821,2932,2889,5676,28,8,12,0,71,26,0,26,5727,94,0.4166,25764,26173,26231,9388,5332,8488,14917,-666666666,9313,13815,27,081
"Lyon County, Minnesota",25724,12811,12913,23169,692,138,813,0,756,156,0,156,24130,1594,0.4544,27787,29078,29729,10473,28677,6557,14040,-666666666,10141,7994,27,083
"McLeod County, Minnesota",36172,17949,18223,34583,242,51,232,0,568,496,2,494,34317,1855,0.3911,27330,27978,28411,12360,3983,11908,33491,-666666666,9760,12350,27,085
"Mahnomen County, Minnesota",5486,2771,2715,2691,33,2254,23,4,40,441,15,426,5347,139,0.4505,19175,26067,26371,5317,4285,12280,33965,,20238,12636,27,087
"Marshall County, Minnesota",9447,4805,4642,9223,32,43,15,0,35,99,4,95,9083,364,0.3973,27877,28275,28778,14419,11072,19965,9740,-666666666,14109,7269,27,089
"Martin County, Minnesota",20515,10116,10399,20038,75,36,106,0,36,224,32,192,19749,766,0.4214,27629,27846,28452,10886,6197,21289,44091,-666666666,26108,8859,27,091
"Meeker County, Minnesota",23147,11752,11395,22554,101,75,86,9,84,238,14,224,22378,769,0.4085,26726,27120,27602,10518,9788,12991,8813,,14811,11302,27,093
"Mille Lacs County, Minnesota",25891,12989,12902,23601,169,1399,115,0,75,532,39,493,25453,438,0.4024,23510,24234,24354,16120,8699,15389,24063,-666666666,41637,14801,27,095
"Morrison County, Minnesota",33054,16714,16340,32167,123,59,161,0,100,444,39,405,32607,447,0.4123,24091,24418,24531,11431,10754,21051,14580,-666666666,8291,11443,27,097
"Mower County, Minnesota",39312,19654,19658,36293,986,64,749,44,462,714,187,527,35019,4293,0.4419,25209,26127,28203,9364,12250,11266,16883,,18509,7485,27,099
"Murray County, Minnesota",8586,4255,4331,8327,28,15,49,32,37,98,16,82,8321,265,0.4194,29107,29091,29592,8982,13400,18787,38984,,12930,6442,27,101
"Nicollet County, Minnesota",32923,16454,16469,30915,817,82,333,0,306,470,2,468,31612,1311,0.3909,27561,28475,28775,19056,9110,4715,24833,-666666666,19491,10638,27,103
"Nobles County, Minnesota",21589,11031,10558,17811,860,53,1164,5,1316,380,34,346,16302,5287,0.4277,23068,25087,29087,11681,10953,15053,18776,,12217,7899,27,105
"Norman County, Minnesota",6725,3357,3368,6292,29,125,34,12,51,182,12,170,6423,302,0.4142,24886,25510,25942,11436,8162,17202,30862,,9996,15519,27,107
"Olmsted County, Minnesota",147431,72094,75337,126696,7494,192,8271,10,1087,3681,178,3503,140930,6501,0.4411,34891,36954,37777,18462,15979,37556,33066,,19340,10927,27,109
"Otter Tail County, Minnesota",57417,28772,28645,55104,625,231,321,8,384,744,50,694,55774,1643,0.4293,27379,28111,28361,14457,8293,13843,9842,8063,15560,7317,27,111
"Pennington County, Minnesota",14041,6974,7067,13176,217,165,77,57,36,313,28,285,13597,444,0.4215,25584,26328,26709,11858,13524,14675,34269,,21114,10996,27,113
"Pine County, Minnesota",29347,15719,13628,26878,663,754,182,12,180,678,56,622,28581,766,0.4101,22129,23033,23267,6980,11123,16042,11821,,5077,11483,27,115
"Pipestone County, Minnesota",9407,4614,4793,8808,97,103,94,12,140,153,0,153,8999,408,0.4303,25102,26100,26268,10981,5573,13410,24172,,3204,8483,27,117
"Polk County, Minnesota",31630,16000,15630,29286,358,291,235,14,636,810,75,735,29821,1809,0.4262,25823,26869,27404,11230,15089,16028,12383,11464,12538,10836,27,119
"Pope County, Minnesota",10946,5570,5376,10722,55,47,33,0,16,73,0,73,10835,111,0.4347,29260,29554,29622,18477,7158,6881,53855,-666666666,,11589,27,121
"Ramsey County, Minnesota",521265,253159,268106,364112,57758,3338,66564,151,9346,19996,1611,18385,483415,37850,0.4609,30076,36645,38007,15695,14997,16903,15872,10663,16235,10111,27,123
"Red Lake County, Minnesota",4071,2080,1991,3888,36,53,11,0,23,60,7,53,3954,117,0.4018,24278,24944,25212,11691,,10785,20673,-666666666,16265,9218,27,125
"Redwood County, Minnesota",15834,7951,7883,14117,104,792,545,0,104,172,6,166,15444,390,0.4252,26119,27643,27827,12507,9913,18786,9051,-666666666,10892,7834,27,127
"Renville County, Minnesota",15326,7754,7572,14550,108,134,83,0,339,112,25,87,14212,1114,0.4393,28228,29003,30045,11700,5353,10046,13104,-666666666,16738,17329,27,129
"Rice County, Minnesota",64829,32934,31895,58410,2297,289,1335,64,1370,1064,171,893,59765,5064,0.4227,26192,27926,28910,12004,7599,11922,14960,11434,11797,8492,27,131
"Rock County, Minnesota",9587,4664,4923,9282,45,106,89,0,21,44,3,41,9367,220,0.4355,25586,25989,26372,6606,6840,1983,35022,-666666666,3767,7782,27,133
"Roseau County, Minnesota",15545,7925,7620,14618,92,156,412,0,29,238,14,224,15405,140,0.3991,25787,26542,26633,10971,5892,12058,15905,-666666666,18621,14070,27,135
"St. Louis County, Minnesota",200563,100738,99825,186183,3098,4347,1881,43,382,4629,136,4493,197832,2731,0.4462,26510,27511,27635,14745,10452,14796,22020,24635,12807,10956,27,137
"Scott County, Minnesota",135129,67314,67815,116503,3938,995,7801,166,2008,3718,454,3264,128925,6204,0.3830,35690,37551,37944,19720,19465,47628,29649,23892,15140,15674,27,139
"Sherburne County, Minnesota",89770,45962,43808,84576,1809,484,1032,20,236,1613,95,1518,87687,2083,0.3734,29440,30296,30574,13779,8479,19576,20752,,10223,19085,27,141
"Sibley County, Minnesota",15096,7598,7498,14648,47,25,106,0,122,148,11,137,13912,1184,0.3930,26709,26995,28017,13812,10574,,34613,-666666666,15645,9232,27,143
"Stearns County, Minnesota",151728,76411,75317,138837,5373,583,2958,23,1676,2278,141,2137,147270,4458,0.4199,26502,27792,28109,10827,10370,11806,20255,,10640,9320,27,145
"Steele County, Minnesota",36472,17940,18532,33620,881,30,319,0,952,670,132,538,33964,2508,0.4174,27596,28948,29687,12591,9192,11667,13155,-666666666,14242,10535,27,147
"Stevens County, Minnesota",9748,4844,4904,9017,65,146,170,27,124,199,6,193,9372,376,0.4990,27693,29045,29473,11165,20089,7862,4994,,25127,7142,27,149
"Swift County, Minnesota",9602,4853,4749,9265,114,37,29,0,71,86,3,83,9220,382,0.4125,27546,27867,28252,16310,17665,5627,6162,-666666666,19975,28972,27,151
"Todd County, Minnesota",24588,12622,11966,23310,90,88,85,0,657,358,12,346,23278,1310,0.4245,23062,23562,23979,12043,8522,16409,14493,-666666666,15426,11848,27,153
"Traverse County, Minnesota",3455,1725,1730,3218,6,157,0,0,8,66,0,66,3396,59,0.4577,29000,30344,30563,7237,,13077,-666666666,-666666666,,6238,27,155
"Wabasha County, Minnesota",21485,10807,10678,20995,91,45,65,0,65,224,0,224,20872,613,0.4013,29307,29419,29720,19658,12385,31373,22765,-666666666,28492,27350,27,157
"Wadena County, Minnesota",13754,6837,6917,13283,141,136,39,0,11,144,5,139,13548,206,0.4439,21384,21779,21972,10182,11838,12860,12718,-666666666,,5171,27,159
"Waseca County, Minnesota",19127,9037,10090,17963,454,115,152,0,105,338,86,252,18071,1056,0.4006,25991,26896,27779,9958,10018,13671,23438,-666666666,25408,4896,27,161
"Washington County, Minnesota",244103,120650,123453,213514,9044,870,12576,110,1788,6201,317,5884,235233,8870,0.4078,37841,39773,40346,21902,23588,25205,31274,27085,15051,13945,27,163
"Watonwan County, Minnesota",11151,5621,5530,10425,83,49,82,22,336,154,25,129,8723,2428,0.4230,26298,27054,29854,14419,26118,23696,15389,,9704,14805,27,165
"Wilkin County, Minnesota",6561,3328,3233,6370,24,62,10,0,4,91,4,87,6410,151,0.4050,26557,26901,27177,15491,4633,14323,,-666666666,,18122,27,167
"Winona County, Minnesota",51285,25128,26157,48280,683,182,1268,24,381,467,16,451,49942,1343,0.4340,24050,24679,24904,13696,10281,18471,16872,,18039,6032,27,169
"Wright County, Minnesota",127386,64133,63253,120515,1330,535,1401,3,1418,2184,323,1861,124018,3368,0.3724,30292,30929,31108,17862,16766,24749,24748,,17154,16864,27,171
"Yellow Medicine County, Minnesota",10233,5228,5005,9534,28,340,44,0,104,183,4,179,9817,416,0.4020,26487,27258,27550,12231,22325,17349,26386,-666666666,10494,13047,27,173
"Adams County, Mississippi",32189,16244,15945,12612,18264,43,97,0,951,222,41,181,30736,1453,0.5222,17656,26697,27398,4368,12309,18588,7808,-666666666,4021,6404,28,001
"Alcorn County, Mississippi",37279,18237,19042,31545,4241,85,86,0,547,775,134,641,36189,1090,0.4539,18758,20355,20520,7598,10870,8280,13644,-666666666,10425,4507,28,003
"Amite County, Mississippi",12957,6462,6495,7450,5478,3,11,0,0,15,0,15,12912,45,0.4598,17140,20136,20250,,13085,,,-666666666,-666666666,24027,28,005
"Attala County, Mississippi",19303,9112,10191,10735,8244,0,33,0,93,198,21,177,18950,353,0.4784,17894,22042,22060,11657,12520,-666666666,,-666666666,17053,8824,28,007
"Benton County, Mississippi",8573,4144,4429,5204,3140,13,0,0,129,87,0,87,8397,176,0.5216,19734,24463,23196,48093,12751,,-666666666,-666666666,6074,12177,28,009
"Bolivar County, Mississippi",33961,15949,18012,11266,21794,48,233,0,503,117,0,117,33266,695,0.4959,16666,27501,27665,10194,11031,2104,49324,-666666666,7203,4680,28,011
"Calhoun County, Mississippi",14841,7105,7736,10395,4067,5,0,89,132,153,1,152,14026,815,0.4551,17419,19888,20786,7689,11508,,-666666666,22680,12830,8082,28,013
"Carroll County, Mississippi",10418,5259,5159,6772,3517,12,29,0,0,88,10,78,10376,42,0.4770,19945,25018,25101,9664,9657,,,-666666666,-666666666,6583,28,015
"Chickasaw County, Mississippi",17376,8316,9060,9590,7522,5,46,0,92,121,58,63,16717,659,0.4697,16750,21332,21812,12650,10691,,80800,-666666666,12834,9553,28,017
"Choctaw County, Mississippi",8399,4082,4317,5700,2633,0,10,0,0,56,0,56,8362,37,0.4473,17359,20516,20555,18168,10526,-666666666,,-666666666,-666666666,16680,28,019
"Claiborne County, Mississippi",9396,4393,5003,1309,7938,20,96,0,12,21,0,21,9304,92,0.4895,11962,26939,26612,10572,9530,23040,,-666666666,,5271,28,021
"Clarke County, Mississippi",16509,7824,8685,10591,5875,3,26,0,0,14,0,14,16413,96,0.4623,18584,22654,22806,4949,11300,,,-666666666,-666666666,17271,28,023
"Clay County, Mississippi",20414,9545,10869,8273,11893,24,108,0,11,105,14,91,20168,246,0.4983,18797,28408,28744,13026,12322,,8268,-666666666,,6522,28,025
"Coahoma County, Mississippi",25527,11799,13728,5816,19381,24,152,0,38,116,1,115,25441,86,0.5230,15858,29881,29885,26917,11732,24396,5614,-666666666,,9281,28,027
"Copiah County, Mississippi",29028,13970,15058,13385,14960,3,68,0,396,216,32,184,28222,806,0.4924,18201,25780,26138,7539,11687,,8610,-666666666,10960,15451,28,029
"Covington County, Mississippi",19495,9392,10103,12269,6989,12,31,18,17,159,0,159,19097,398,0.4512,16733,19963,20269,9198,11235,,28623,,,6217,28,031
"DeSoto County, Mississippi",166266,80830,85436,120354,38383,280,2115,22,1443,3669,562,3107,158016,8250,0.3824,25593,28145,28964,13101,19630,17136,21523,37718,16720,10642,28,033
"Forrest County, Mississippi",76159,36352,39807,45457,27855,169,777,5,791,1105,132,973,73602,2557,0.5098,20075,25520,26069,10951,12154,10856,9932,,14167,8652,28,035
"Franklin County, Mississippi",7944,3895,4049,5052,2828,8,26,0,0,30,2,28,7934,10,0.4523,21294,23913,23913,,16707,,,-666666666,-666666666,2980,28,037
"George County, Mississippi",22960,11726,11234,20407,1824,48,103,0,284,294,11,283,22473,487,0.4486,20979,22536,22626,6960,9453,,3486,-666666666,5272,8536,28,039
"Greene County, Mississippi",14308,8425,5883,10257,3671,14,29,0,72,265,9,256,14164,144,0.4323,15427,18933,19044,9158,6480,,,-666666666,5029,6524,28,041
"Grenada County, Mississippi",21660,10150,11510,12105,9313,54,105,0,0,83,0,83,21626,34,0.5411,20594,27014,27023,19700,12377,5385,25181,-666666666,-666666666,10307,28,043
"Hancock County, Mississippi",45136,22131,23005,39421,3927,14,479,0,632,663,0,663,43581,1555,0.4368,22774,23922,24112,17878,14270,,14535,-666666666,21518,11727,28,045
"Harrison County, Mississippi",193642,96240,97402,135330,44251,613,5675,16,2105,5652,268,5384,183310,10332,0.4473,22224,25273,25781,17297,14702,35718,20812,,14365,11041,28,047
"Hinds County, Mississippi",246364,115527,130837,68393,172637,369,1847,53,1376,1689,214,1475,242563,3801,0.4946,20897,34703,35130,17218,15506,11124,26740,8730,17829,11540,28,049
"Holmes County, Mississippi",18965,9039,9926,3130,15668,16,62,0,0,89,0,89,18924,41,0.5177,11914,21518,21704,4285,10022,4013,11534,-666666666,-666666666,8822,28,051
"Humphreys County, Mississippi",9106,4336,4770,2072,6890,0,12,0,25,107,0,107,8892,214,0.4984,12938,21899,22125,11917,10105,-666666666,72775,-666666666,572,17989,28,053
"Issaquena County, Mississippi",1279,806,473,423,855,0,0,0,1,0,0,0,1278,1,0.4681,14548,27989,27989,,7915,-666666666,-666666666,-666666666,,-666666666,28,055
"Itawamba County, Mississippi",23415,11496,11919,21611,1523,19,43,0,58,161,28,133,23090,325,0.4487,19238,19816,19816,17406,12533,58605,14235,-666666666,16771,2699,28,057
"Jackson County, Mississippi",140194,69008,71186,102083,30673,381,3030,0,1531,2496,132,2364,133107,7087,0.4484,24162,26988,27163,22648,15730,19562,26732,-666666666,22464,10825,28,059
"Jasper County, Mississippi",16687,8091,8596,7767,8781,0,1,0,33,105,1,104,16544,143,0.4787,18398,25052,25257,7335,12790,-666666666,,-666666666,,1055,28,061
"Jefferson County, Mississippi",7634,3710,3924,1048,6558,0,28,0,0,0,0,0,7634,0,0.4856,12518,20354,20354,-666666666,11188,-666666666,,-666666666,-666666666,-666666666,28,063
"Jefferson Davis County, Mississippi",12100,5898,6202,4661,7390,0,0,0,13,36,0,36,12069,31,0.4655,15782,20697,20675,14955,12714,-666666666,-666666666,-666666666,,11542,28,065
"Jones County, Mississippi",68273,33093,35180,47139,19532,202,381,0,449,570,57,513,65281,2992,0.4707,19673,23206,23748,13134,11271,14530,41144,-666666666,10878,9834,28,067
"Kemper County, Mississippi",10310,5081,5229,3768,6093,392,6,0,0,51,0,51,10016,294,0.4588,14837,22150,23063,6797,10950,6860,,-666666666,-666666666,,28,069
"Lafayette County, Mississippi",50256,24573,25683,36037,12207,20,1139,26,318,509,83,426,49111,1145,0.5224,21838,24495,24813,12774,15273,,12933,,24254,10163,28,071
"Lamar County, Mississippi",58038,28044,29994,44240,11695,103,760,0,593,647,163,484,56702,1336,0.4639,26293,29239,29318,16286,16395,27592,30203,-666666666,11780,12258,28,073
"Lauderdale County, Mississippi",80261,38747,41514,43804,33890,171,561,0,439,1396,156,1240,78660,1601,0.4889,21669,28076,28211,14529,14006,10504,28508,-666666666,6297,10131,28,075
"Lawrence County, Mississippi",12636,6148,6488,8407,4082,10,7,0,15,115,7,108,12551,85,0.4638,20186,23127,22945,39386,13630,,,-666666666,,37091,28,077
"Leake County, Mississippi",23368,11730,11638,12187,9666,1350,4,0,97,64,0,64,22366,1002,0.4786,17178,22523,23123,13339,11547,11168,,-666666666,387,2616,28,079
"Lee County, Mississippi",84588,40367,44221,58744,23255,118,653,24,690,1104,185,919,82512,2076,0.4627,22496,26675,27089,11616,13162,5066,18183,,16984,4853,28,081
"Leflore County, Mississippi",31772,15155,16617,8008,22880,152,241,0,273,218,0,218,31011,761,0.5366,14663,27788,28412,7882,10165,10972,15257,-666666666,6738,16366,28,083
"Lincoln County, Mississippi",34824,16617,18207,23815,10686,111,14,0,13,185,11,174,34454,370,0.4529,18597,21241,21486,4359,12784,3812,,-666666666,,24859,28,085
"Lowndes County, Mississippi",59736,28463,31273,32248,26358,54,414,6,349,307,25,282,58707,1029,0.4696,21213,28020,28210,14711,13006,17080,25628,,5915,22890,28,087
"Madison County, Mississippi",98622,47208,51414,55870,37764,97,2252,0,1920,719,103,616,95797,2825,0.4948,34334,45486,45630,18701,18602,33480,43815,-666666666,10528,27981,28,089
"Marion County, Mississippi",26449,12820,13629,17525,8529,58,1,0,40,296,0,296,26092,357,0.5211,18712,21461,21778,12255,13300,,,-666666666,,5744,28,091
"Marshall County, Mississippi",36636,18085,18551,18112,17232,89,33,9,700,461,16,445,35427,1209,0.4338,18526,23371,23420,16747,13824,14315,10933,,17143,7644,28,093
"Monroe County, Mississippi",36383,17329,19054,24735,11232,0,33,15,31,337,0,337,36010,373,0.4307,18576,21553,21634,15591,12250,-666666666,86939,,43455,2355,28,095
"Montgomery County, Mississippi",10634,4970,5664,5594,5003,0,0,0,0,37,0,37,10634,0,0.4332,16761,21438,21438,-666666666,11607,-666666666,-666666666,-666666666,-666666666,,28,097
"Neshoba County, Mississippi",29596,14220,15376,17744,6319,4980,131,0,86,336,45,291,29064,532,0.4626,18888,22855,22971,4204,13182,12196,18175,-666666666,16503,16829,28,099
"Newton County, Mississippi",21671,10455,11216,13783,6605,1123,9,0,0,151,0,151,21341,330,0.4777,21157,26262,26128,28161,12700,9989,,-666666666,-666666666,7892,28,101
"Noxubee County, Mississippi",11240,5376,5864,3089,8079,59,0,0,11,2,0,2,11136,104,0.4643,14070,22584,22973,10095,10864,7878,-666666666,-666666666,,,28,103
"Oktibbeha County, Mississippi",48639,24237,24402,28375,18085,60,1385,0,244,490,53,437,47868,771,0.5399,20766,25823,25936,16444,12724,31130,25540,-666666666,13611,13509,28,105
"Panola County, Mississippi",34507,16561,17946,16757,17286,12,15,0,60,377,157,220,33960,547,0.4782,19319,27565,27713,6434,11695,,,-666666666,,2167,28,107
"Pearl River County, Mississippi",55293,27208,28085,46668,7373,119,155,0,177,801,41,760,53636,1657,0.4470,20117,21190,21369,18343,12613,10912,32276,-666666666,40412,21230,28,109
"Perry County, Mississippi",12173,5927,6246,9402,2632,0,0,0,24,115,0,115,12167,6,0.4333,16814,18330,18294,,11838,-666666666,-666666666,-666666666,49196,,28,111
"Pike County, Mississippi",40209,19120,21089,18516,20974,152,200,6,132,229,21,208,39686,523,0.4871,17671,22619,22814,10884,13512,4565,19462,,9007,11166,28,113
"Pontotoc County, Mississippi",30374,14888,15486,24126,4455,14,173,0,1286,320,0,320,28521,1853,0.4306,19481,20745,20932,14370,14506,,26835,-666666666,15863,4350,28,115
"Prentiss County, Mississippi",25338,12475,12863,21351,3580,17,31,22,119,218,0,218,25013,325,0.4454,17595,19129,19272,9936,9284,,,,20333,3051,28,117
"Quitman County, Mississippi",7902,3757,4145,2317,5502,0,18,0,27,38,0,38,7813,89,0.4803,14685,26111,26061,21184,9967,-666666666,,-666666666,,7879,28,119
"Rankin County, Mississippi",145483,70446,75037,112503,28337,290,1826,4,976,1547,116,1431,141691,3792,0.4201,27508,29924,30220,16379,19306,22248,26969,,17515,9887,28,121
"Scott County, Mississippi",28312,13695,14617,16708,10696,140,217,0,471,80,22,58,25317,2995,0.4437,16965,20989,22642,10729,10951,7749,22725,-666666666,10812,17455,28,123
"Sharkey County, Mississippi",4898,2185,2713,1397,3470,0,24,0,7,0,0,0,4850,48,0.4077,15600,25238,25465,21644,11699,-666666666,7629,-666666666,,-666666666,28,125
"Simpson County, Mississippi",27425,13185,14240,17245,9580,80,155,0,102,263,18,245,26989,436,0.4651,18728,21961,22151,12407,13245,,21706,-666666666,20141,7732,28,127
"Smith County, Mississippi",16344,7871,8473,12206,4051,0,9,0,11,67,36,31,16309,35,0.4920,21173,24756,24749,17949,10494,-666666666,,-666666666,,13940,28,129
"Stone County, Mississippi",17941,9020,8921,14111,3349,152,14,0,4,311,0,311,17662,279,0.4137,19130,21514,21677,12477,10025,16724,,-666666666,,11041,28,131
"Minidoka County, Idaho",20191,10259,9932,18058,54,101,41,6,1408,523,40,483,13523,6668,0.4186,20238,21179,24567,11598,9496,15066,43461,,8471,19900,16,067
"Nez Perce County, Idaho",39655,19686,19969,35629,140,2159,423,33,222,1049,70,979,38368,1287,0.4079,24570,25671,25889,12261,15945,16091,17681,11339,12205,11594,16,069
"Oneida County, Idaho",4241,2199,2042,4102,0,11,0,0,15,113,36,77,4101,140,0.4209,21286,21699,21799,13850,-666666666,9700,-666666666,-666666666,,8353,16,071
"Owyhee County, Idaho",11412,5920,5492,10279,9,375,17,0,323,409,25,384,8453,2959,0.4489,16733,17360,20269,8686,,7819,25612,-666666666,11811,13027,16,073
"Payette County, Idaho",22658,11464,11194,21077,57,158,86,9,445,826,172,654,19068,3590,0.4243,20332,20590,22081,11976,33,29837,12979,,16811,15904,16,075
"Power County, Idaho",7742,3856,3886,6314,8,341,2,0,907,170,146,24,5376,2366,0.3358,18184,20230,22096,11402,,6569,,-666666666,9065,13489,16,077
"Shoshone County, Idaho",12629,6355,6274,12096,44,122,82,0,19,266,0,266,12214,415,0.4157,20803,21196,21366,16457,29893,14193,5399,-666666666,33932,8256,16,079
"Teton County, Idaho",10212,5305,4907,9618,24,11,16,0,370,173,46,127,8442,1770,0.3780,23409,24041,25822,13342,,,,-666666666,13913,6547,16,081
"Twin Falls County, Idaho",78933,39092,39841,72814,458,887,1179,25,2298,1272,240,1032,67484,11449,0.4244,21167,21888,23102,12260,6628,9001,16025,8596,14310,11006,16,083
"Valley County, Idaho",9662,4980,4682,9521,3,6,16,0,1,115,29,86,9257,405,0.4031,23880,23888,24639,6789,,,-666666666,-666666666,,26921,16,085
"Washington County, Idaho",10068,5038,5030,9333,0,38,91,0,379,227,0,227,8323,1745,0.4317,19342,19904,21185,11495,-666666666,7195,15936,-666666666,9388,16237,16,087
"Adams County, Illinois",67113,32768,34345,62508,2480,83,512,26,484,1020,76,944,66223,890,0.4265,24247,25148,25202,13173,12230,8194,17505,,15015,7199,17,001
"Alexander County, Illinois",7821,3965,3856,4775,2805,30,24,0,3,184,53,131,7659,162,0.4756,14052,16285,16518,5588,10726,6017,35879,-666666666,,5258,17,003
"Bond County, Illinois",17571,9103,8468,15983,817,18,260,0,88,405,22,383,16992,579,0.4549,23232,24317,24805,7592,12767,10200,17401,-666666666,5805,9624,17,005
"Boone County, Illinois",54005,26886,27119,48297,1249,13,832,0,2663,951,356,595,43062,10943,0.4211,25950,26591,29526,12186,24544,,36040,-666666666,14946,16524,17,007
"Brown County, Illinois",6878,4335,2543,5428,1013,16,92,0,22,307,10,297,6534,344,0.4322,20518,23150,24285,5318,3185,,10022,-666666666,,36868,17,009
"Bureau County, Illinois",34361,16828,17533,32784,220,83,247,4,629,394,83,311,31556,2805,0.4291,26587,26796,27759,14283,20810,73372,27113,,21376,10611,17,011
"Calhoun County, Illinois",5033,2542,2491,4943,6,2,1,0,0,81,0,81,5020,13,0.4215,26446,26747,26738,26015,5650,,,-666666666,-666666666,10344,17,013
"Carroll County, Illinois",15027,7507,7520,14447,177,15,63,2,110,213,37,176,14553,474,0.4219,26918,27556,27911,10033,10999,3920,9579,,10014,12414,17,015
"Cass County, Illinois",13440,6868,6572,12130,475,13,10,57,581,174,39,135,11008,2432,0.4030,23423,24350,26286,13904,13327,19038,,5907,19694,5481,17,017
"Champaign County, Illinois",204214,101952,102262,151456,25470,345,19638,17,1573,5715,468,5247,193049,11165,0.4948,26087,29682,30555,16209,14974,18115,17474,,19419,12249,17,019
"Christian County, Illinois",34415,17597,16818,33169,640,48,105,34,128,291,25,266,33904,511,0.4332,24016,24496,24661,14233,3561,5863,17151,,28531,20581,17,021
"Clark County, Illinois",16240,7937,8303,15881,58,8,59,7,24,203,58,145,16034,206,0.4185,25061,25193,25356,6345,5143,,50715,,,13407,17,023
"Clay County, Illinois",13675,6745,6930,13365,55,58,17,0,36,144,0,144,13496,179,0.4038,22160,22532,22567,18509,5349,4281,27629,-666666666,16250,2065,17,025
"Clinton County, Illinois",37952,19541,18411,35659,1348,66,203,0,186,490,67,423,36825,1127,0.4041,28255,29562,30030,12780,3769,39971,11810,-666666666,28028,5817,17,027
"Coles County, Illinois",53655,25786,27869,49919,1920,59,512,60,129,1056,108,948,52439,1216,0.4887,22464,23249,23490,10184,9162,10729,24876,18717,48775,6045,17,029
"Cook County, Illinois",5227827,2531895,2695932,2975596,1264466,13278,345713,1105,515673,111996,29796,82200,3946610,1281217,0.4982,30468,38057,44486,16370,19234,21611,33167,39532,15086,19132,17,031
"Crawford County, Illinois",19626,10212,9414,18249,615,123,97,0,41,501,89,412,19232,394,0.4436,25613,26703,27094,3804,6538,32315,17557,-666666666,2017,11156,17,033
"Cumberland County, Illinois",10950,5494,5456,10697,41,31,108,5,3,65,36,29,10871,79,0.4056,22631,22874,22954,1480,5080,28119,5561,,,21834,17,035
"DeKalb County, Illinois",104919,51892,53027,87514,6987,241,2586,5,4980,2606,622,1984,93866,11053,0.4294,23903,26192,27060,10687,12357,5002,22139,,10721,6650,17,037
"De Witt County, Illinois",16461,8272,8189,15949,90,12,12,3,64,331,0,331,16100,361,0.4327,27575,28004,28277,9233,4010,54333,21150,,11561,15945,17,039
"Douglas County, Illinois",19867,9796,10071,19080,92,20,231,0,244,200,110,90,18532,1335,0.4029,24330,24718,25201,15358,9289,15435,15406,-666666666,20595,9992,17,041
"DuPage County, Illinois",926485,454215,472270,741208,43163,1699,98008,353,21093,20961,3887,17074,799343,127142,0.4501,38931,41219,44594,19496,25176,33194,36253,25990,19296,19292,17,043
"Edgar County, Illinois",18171,8862,9309,17839,117,26,65,0,0,124,23,101,17977,194,0.4625,25018,25320,25448,7440,1906,10096,19325,-666666666,-666666666,9399,17,045
"Edwards County, Illinois",6687,3285,3402,6544,38,0,15,0,0,90,33,57,6609,78,0.4101,21896,22209,22361,267,12563,-666666666,23793,-666666666,-666666666,2710,17,047
"Effingham County, Illinois",34280,17154,17126,33444,104,27,118,9,291,287,14,273,33654,626,0.4390,26774,26940,27044,17308,5914,11515,70532,,18857,7305,17,049
"Fayette County, Illinois",22041,11630,10411,21105,664,19,35,0,45,173,50,123,21690,351,0.4118,21845,22597,22814,5479,3421,39668,2254,-666666666,5547,7042,17,051
"Ford County, Illinois",13906,6897,7009,13600,74,36,38,0,6,152,2,150,13553,353,0.4286,25495,25554,25785,16780,19982,42064,50663,-666666666,,12952,17,053
"Franklin County, Illinois",39774,19602,20172,38859,103,68,137,0,33,574,2,572,39221,553,0.4308,20591,20808,20968,7094,3879,9049,23261,-666666666,8258,10398,17,055
"Fulton County, Illinois",36616,18996,17620,34641,915,60,94,16,100,790,12,778,35666,950,0.4055,22478,23039,23354,9634,3042,19213,15836,36163,12309,22422,17,057
"Gallatin County, Illinois",5439,2615,2824,5248,21,21,25,0,2,122,0,122,5426,13,0.4540,22890,23296,23325,,15714,55438,,-666666666,,4466,17,059
"Greene County, Illinois",13677,6927,6750,13369,136,16,8,0,44,104,0,104,13542,135,0.4119,22483,22727,22838,10990,185,29975,,-666666666,20327,10523,17,061
"Grundy County, Illinois",50173,25064,25109,47861,688,40,305,0,703,576,75,501,45813,4360,0.4114,29439,29811,30752,18361,12286,,76608,-666666666,18581,8838,17,063
"Hamilton County, Illinois",8371,4127,4244,8216,80,18,0,0,0,57,0,57,8253,118,0.4408,23160,23403,23514,6884,12956,,-666666666,-666666666,-666666666,177,17,065
"Hancock County, Illinois",18808,9273,9535,18389,80,39,59,1,9,231,65,166,18575,233,0.4031,24418,24724,24839,8830,2395,5882,24924,,,10503,17,067
"Hardin County, Illinois",4226,2236,1990,3990,30,5,24,0,15,162,23,139,4137,89,0.4788,21901,22039,22268,4720,2060,,54558,-666666666,,19632,17,069
"Henderson County, Illinois",7074,3460,3614,6893,21,20,20,0,17,103,23,80,6985,89,0.4139,27132,27391,27448,27700,11095,,23205,-666666666,14688,16141,17,071
"Henry County, Illinois",50031,24869,25162,46973,794,83,196,7,842,1136,245,891,47477,2554,0.4172,26845,27831,28185,14049,9805,16912,11511,,13248,11504,17,073
"Iroquois County, Illinois",29272,14292,14980,27860,387,29,147,0,542,307,62,245,27519,1753,0.4360,25234,25980,26594,10217,9540,32721,17178,-666666666,8010,10868,17,075
"Jackson County, Illinois",60125,30145,29980,46669,8790,223,1978,24,474,1967,133,1834,57628,2497,0.5352,20729,22965,23263,12365,11086,10315,26347,,14030,8054,17,077
"Jasper County, Illinois",9658,4816,4842,9452,16,16,13,0,82,79,0,79,9548,110,0.3655,25063,25160,25214,15646,19625,,2008,-666666666,18895,7609,17,079
"Jefferson County, Illinois",38716,19898,18818,33966,2959,76,383,0,210,1122,192,930,37859,857,0.4564,22849,24449,24658,8081,10735,21830,26506,-666666666,10819,7439,17,081
"Jersey County, Illinois",22751,11116,11635,22172,120,6,192,12,17,232,34,198,22488,263,0.4011,26154,26305,26228,30484,22545,,29616,2358,,9868,17,083
"Jo Daviess County, Illinois",22427,11319,11108,21926,65,39,95,6,41,255,37,218,21768,659,0.4319,29477,29637,29992,17220,17317,12828,44721,,33115,15440,17,085
"Johnson County, Illinois",12650,7141,5509,11245,1189,19,9,0,8,180,28,152,12429,221,0.4478,19684,21681,21983,3136,1863,20674,,-666666666,14038,11934,17,087
"Kane County, Illinois",521874,259759,262115,380753,28601,1787,18686,94,80995,10958,2538,8420,359826,162048,0.4346,30645,35534,40231,14953,19177,18266,34042,26215,13284,15274,17,089
"Kankakee County, Illinois",112682,55288,57394,89765,16600,246,1220,29,2319,2503,336,2167,102098,10584,0.4198,24117,26548,27719,13249,14214,19935,40116,56424,11577,6484,17,091
"Kendall County, Illinois",118194,58704,59490,99130,6876,215,3948,0,5151,2874,770,2104,99039,19155,0.3525,31110,32745,34661,17734,29500,11964,26902,-666666666,16464,12034,17,093
"Knox County, Illinois",52447,26385,26062,45798,4476,57,485,6,907,718,132,586,49741,2706,0.4327,22273,24221,24704,10549,8017,4753,17376,,10394,6762,17,095
"Lake County, Illinois",703170,350905,352265,560800,48626,1397,45941,353,27571,18482,3414,15068,559329,143841,0.4772,38459,41850,48096,15733,21334,18830,38818,27239,15594,15538,17,097
"LaSalle County, Illinois",112698,56281,56417,106603,2391,250,706,2,1081,1665,282,1383,103129,9569,0.4213,25668,26460,27312,15214,6954,23134,23054,,15255,10134,17,099
"Lawrence County, Illinois",16726,9987,6739,12554,3491,77,25,27,234,318,124,194,15832,894,0.4087,14208,18199,18862,3164,1909,9710,19172,,2627,2107,17,101
"Lee County, Illinois",35248,18426,16822,32338,1661,36,236,103,311,563,68,495,33338,1910,0.4098,24943,25901,26713,9881,6840,10797,54911,52625,17839,10541,17,103
"Livingston County, Illinois",38476,19286,19190,35320,2070,21,266,12,403,384,76,308,36847,1629,0.4203,25831,27597,28216,8653,2279,17057,30295,,9006,6002,17,105
"Logan County, Illinois",30047,15258,14789,24580,3425,61,254,16,419,1292,37,1255,29087,960,0.4326,21986,25477,25791,7486,2694,23180,13187,16913,5172,13905,17,107
"McDonough County, Illinois",32388,15928,16460,29247,1687,39,711,28,160,516,8,508,31523,865,0.4858,20592,21322,21564,9391,8430,15121,33195,39914,7119,5150,17,109
"McHenry County, Illinois",307888,153505,154383,280156,3817,484,7980,39,10118,5294,966,4328,271265,36623,0.3992,33118,34380,35979,16822,20424,15810,31204,51895,14861,14718,17,111
"McLean County, Illinois",172390,83960,88430,144824,13474,257,7944,20,2078,3793,477,3316,164444,7946,0.4562,30728,32582,33187,17383,15494,11389,33030,,19264,16698,17,113
"Macon County, Illinois",109833,52618,57215,86770,16645,175,1338,19,417,4469,149,4320,107633,2200,0.4637,26259,29381,29649,13790,13289,13609,30200,,19236,13912,17,115
"Macoupin County, Illinois",47229,23320,23909,45935,140,54,151,14,50,885,84,801,46776,453,0.4048,25402,25596,25650,18308,20550,51507,15948,43671,32036,15448,17,117
"Madison County, Illinois",267937,131010,136927,237095,21475,518,2225,97,1023,5504,662,4842,260100,7837,0.4401,28093,29526,29897,15649,16499,18159,26716,59252,25258,13043,17,119
"Marion County, Illinois",38922,18970,19952,36201,1453,46,271,0,162,789,89,700,38291,631,0.4336,22398,22955,23063,11396,16885,18604,24930,-666666666,17731,7295,17,121
"Marshall County, Illinois",12319,6089,6230,11873,59,28,41,5,187,126,16,110,11963,356,0.3838,26399,26852,26874,15931,21403,8021,16012,,10004,14194,17,123
"Mason County, Illinois",14309,7048,7261,14036,93,27,84,18,0,51,0,51,14157,152,0.4260,23937,24203,24159,28214,8116,,14999,,-666666666,3045,17,125
"Massac County, Illinois",15148,7258,7890,13794,841,22,68,0,56,367,72,295,14795,353,0.4407,23190,23796,23992,23401,16996,6277,14281,-666666666,53609,12646,17,127
"Menard County, Illinois",12658,6201,6457,12319,108,7,49,15,28,132,0,132,12506,152,0.4126,29391,29749,29972,12036,26370,,,,,8379,17,129
"Mercer County, Illinois",16204,7982,8222,15785,69,15,47,0,156,132,15,117,15877,327,0.4024,26739,27078,27211,11037,12719,13600,37930,-666666666,8360,12828,17,131
"Monroe County, Illinois",33373,16440,16933,32721,98,4,273,0,0,277,0,277,32877,496,0.3958,33059,32987,33087,21025,34858,,33399,-666666666,-666666666,39925,17,133
"Montgomery County, Illinois",29740,15626,14114,26726,2412,53,158,0,115,276,37,239,29254,486,0.4228,20067,21545,21645,15585,3840,17809,41005,-666666666,24937,5215,17,135
"Morgan County, Illinois",35272,17743,17529,32232,2177,34,109,0,50,670,18,652,34502,770,0.4277,24822,26326,26742,6043,9901,16041,11523,-666666666,3620,5168,17,137
"Moultrie County, Illinois",14896,7251,7645,14655,40,16,32,0,16,137,4,133,14733,163,0.4073,23801,23573,23704,11543,19740,,185663,-666666666,,11521,17,139
"Ogle County, Illinois",52782,26159,26623,50352,482,41,214,0,712,981,99,882,47911,4871,0.4059,27337,27923,29266,11307,25883,13434,25451,-666666666,10093,11461,17,141
"Peoria County, Illinois",187197,90636,96561,139731,32836,576,6507,19,2256,5272,290,4982,179287,7910,0.4614,28414,32096,32729,16106,14129,13663,40303,,16438,11751,17,143
"Perry County, Illinois",22034,11645,10389,19436,1852,76,89,0,194,387,69,318,21388,646,0.4305,19999,21877,22064,9058,5110,4421,24544,-666666666,7139,5399,17,145
"Piatt County, Illinois",16552,8204,8348,16185,47,0,10,0,20,290,12,278,16378,174,0.4041,31750,32169,32244,25831,6413,-666666666,16860,-666666666,28235,13244,17,147
"Pike County, Illinois",16244,8079,8165,15726,179,98,57,0,26,158,8,150,16053,191,0.4187,20925,21170,21318,7538,1696,16899,36702,-666666666,16023,15941,17,149
"Pope County, Illinois",4362,2196,2166,4092,152,10,60,0,0,48,0,48,4310,52,0.4125,21431,22086,22240,8396,8250,,8448,-666666666,-666666666,16483,17,151
"Pulaski County, Illinois",5967,2908,3059,3827,1941,18,11,0,24,146,57,89,5863,104,0.4575,19575,21962,22073,7553,16113,22744,15064,-666666666,7888,4896,17,153
"Putnam County, Illinois",5895,2969,2926,5730,4,0,18,0,49,94,0,94,5622,273,0.3989,28158,28798,29406,13959,1075,-666666666,14861,-666666666,14367,,17,155
"Randolph County, Illinois",33091,18121,14970,29225,3366,21,100,0,158,221,4,217,32188,903,0.3987,22771,24755,24809,20145,6261,14095,26121,-666666666,10744,19786,17,157
"Richland County, Illinois",16144,7989,8155,15731,69,35,86,0,2,221,16,205,15923,221,0.4285,23996,24347,24571,6037,15713,1809,11786,-666666666,,9815,17,159
"Rock Island County, Illinois",146964,72260,74704,120355,13988,461,2736,39,4913,4472,935,3537,129278,17686,0.4366,26257,28525,29861,14540,14983,14282,31713,81395,15092,10170,17,161
"St. Clair County, Illinois",268415,129381,139034,174857,80800,459,3282,55,2038,6924,541,6383,258881,9534,0.4640,26459,31750,32126,19909,15645,25153,44116,37204,19458,12734,17,163
"Saline County, Illinois",24876,12067,12809,23196,983,89,152,0,4,452,11,441,24494,382,0.4537,21295,22225,22487,3976,9681,15128,10422,-666666666,34925,3538,17,165
"Sangamon County, Illinois",198808,95365,103443,165086,24762,329,3331,57,1418,3825,284,3541,194812,3996,0.4487,30594,33586,33717,22579,14212,25338,30919,32795,15275,13309,17,167
"Schuyler County, Illinois",7454,3873,3581,7168,159,30,0,0,0,97,0,97,7310,144,0.3946,23852,24527,24930,4869,124,20527,-666666666,-666666666,-666666666,13955,17,169
"Scott County, Illinois",5260,2576,2684,5207,0,3,9,0,0,41,0,41,5180,80,0.4350,24395,24540,24860,,-666666666,,,-666666666,-666666666,7078,17,171
"Shelby County, Illinois",22216,11078,11138,21902,86,57,72,0,15,84,2,82,22017,199,0.3872,23279,23239,23310,15507,13027,61711,15361,-666666666,,26050,17,173
"Stark County, Illinois",5888,2901,2987,5740,24,0,28,0,7,89,17,72,5825,63,0.4152,27104,27446,27629,1411,15079,-666666666,29214,-666666666,,9057,17,175
"Stephenson County, Illinois",47053,22796,24257,40606,4413,48,374,0,427,1185,16,1169,45551,1502,0.4241,23686,25368,25710,10294,13166,19281,27312,-666666666,11094,8778,17,177
"Tazewell County, Illinois",135872,67084,68788,130596,1464,150,1029,17,511,2105,207,1898,133050,2822,0.4107,28953,29471,29541,22177,11486,17963,38083,,15694,8690,17,179
"Union County, Illinois",17620,8810,8810,16743,287,9,83,0,269,229,19,210,16736,884,0.4511,22430,23056,23367,12316,4595,,31461,-666666666,8645,12479,17,181
"Vermilion County, Illinois",80773,40135,40638,66879,10939,281,667,54,874,1079,110,969,77147,3626,0.4272,21924,23776,24323,10100,11725,9221,42355,,13371,7206,17,183
"Wabash County, Illinois",11730,5754,5976,11378,31,31,84,0,16,190,0,190,11567,163,0.4265,24493,24626,24757,11167,28868,,4369,-666666666,,18457,17,185
"Warren County, Illinois",17784,8744,9040,16151,566,44,257,0,578,188,22,166,16207,1577,0.4274,22923,24238,24885,9492,12969,,8971,-666666666,7511,11490,17,187
"Washington County, Illinois",14527,7259,7268,14151,146,4,54,0,73,99,6,93,14303,224,0.4260,27996,28318,28494,11272,19710,,14689,-666666666,5227,18774,17,189
"Wayne County, Illinois",16627,8181,8446,16269,95,20,84,0,32,127,4,123,16425,202,0.4277,23897,24161,24301,9050,4289,11310,13785,-666666666,5456,17991,17,191
"White County, Illinois",14549,7012,7537,14304,60,5,68,0,7,105,5,100,14375,174,0.4666,26388,26522,26642,15102,11722,,15876,-666666666,,22216,17,193
"Whiteside County, Illinois",57680,28370,29310,53197,829,177,314,122,1825,1216,466,750,51074,6606,0.4081,24815,25413,26296,14537,17328,18214,40060,11132,18352,11857,17,195
"Will County, Illinois",682108,338598,343510,514650,74884,1508,33100,121,40214,17631,4155,13476,572267,109841,0.4005,30791,33117,35167,17344,25034,22436,34916,14802,16470,13075,17,197
"Williamson County, Illinois",66808,33074,33734,61959,2741,256,565,14,187,1086,58,1028,65345,1463,0.4411,24096,25079,25280,12317,10501,1917,24441,,8552,10193,17,199
"Winnebago County, Illinois",292026,142705,149321,231858,36171,593,7144,92,7917,8251,1258,6993,258448,33578,0.4511,24802,27547,28943,13657,13181,15306,26582,35885,12142,9767,17,201
"Woodford County, Illinois",38965,19307,19658,37781,315,33,283,0,240,313,31,282,38350,615,0.3954,30300,30893,31036,13832,6226,17106,22816,-666666666,9970,6730,17,203
"Adams County, Indiana",34533,17066,17467,33682,225,65,83,0,295,183,45,138,33056,1477,0.4196,21161,21378,21660,13608,2376,27369,27916,-666666666,16824,5998,18,001
"Allen County, Indiana",360990,176041,184949,286974,42456,1057,10840,234,8396,11033,1080,9953,336340,24650,0.4457,25485,28102,28737,13580,15720,16901,22790,13642,11190,9591,18,003
"Bartholomew County, Indiana",78628,39105,39523,68855,1513,274,3452,57,3250,1227,169,1058,73711,4917,0.4292,27623,27661,27944,12660,33759,13704,44273,29111,11248,17516,18,005
"Benton County, Indiana",8810,4360,4450,8645,66,0,10,0,14,75,5,70,8351,459,0.3832,22591,22809,23437,11095,5624,-666666666,23640,-666666666,8029,14913,18,007
"Blackford County, Indiana",12576,6205,6371,12277,73,16,69,0,5,136,1,135,12412,164,0.4197,20754,20615,20647,17411,26363,,2175,-666666666,,41347,18,009
"Boone County, Indiana",59246,29326,29920,56172,761,67,1264,0,129,853,116,737,57797,1449,0.4896,38024,38329,38706,19689,24581,35493,45862,-666666666,19922,21230,18,011
"Brown County, Indiana",15074,7560,7514,14681,31,125,21,0,25,191,10,181,14862,212,0.4399,27664,27879,27962,21162,7013,35943,,-666666666,,14054,18,013
"Carroll County, Indiana",20068,10004,10064,19664,63,20,34,0,37,250,26,224,19285,783,0.3943,25040,25296,25886,9360,15740,28230,,-666666666,12173,10342,18,015
"Cass County, Indiana",38730,19399,19331,33729,580,99,476,45,3059,742,253,489,33604,5126,0.4298,21609,23034,23822,10545,11698,29748,22260,,11347,6017,18,017
"Clark County, Indiana",112212,54932,57280,99544,7742,79,903,20,1008,2916,123,2793,106622,5590,0.4136,25057,25898,26444,14645,21554,11677,18089,,17806,10616,18,019
"Clay County, Indiana",26797,13106,13691,26164,88,36,14,0,78,417,46,371,26460,337,0.4035,21520,21830,21910,12098,9788,12844,16686,-666666666,19124,5883,18,021
"Clinton County, Indiana",32987,16246,16741,30990,339,62,62,0,1188,346,119,227,28343,4644,0.3865,22205,22702,23888,12278,21850,14469,19885,-666666666,13477,9821,18,023
"Crawford County, Indiana",10646,5409,5237,10394,29,130,9,0,23,61,13,48,10496,150,0.3888,19002,19256,19453,3625,7583,5501,,-666666666,,14064,18,025
"Daviess County, Indiana",32156,16010,16146,31088,406,53,130,35,257,187,29,158,30743,1413,0.4143,21532,21675,22100,10869,14381,5115,36254,,14072,21937,18,027
"Madison County, Ohio",43326,23786,19540,39277,2618,159,363,7,140,762,31,731,42657,669,0.4168,23994,25779,25916,12913,5301,6951,14612,,9154,7207,39,097
"Mahoning County, Ohio",235809,114506,121303,189613,36425,493,1918,9,2147,5204,404,4800,223948,11861,0.4553,23628,26023,26572,12424,13348,15601,25085,,15443,11928,39,099
"Marion County, Ohio",66171,35278,30893,59735,3805,131,365,2,729,1404,111,1293,64637,1534,0.4283,20986,22269,22416,6980,5498,10179,58751,,5939,7421,39,101
"Medina County, Ohio",174091,85811,88280,166811,2318,325,1905,9,634,2089,210,1879,171025,3066,0.4037,31291,31669,31774,22800,17968,24296,37824,,12908,16519,39,103
"Meigs County, Ohio",23564,11559,12005,22983,248,44,44,0,6,239,5,234,23448,116,0.4236,19097,19199,19277,3078,20549,8211,17920,-666666666,,10465,39,105
"Mercer County, Ohio",40789,20449,20340,39781,182,26,115,207,134,344,0,344,40123,666,0.3913,24362,24559,24691,15899,27559,11312,30329,7755,19772,10652,39,107
"Miami County, Ohio",103145,50709,52436,97474,2256,162,1314,16,179,1744,60,1684,101671,1474,0.4037,25654,26132,26275,15203,15415,19294,29795,,17177,10742,39,109
"Monroe County, Ohio",14590,7280,7310,14307,62,32,0,0,0,189,0,189,14504,86,0.4199,22337,22551,22623,2674,13940,24431,-666666666,-666666666,-666666666,8603,39,111
"Montgomery County, Ohio",534801,257015,277786,394526,110924,1076,10295,242,3695,14043,927,13116,521703,13098,0.4619,25171,27709,27909,19073,17082,17593,35078,12360,12745,14567,39,113
"Morgan County, Ohio",14977,7448,7529,13967,509,33,65,0,43,360,0,360,14871,106,0.4535,21010,21594,21591,17386,17267,,10642,-666666666,2993,9605,39,115
"Morrow County, Ohio",34991,17463,17528,34155,153,18,44,0,49,572,0,572,34545,446,0.3872,22825,23062,23246,8924,20844,,,-666666666,21482,10266,39,117
"Muskingum County, Ohio",85947,41634,44313,79668,2803,166,246,10,186,2868,141,2727,85204,743,0.4269,20887,21454,21495,12042,17963,7943,9856,,30423,9100,39,119
"Noble County, Ohio",14561,8311,6250,13413,913,18,0,0,36,181,0,181,14410,151,0.4235,20719,21723,21785,9795,9012,8628,-666666666,-666666666,2158,10311,39,121
"Ottawa County, Ohio",41304,20562,20742,39546,396,37,152,19,504,650,169,481,39399,1905,0.4067,28703,29342,29597,18636,23415,41459,19834,,12259,7512,39,123
"Paulding County, Ohio",19293,9623,9670,18398,147,54,147,8,202,337,79,258,18440,853,0.4255,23565,24008,24236,16798,15560,6381,21393,18825,22479,7374,39,125
"Perry County, Ohio",36000,17962,18038,35195,137,69,69,0,45,485,23,462,35763,237,0.4120,19580,19723,19716,16088,21055,21819,3983,-666666666,5602,12005,39,127
"Pickaway County, Ohio",56279,29648,26631,52937,1802,162,227,1,77,1073,83,990,55595,684,0.4084,24341,24907,24993,11740,4834,47527,84784,,,12993,39,129
"Pike County, Ohio",28504,14231,14273,27466,233,68,68,67,62,540,19,521,28275,229,0.4463,20292,20411,20328,25762,26023,23593,20916,,,12809,39,131
"Portage County, Ohio",161553,78856,82697,148225,6440,242,2860,0,536,3250,97,3153,159158,2395,0.4289,25926,26664,26739,20622,19665,38657,18086,-666666666,18549,11851,39,133
"Preble County, Ohio",41887,20720,21167,40825,237,100,243,2,0,480,18,462,41606,281,0.4109,23603,23923,23957,13833,13023,23676,8384,,-666666666,9340,39,135
"Putnam County, Ohio",34256,17146,17110,32839,97,14,38,0,819,449,126,323,32306,1950,0.3653,26060,26584,27023,12678,28662,29214,12508,-666666666,14150,9922,39,137
"Richland County, Ohio",122813,62260,60553,107035,10426,121,770,25,620,3816,292,3524,120876,1937,0.4306,21959,23241,23266,15414,12871,10669,49410,,11795,7294,39,139
"Ross County, Ohio",77552,40861,36691,70092,4175,37,401,27,335,2485,104,2381,76716,836,0.4390,21536,22333,22401,9722,12754,10392,50222,,24407,8998,39,141
"Sandusky County, Ohio",60498,29809,30689,54865,1932,135,189,0,1912,1465,209,1256,54902,5596,0.4088,23236,24373,24870,14774,11970,21113,9660,-666666666,16005,6883,39,143
"Scioto County, Ohio",78520,38934,39586,74146,2209,307,278,0,291,1289,26,1263,77596,924,0.4671,20045,20425,20508,10192,12646,23855,21959,-666666666,10402,11713,39,145
"Seneca County, Ohio",56100,28123,27977,52822,1320,111,287,0,534,1026,147,879,53501,2599,0.4190,22552,23234,23628,12367,10726,14402,12766,-666666666,14910,10234,39,147
"Shelby County, Ohio",49165,24486,24679,46578,1191,132,326,9,135,794,70,724,48449,716,0.4262,25603,25982,26164,9699,17492,21746,32306,,9326,16325,39,149
"Stark County, Ohio",375090,181756,193334,333037,26616,479,2765,76,723,11394,462,10932,368494,6596,0.4412,24821,25996,26133,16368,15569,15180,44512,39001,14025,8298,39,151
"Summit County, Ohio",541464,262038,279426,434336,77257,949,12733,107,2147,13935,638,13297,531878,9586,0.4663,28389,30974,31101,20103,17563,21956,27950,12032,15282,10847,39,153
"Trumbull County, Ohio",207596,100899,106697,184529,17422,278,997,11,371,3988,300,3688,204468,3128,0.4253,23139,24203,24349,11964,14841,25104,31014,,17916,8602,39,155
"Tuscarawas County, Ohio",92616,45630,46986,89816,925,275,308,0,416,876,151,725,90624,1992,0.4156,22617,22805,22953,13824,14396,15765,30356,-666666666,19025,13188,39,157
"Union County, Ohio",53090,25224,27866,49203,1127,144,1452,0,108,1056,70,986,52348,742,0.4193,28648,28903,29078,12644,14517,34165,44798,-666666666,3936,11388,39,159
"Van Wert County, Ohio",28612,14036,14576,27659,283,58,87,0,210,315,39,276,27848,764,0.4164,23686,24014,24234,14272,13480,13771,36724,-666666666,22388,3121,39,161
"Vinton County, Ohio",13319,6673,6646,12955,33,8,2,0,0,321,0,321,13307,12,0.4039,18198,18449,18457,10100,,,,-666666666,-666666666,10195,39,163
"Warren County, Ohio",217623,109409,108214,196081,7718,242,9347,41,1082,3112,422,2690,212397,5226,0.4121,33421,34026,34325,20689,18760,26640,36418,191593,21089,25401,39,165
"Washington County, Ohio",61473,30139,31334,59223,667,68,444,23,90,958,61,897,60910,563,0.4495,23933,24107,24168,15574,21012,6496,42728,,6039,9980,39,167
"Wayne County, Ohio",114978,56753,58225,109889,1913,166,1000,0,375,1635,113,1522,113076,1902,0.4126,23151,23434,23562,14360,13021,27135,27035,-666666666,27241,12288,39,169
"Williams County, Ohio",37493,18549,18944,35830,424,128,161,49,420,481,129,352,36026,1467,0.3969,21413,21806,22033,12808,6144,14193,30340,31298,19017,5615,39,171
"Wood County, Ohio",128139,62751,65388,118162,3258,189,2174,9,1510,2837,772,2065,121799,6340,0.4445,27210,27941,28331,15507,13493,17666,37372,,18786,9851,39,173
"Wyandot County, Ohio",22535,11130,11405,21912,69,0,268,8,174,104,7,97,21980,555,0.3908,23266,23391,23646,13466,23372,-666666666,17142,,25107,9437,39,175
"Adair County, Oklahoma",22380,11188,11192,10086,72,8693,141,3,166,3219,41,3178,21093,1287,0.4509,15692,18378,18993,7641,18835,14656,16784,,10626,10235,40,001
"Alfalfa County, Oklahoma",5703,3434,2269,4583,131,100,2,0,157,730,29,701,5435,268,0.4747,26103,28888,29189,15782,10668,2973,,-666666666,21818,15515,40,003
"Atoka County, Oklahoma",13958,7332,6626,10377,592,1641,70,0,101,1177,15,1162,13495,463,0.4658,18587,20800,21124,12743,5700,14684,10594,-666666666,29755,10523,40,005
"Beaver County, Oklahoma",5581,2736,2845,4595,62,23,8,0,776,117,0,117,4388,1193,0.4222,25610,27940,29730,13325,2803,,,-666666666,15085,13856,40,007
"Beckham County, Oklahoma",22941,12445,10496,19551,775,314,70,8,430,1793,93,1700,19957,2984,0.4878,25654,28171,29648,10840,5814,25602,4136,,11733,11088,40,009
"Blaine County, Oklahoma",9832,5318,4514,7827,613,516,26,0,363,487,42,445,8961,871,0.4462,21130,23520,24263,9477,11433,13464,6431,-666666666,10622,11679,40,011
"Bryan County, Oklahoma",43595,21212,22383,32408,846,5605,201,14,1480,3041,55,2986,41290,2305,0.4587,20964,22696,22873,13267,15711,16643,33672,,14327,14347,40,013
"Caddo County, Oklahoma",29551,15291,14260,18499,815,6808,99,0,1372,1958,241,1717,26358,3193,0.4331,18870,22409,23066,11247,11269,13735,7680,-666666666,12804,11261,40,015
"Canadian County, Oklahoma",122832,60881,61951,101400,2883,5313,3766,12,3175,6283,612,5671,113665,9167,0.3847,28160,30232,30919,15905,18703,19718,22253,,16250,15771,40,017
"Carter County, Oklahoma",48288,23453,24835,36042,3336,4023,473,63,1027,3324,169,3155,45366,2922,0.4460,22118,24767,25256,11424,15808,15224,21668,2027,11855,11688,40,019
"Cherokee County, Oklahoma",47860,23598,24262,25428,563,14681,321,51,478,6338,203,6135,44764,3096,0.4522,18893,22122,22977,9035,12136,15840,27331,14188,11156,13803,40,021
"Choctaw County, Oklahoma",15175,7319,7856,9595,1594,1741,66,0,237,1942,143,1799,14667,508,0.4806,18739,19751,19799,11596,19805,19359,32912,-666666666,18036,11911,40,023
"Cimarron County, Oklahoma",2390,1214,1176,1979,12,18,6,0,336,39,0,39,1898,492,0.4410,24946,26993,28599,11790,825,29067,,-666666666,13449,28413,40,025
"Cleveland County, Oklahoma",264934,132363,132571,210518,11659,10841,10671,182,3821,17242,1199,16043,244944,19990,0.4345,27386,29568,30342,16865,20019,20330,21364,43106,16602,16117,40,027
"Coal County, Oklahoma",5877,2866,3011,4255,28,599,10,0,57,928,27,901,5684,193,0.4681,20968,23115,23246,12795,28768,16802,29640,-666666666,12675,13993,40,029
"Comanche County, Oklahoma",125647,65047,60600,80999,21169,6641,2548,717,2633,10940,1397,9543,110482,15165,0.4403,23035,25492,26092,19274,19526,16001,21131,22712,23999,16140,40,031
"Cotton County, Oklahoma",6157,3072,3085,4904,115,531,43,0,134,430,12,418,5753,404,0.4043,21410,23785,24083,10914,9811,15838,17486,-666666666,13386,7206,40,033
"Craig County, Oklahoma",14792,7516,7276,9851,483,2515,90,11,98,1744,45,1699,14368,424,0.4200,19936,21584,21949,9078,13050,15042,30526,30436,21299,18908,40,035
"Creek County, Oklahoma",70607,34978,35629,56295,1668,6332,366,11,695,5240,226,5014,68136,2471,0.4390,22736,24359,24575,16741,12260,16489,24821,39636,13926,17171,40,037
"Custer County, Oklahoma",28506,14397,14109,23782,839,766,395,33,486,2205,167,2038,24108,4398,0.4570,22993,24731,27237,10621,11451,16543,11558,10912,19603,13856,40,039
"Delaware County, Oklahoma",41415,20467,20948,27625,131,8899,499,24,393,3844,100,3744,40073,1342,0.4687,21476,24997,25279,9972,14327,14887,15880,14954,11777,13430,40,041
"Dewey County, Oklahoma",4817,2435,2382,4264,3,143,15,1,2,389,8,381,4547,270,0.4564,25721,27362,27758,14053,,8617,12707,,,14838,40,043
"Ellis County, Oklahoma",4113,2054,2059,3875,8,27,19,0,18,166,30,136,3825,288,0.4791,28458,28544,29510,14744,,101741,35247,-666666666,50256,12491,40,045
"Garfield County, Oklahoma",61663,30574,31089,51258,1987,1141,597,1210,2955,2515,174,2341,55404,6259,0.4325,24647,26540,27562,11080,15472,20658,39865,9504,13079,12408,40,047
"Garvin County, Oklahoma",27421,13488,13933,22430,678,1860,73,1,442,1937,147,1790,25517,1904,0.4815,21315,22421,23095,10517,22818,14801,52088,,13123,14947,40,049
"Grady County, Oklahoma",53161,26349,26812,45459,980,2640,155,46,835,3046,141,2905,50508,2653,0.4251,24286,25745,26137,12145,19862,16590,15485,10615,12767,14406,40,051
"Grant County, Oklahoma",4523,2237,2286,4101,32,27,10,0,99,254,18,236,4347,176,0.4254,28135,29195,29259,13153,12663,13774,14150,-666666666,19583,18378,40,053
"Greer County, Oklahoma",6144,3534,2610,4844,468,198,3,0,448,183,55,128,5503,641,0.4477,19837,20892,21004,22175,3170,27748,,-666666666,25793,11648,40,055
"Harmon County, Oklahoma",2883,1341,1542,1998,202,33,44,0,454,152,47,105,2127,756,0.5000,21012,26442,28436,8866,9799,14576,8534,-666666666,8829,5945,40,057
"Harper County, Oklahoma",3747,1841,1906,3575,2,1,5,0,52,112,14,98,3034,713,0.4185,23484,24230,27050,10258,,,,-666666666,5471,8509,40,059
"Haskell County, Oklahoma",12839,6351,6488,9591,95,1894,47,0,69,1143,51,1092,12373,466,0.4122,18910,20466,20750,9595,15035,14625,51719,-666666666,9188,12515,40,061
"Hughes County, Oklahoma",13840,7383,6457,9421,763,2408,5,4,171,1068,43,1025,13245,595,0.4776,18007,20673,21053,8977,5984,12281,,,8003,17684,40,063
"Jackson County, Oklahoma",26275,12996,13279,19722,1951,374,347,70,1771,2040,372,1668,20515,5760,0.4415,22569,23642,25456,13102,15503,19155,31963,,18091,10129,40,065
"Jefferson County, Oklahoma",6377,3202,3175,5281,39,478,7,0,261,311,34,277,5803,574,0.4496,18828,20385,20786,9696,12638,11258,,-666666666,8506,13874,40,067
"Johnston County, Oklahoma",11043,5425,5618,7921,165,711,76,35,163,1972,143,1829,10573,470,0.4340,19742,21488,21652,12155,20833,17532,19663,,10636,14250,40,069
"Kay County, Oklahoma",45781,22625,23156,36534,861,3728,295,8,984,3371,262,3109,42626,3155,0.4425,22741,25181,25720,13370,11354,13080,17922,,18845,11345,40,071
"Kingfisher County, Oklahoma",15202,7565,7637,13150,64,596,0,11,936,445,28,417,13054,2148,0.3889,26791,28051,29367,14845,10542,25007,-666666666,,15383,18014,40,073
"Kiowa County, Oklahoma",9379,4597,4782,7466,387,546,15,0,477,488,44,444,8454,925,0.5006,23062,25829,26222,13046,17102,13236,,-666666666,11589,7807,40,075
"Latimer County, Oklahoma",10921,5547,5374,7593,96,1592,61,0,114,1465,2,1463,10587,334,0.4669,22065,25026,25378,9741,3220,14891,26185,-666666666,18406,15866,40,077
"Le Flore County, Oklahoma",50048,25186,24862,37712,1195,4875,224,56,1524,4462,134,4328,46666,3382,0.4567,18390,20113,20566,8514,9498,14465,23497,5314,10142,13220,40,079
"Lincoln County, Oklahoma",34366,17068,17298,29515,579,2446,36,0,179,1611,62,1549,33418,948,0.4397,22752,23842,24130,12980,18370,16295,11219,-666666666,20844,14632,40,081
"Logan County, Oklahoma",43700,21632,22068,35699,4006,1624,219,2,555,1595,22,1573,41339,2361,0.4568,26284,28524,29102,15657,13847,19507,71274,,13587,12547,40,083
"Love County, Oklahoma",9574,4668,4906,8161,199,616,50,0,162,386,10,376,8300,1274,0.3988,20151,21114,22972,9309,14397,15062,27724,-666666666,14629,12223,40,085
"McClain County, Oklahoma",35860,17932,17928,30168,323,1925,221,158,979,2086,121,1965,33234,2626,0.4163,26582,27823,28222,17710,12799,25240,11203,6852,18917,18720,40,087
"McCurtain County, Oklahoma",33164,16272,16892,21892,2826,5361,18,0,531,2536,176,2360,31474,1690,0.4522,17691,19635,19782,10018,15427,13140,39856,-666666666,13903,13691,40,089
"McIntosh County, Oklahoma",20334,10035,10299,14275,706,3087,75,0,6,2185,21,2164,19868,466,0.4307,19891,22120,22283,11477,14847,15059,18791,-666666666,2650,13871,40,091
"Major County, Oklahoma",7639,3848,3791,6847,32,299,0,0,292,169,21,148,6993,646,0.4554,27225,29278,30037,8807,,12272,-666666666,-666666666,10466,3730,40,093
"Marshall County, Oklahoma",15964,7886,8078,11696,234,916,0,0,1095,2023,380,1643,13539,2425,0.4553,20831,22846,23592,13128,8559,14140,-666666666,-666666666,14634,16986,40,095
"Mayes County, Oklahoma",41084,20432,20652,27951,178,3737,182,19,22,8995,85,8910,39850,1234,0.4226,20848,23565,23704,14952,18108,14699,18635,30958,9764,15064,40,097
"Murray County, Oklahoma",13656,6913,6743,10348,223,1071,55,0,461,1498,85,1413,12925,731,0.4006,22809,25209,25287,12061,13727,16633,21004,-666666666,11177,15642,40,099
"Muskogee County, Oklahoma",70519,34519,36000,43181,7721,10513,489,10,1023,7582,61,7521,66625,3894,0.4523,20312,23395,24187,10190,13635,16329,25648,57300,11928,15814,40,101
"Noble County, Oklahoma",11498,5654,5844,9646,192,920,19,0,104,617,0,617,11161,337,0.4257,22996,25170,25356,13139,7311,12024,12926,-666666666,20512,10963,40,103
"Nowata County, Oklahoma",10555,5272,5283,7315,188,2092,39,60,30,831,3,828,10273,282,0.4173,20142,21894,22142,12990,10193,17973,24597,11663,,13467,40,105
"Okfuskee County, Oklahoma",12260,6601,5659,7869,956,1902,35,0,76,1422,59,1363,11818,442,0.4424,16664,19546,19829,7889,9877,11869,7917,-666666666,11239,12199,40,107
"Oklahoma County, Oklahoma",743145,363556,379589,510048,111251,22079,23923,613,25630,49601,2574,47027,626194,116951,0.4887,27114,31479,34892,11916,18266,19789,24716,19493,13531,13602,40,109
"Okmulgee County, Oklahoma",39606,19799,19807,26159,3316,4883,113,22,165,4948,89,4859,38211,1395,0.4387,20198,23000,23228,15103,16204,15286,6950,44264,25217,12935,40,111
"Osage County, Oklahoma",47937,24044,23893,31507,5466,7025,74,57,376,3432,25,3407,46451,1486,0.4355,22530,25434,25741,11100,18181,17003,7041,30209,14246,15230,40,113
"Ottawa County, Oklahoma",32086,15734,16352,22266,277,4832,212,266,433,3800,136,3664,30502,1584,0.4321,18231,20000,20436,8768,13088,16020,20716,8308,9196,12641,40,115
"Pawnee County, Oklahoma",16566,8283,8283,13247,171,1732,62,22,78,1254,12,1242,16155,411,0.4202,21660,22780,22920,14383,6308,18393,15855,,20194,16829,40,117
"Payne County, Oklahoma",78723,40189,38534,63696,2845,3642,3031,34,460,5015,46,4969,75421,3302,0.5002,21452,23607,23847,14976,14325,13680,12716,9474,9975,10186,40,119
"Pittsburg County, Oklahoma",45220,23075,22145,32632,1539,4335,240,10,802,5662,211,5451,43272,1948,0.4559,22719,24993,25134,13317,16023,18005,16629,,11348,16954,40,121
"Pontotoc County, Oklahoma",37873,18466,19407,27127,886,2803,210,6,61,6780,18,6762,36194,1679,0.4239,21556,23858,24511,10676,15636,18610,20235,,21287,14401,40,123
"Pottawatomie County, Oklahoma",70700,33777,36923,53875,1920,9139,437,5,662,4662,53,4609,67467,3233,0.4465,21682,24024,24410,11156,11581,15055,30186,,14590,11966,40,125
"Pushmataha County, Oklahoma",11315,5562,5753,8522,126,1463,63,3,84,1054,0,1054,10980,335,0.4797,20108,21115,21402,11451,9527,20449,3303,,14533,14262,40,127
"Roger Mills County, Oklahoma",3743,1878,1865,3392,4,54,1,5,5,282,19,263,3523,220,0.4564,26104,27166,28005,10722,,12283,,,,17025,40,129
"Rogers County, Oklahoma",88444,43990,44454,66742,882,10907,762,7,1301,7843,125,7718,84913,3531,0.4156,27488,30087,30512,17322,22429,19710,18023,,21479,18700,40,131
"Seminole County, Oklahoma",25460,12398,13062,17402,1270,4552,72,9,273,1882,146,1736,24409,1051,0.4603,18797,21488,21647,12401,15534,12186,9915,,16054,12932,40,133
"Sequoyah County, Oklahoma",41720,20599,21121,27523,869,6141,256,0,352,6579,115,6464,40212,1508,0.4324,18639,19759,19873,11134,12463,16805,10330,-666666666,9434,17296,40,135
"Stephens County, Oklahoma",44900,21947,22953,38034,1114,2759,232,10,1097,1654,219,1435,41930,2970,0.4508,23577,25107,25320,14448,10772,19279,19323,,10643,13446,40,137
"Texas County, Oklahoma",21495,11069,10426,13701,400,82,783,0,5843,686,115,571,11926,9569,0.4248,22569,24837,27841,15576,11512,27905,48395,-666666666,15383,14796,40,139
"Tillman County, Oklahoma",7811,3929,3882,5823,644,149,30,9,597,559,183,376,5939,1872,0.4276,18449,20875,22645,11100,12210,10460,11207,,13741,7492,40,141
"Tulsa County, Oklahoma",616128,300316,315812,441257,62789,28938,15669,483,20757,46235,2323,43912,545694,70434,0.4803,27995,32079,34020,13701,15705,21634,27022,13934,13428,16706,40,143
"Wagoner County, Oklahoma",74767,36931,37836,56813,2552,6520,972,0,955,6955,191,6764,70902,3865,0.4024,25239,27691,28167,15702,20934,18196,19452,-666666666,14270,15701,40,145
"Washington County, Oklahoma",51564,24829,26735,40588,1320,4999,883,0,409,3365,68,3297,48780,2784,0.4550,27514,29718,30648,12140,14225,18381,43483,-666666666,13627,17203,40,147
"Washita County, Oklahoma",11622,5745,5877,10621,94,159,15,0,168,565,11,554,10588,1034,0.4350,24213,24892,25865,11969,12043,16199,120960,-666666666,14988,15908,40,149
"Woods County, Oklahoma",8958,4843,4115,7948,322,133,39,4,168,344,43,301,8469,489,0.4547,25494,27616,28291,12946,3907,16181,8515,,6929,11532,40,151
"Woodward County, Oklahoma",20697,10978,9719,18842,225,392,10,5,346,877,9,868,18393,2304,0.4503,25767,26726,28221,17747,3908,9020,,,44536,11055,40,153
"Baker County, Oregon",16049,8104,7945,15273,37,243,105,46,49,296,13,283,15462,587,0.4574,23890,24484,24906,11904,34492,5901,12320,12900,19157,13293,41,001
"Benton County, Oregon",86034,43218,42816,75656,857,484,5190,278,925,2644,255,2389,80246,5788,0.4848,27233,28267,29081,15374,18747,33744,23673,5677,14634,12866,41,003
"Clackamas County, Oregon",384697,189438,195259,344291,3323,2565,15018,979,5690,12831,1389,11442,353763,30934,0.4411,33126,34203,35394,16027,27115,18267,32313,22620,15952,18122,41,005
"Clatsop County, Oregon",37236,18357,18879,33790,267,204,435,27,898,1615,136,1479,34290,2946,0.4329,26281,27236,27810,12428,18357,12436,53659,10770,11548,10432,41,007
"Columbia County, Oregon",49325,24643,24682,45668,100,773,558,118,677,1431,38,1393,47155,2170,0.4219,26316,27109,27484,13841,7355,13680,25656,17131,13896,16046,41,009
"Coos County, Oregon",62678,30785,31893,56070,579,1913,833,82,899,2302,62,2240,59092,3586,0.4662,22993,24094,24337,13135,11536,11132,20158,7871,10286,15436,41,011
"Crook County, Oregon",20798,10324,10474,19298,136,287,53,23,550,451,53,398,19285,1513,0.4205,20533,21184,21279,14939,9779,22170,5026,15800,9848,9998,41,013
"Curry County, Oregon",22341,10780,11561,20615,2,447,97,3,347,830,57,773,20996,1345,0.4181,24056,24581,25081,15802,,17449,21986,,18755,17077,41,015
"Deschutes County, Oregon",163141,80452,82689,152132,619,927,1982,187,3233,4061,497,3564,150724,12417,0.4651,28054,28532,29346,15395,26877,21891,30909,26984,14215,21398,41,017
"Douglas County, Oregon",107156,52920,54236,99464,331,1650,1011,106,745,3849,193,3656,101832,5324,0.4231,22074,22440,22694,15002,17008,17403,31131,13758,15169,14236,41,019
"Gilliam County, Oregon",1926,995,931,1893,11,19,0,0,3,0,0,0,1782,144,0.4156,27401,27540,28586,14531,18455,,-666666666,-666666666,,-666666666,41,021
"Grant County, Oregon",7325,3645,3680,6995,26,46,16,2,4,236,0,236,7087,238,0.4391,22878,23479,23860,10605,1481,18611,14600,,,9096,41,023
"Harney County, Oregon",7253,3675,3578,6680,45,280,82,3,63,100,8,92,6932,321,0.4232,20455,21310,21808,11673,7853,7823,6905,,23338,14200,41,025
"Hood River County, Oregon",22620,11169,11451,20272,73,135,305,71,1078,686,136,550,15774,6846,0.4091,26497,27566,32906,13256,10912,19321,28606,5077,10679,24113,41,027
"Jackson County, Oregon",206583,100809,105774,189271,1476,1647,2064,646,3267,8212,663,7549,182977,23606,0.4511,24460,25238,26549,12884,14104,15943,29963,10624,13464,14185,41,029
"Jefferson County, Oregon",21830,11306,10524,15363,153,3756,173,93,1796,496,39,457,17580,4250,0.4234,21997,25755,27475,11760,7944,14289,14738,13617,10296,14765,41,031
"Josephine County, Oregon",83021,40385,42636,77510,264,1352,502,126,835,2432,206,2226,77472,5549,0.4755,22412,22991,23513,13824,19053,13113,24978,17418,14123,12084,41,033
"Klamath County, Oregon",65985,32868,33117,58193,603,2224,735,110,1254,2866,434,2432,58590,7395,0.4360,21740,22736,23789,12111,12736,14004,22659,27088,15970,11499,41,035
"Lake County, Oregon",7854,4188,3666,7065,35,130,84,6,232,302,4,298,7269,585,0.4617,22020,23482,23804,13015,1731,7958,14455,,12256,5696,41,037
"Lane County, Oregon",354764,174261,180503,314521,3336,3781,8717,825,8062,15522,1053,14469,326885,27879,0.4667,24720,25781,26431,14222,17606,18797,22025,17726,14845,13192,41,039
"Lincoln County, Oregon",46138,22495,23643,40372,146,1303,621,67,1664,1965,231,1734,42330,3808,0.4327,25130,26520,27043,13565,19267,20783,17993,19327,13239,12417,41,041
"Linn County, Oregon",118270,58605,59665,109302,560,2219,1363,74,1941,2811,370,2441,108680,9590,0.4070,21363,21903,22539,11759,14713,14758,23258,13870,12598,12253,41,043
"Malheur County, Oregon",30740,16778,13962,25589,386,192,469,18,2636,1450,454,996,20770,9970,0.4603,16683,17926,20071,10756,8168,16993,25909,13806,10331,5559,41,045
"Marion County, Oregon",320448,159538,160910,258742,3183,4002,5966,2206,31542,14807,3391,11416,240244,80204,0.4280,22202,24302,26826,11651,15131,17477,22271,10183,11887,12035,41,047
"Morrow County, Oregon",11217,5763,5454,9725,34,95,41,12,932,378,80,298,7495,3722,0.4007,20750,21812,25406,12829,,21111,9324,,13702,11900,41,049
"Multnomah County, Oregon",757371,374175,383196,591097,41861,6482,52070,4697,26970,34194,3594,30600,673906,83465,0.4835,31047,34373,35950,15600,17404,18212,25500,11870,14589,16742,41,051
"Polk County, Oregon",76464,36768,39696,66769,387,986,1650,278,2160,4234,528,3706,66828,9636,0.4198,23891,25566,26391,13718,25970,19004,15731,19649,10909,8499,41,053
"Sherman County, Oregon",1790,883,907,1659,6,34,1,0,5,85,4,81,1693,97,0.4908,27427,28067,29347,6960,7883,15715,,-666666666,,21239,41,055
"Tillamook County, Oregon",25334,12724,12610,23191,75,217,180,84,949,638,49,589,22891,2443,0.4176,22417,23123,24111,10222,32896,13348,22646,14605,12153,14832,41,057
"Umatilla County, Oregon",76645,39967,36678,65801,488,1617,572,110,4199,3858,361,3497,57587,19058,0.4174,20887,22088,24488,12887,12214,14186,28514,11758,12319,12762,41,059
"Union County, Oregon",25736,12613,13123,23908,152,185,254,238,260,739,51,688,24648,1088,0.4664,22857,23203,23423,13855,9797,19155,50587,18812,9163,11866,41,061
"Wallowa County, Oregon",6893,3373,3520,6605,31,33,25,4,31,164,17,147,6721,172,0.4226,23996,24309,24412,16082,5648,23512,14168,,43300,12955,41,063
"Wasco County, Oregon",25387,12624,12763,21852,181,1215,281,156,1221,481,98,383,21317,4070,0.4239,21865,23353,24839,11210,18409,12146,14945,17441,12524,9330,41,065
"Washington County, Oregon",547451,269401,278050,423536,9730,4353,49411,2580,34280,23561,2533,21028,459801,87650,0.4281,31587,34087,36326,14184,25279,23161,33498,22475,11741,16675,41,067
"Wheeler County, Oregon",1357,656,701,1274,0,8,3,0,32,40,0,40,1309,48,0.4560,24154,23955,24037,15208,-666666666,11800,5233,-666666666,14044,42450,41,069
"Yamhill County, Oregon",100486,50368,50118,88226,1207,1351,1392,258,4805,3247,287,2960,85201,15285,0.4211,24018,25503,26982,12954,6107,15259,19205,18867,13378,12187,41,071
"Adams County, Pennsylvania",101566,50034,51532,93835,1526,148,710,0,3340,2007,564,1443,95132,6434,0.4032,27701,28709,29076,11931,29475,59270,21947,-666666666,10494,7576,42,001
"Allegheny County, Pennsylvania",1229172,590519,638653,996737,159671,1682,38048,308,4901,27825,1561,26264,1207828,21344,0.4850,32378,35115,35230,22504,17881,19764,38526,37279,17291,12450,42,003
"Armstrong County, Pennsylvania",68343,33913,34430,66840,657,21,130,0,179,516,40,476,67916,427,0.4134,24266,24508,24542,8458,17746,26781,9249,-666666666,3072,12178,42,005
"Beaver County, Pennsylvania",170124,82339,87785,154687,10276,151,933,19,491,3567,96,3471,167874,2250,0.4282,26925,28120,28204,18250,16904,17168,19507,,21097,7262,42,007
"Bedford County, Pennsylvania",49332,24636,24696,48310,325,96,120,0,67,414,55,359,48835,497,0.4164,23075,23275,23317,13196,11353,19341,21967,-666666666,7551,12710,42,009
"Berks County, Pennsylvania",413016,202883,210133,346306,20084,1752,5649,188,24501,14536,3057,11479,340309,72707,0.4322,26998,29331,31197,11850,16747,12486,32061,10189,12151,10610,42,011
"Blair County, Pennsylvania",126708,61789,64919,121835,2041,67,1016,0,144,1605,41,1564,125358,1350,0.4361,23785,24170,24133,24897,10998,19797,26757,-666666666,6627,10659,42,013
"Bradford County, Pennsylvania",62510,30884,31626,60929,323,61,389,6,121,681,20,661,61673,837,0.4215,24431,24658,24737,18248,7227,17887,20014,,25524,14998,42,015
"Bucks County, Pennsylvania",626205,306927,319278,559457,23611,803,25974,46,5781,10533,1679,8854,597352,28853,0.4367,37910,38930,39471,23512,22540,24128,42488,10665,20379,17670,42,017
"Butler County, Pennsylvania",185034,91379,93655,178464,2191,157,2001,52,315,1854,103,1751,182802,2232,0.4400,31818,31894,32028,20910,24904,28987,43605,93433,34283,18089,42,019
"Cambria County, Pennsylvania",140835,69499,71336,132205,4927,127,731,32,497,2316,260,2056,138717,2118,0.4388,23191,23955,24028,12162,8204,12535,51100,8653,13405,5488,42,021
"Cameron County, Pennsylvania",4939,2451,2488,4850,29,13,10,0,0,37,0,37,4909,30,0.4325,25087,25325,25410,11710,8866,32608,,-666666666,-666666666,10711,42,023
"Carbon County, Pennsylvania",64874,31986,32888,62321,851,118,320,0,379,885,45,840,62452,2422,0.4092,25294,25805,26038,16448,13466,13598,10858,-666666666,9581,14189,42,025
"Centre County, Pennsylvania",156240,81386,74854,138722,5524,314,8523,65,615,2477,272,2205,152090,4150,0.4680,25803,26913,27132,13562,14389,22306,19522,27029,14742,13863,42,027
"Chester County, Pennsylvania",506422,248929,257493,438969,30441,454,21528,67,5456,9507,1182,8325,471880,34542,0.4492,42323,44269,45961,18070,23397,25769,46896,,18346,17387,42,029
"Clarion County, Pennsylvania",39437,19266,20171,38259,443,51,221,10,100,353,17,336,39165,272,0.4391,22341,22504,22570,13720,9047,26875,35956,,29478,10383,42,031
"Clearfield County, Pennsylvania",81472,42340,39132,77842,1881,98,436,0,275,940,217,723,79305,2167,0.4196,21102,21590,21753,11458,4619,14914,44855,-666666666,3596,8414,42,033
"Clinton County, Pennsylvania",39611,19301,20310,38161,607,31,195,10,62,545,51,494,39112,499,0.4192,21595,22066,22150,10781,4491,29513,16433,,12090,10532,42,035
"Columbia County, Pennsylvania",67089,32243,34846,64049,1300,82,769,18,330,541,68,473,65512,1577,0.4542,23913,24380,24490,21259,8480,16524,16885,8811,27046,15433,42,037
"Crawford County, Pennsylvania",87801,42927,44874,84279,1597,51,363,8,138,1365,130,1235,86835,966,0.4243,22421,22928,23007,12252,10206,14653,22479,,12841,6788,42,039
"Cumberland County, Pennsylvania",239420,117974,121446,215249,8022,223,7488,55,2552,5831,933,4898,232025,7395,0.4265,32179,33468,33729,16089,15540,21126,34376,41027,16335,11926,42,041
"Dauphin County, Pennsylvania",269946,130608,139338,195993,48237,498,9147,85,7135,8851,996,7855,249266,20680,0.4434,29536,33613,34476,14619,18719,21460,28652,6621,13058,13103,42,043
"Delaware County, Pennsylvania",560775,269013,291762,401730,114783,661,27939,70,4868,10724,1148,9576,542502,18273,0.4724,33539,38657,39108,18411,19289,19249,29770,9677,13800,14134,42,045
"Elk County, Pennsylvania",31584,15726,15858,31045,195,67,118,0,66,93,0,93,31373,211,0.3918,24071,23974,24011,14878,24594,13063,72912,-666666666,14983,7753,42,047
"Erie County, Pennsylvania",280132,137955,142177,246195,19892,761,3800,58,2580,6846,833,6013,269946,10186,0.4547,24505,26043,26361,11315,14090,17524,18625,18378,13613,7638,42,049
"Fayette County, Pennsylvania",135376,66674,68702,125855,5430,123,194,228,349,3197,159,3038,134117,1259,0.4382,21319,21897,21931,10275,14509,14534,37303,12382,8692,11453,42,051
"Forest County, Pennsylvania",7649,5332,2317,5430,1775,58,49,0,164,173,55,118,7215,434,0.4027,13680,18027,18482,1758,2395,4203,22812,-666666666,1923,4783,42,053
"Franklin County, Pennsylvania",151517,74170,77347,141071,5604,376,1368,17,1192,1889,259,1630,144415,7102,0.3908,25540,26302,26897,11758,15408,10416,23553,,14749,10056,42,055
"Fulton County, Pennsylvania",14747,7412,7335,14338,205,36,22,8,35,103,4,99,14599,148,0.3852,23192,23501,23585,9107,10972,20356,29627,,13483,8705,42,057
"Greene County, Pennsylvania",38171,19867,18304,35245,2052,173,73,3,121,504,77,427,37675,496,0.4231,22847,24124,24155,7683,5647,11155,33784,,13314,8494,42,059
"Huntingdon County, Pennsylvania",45950,24221,21729,42559,2439,22,214,3,163,550,57,493,45160,790,0.4057,20918,21959,22119,8097,7044,18073,11919,,6813,9831,42,061
"Indiana County, Pennsylvania",88301,44329,43972,83466,2226,201,993,44,359,1012,138,874,87185,1116,0.4593,23577,23894,23967,10095,8354,18575,52579,6716,10693,8826,42,063
"Jefferson County, Pennsylvania",44935,22313,22622,44071,202,92,96,5,62,407,46,361,44615,320,0.4115,21952,22050,22076,15377,9686,12721,64822,,17277,9828,42,065
"Juniata County, Pennsylvania",24793,12307,12486,24016,208,44,101,0,240,184,18,166,24101,692,0.3952,22134,22500,22739,9508,10830,3468,11444,-666666666,14165,7837,42,067
"Lackawanna County, Pennsylvania",214023,103234,110789,199025,6241,307,4185,52,1552,2661,398,2263,202002,12021,0.4538,25624,26370,27090,11771,14021,17342,20609,14483,14822,12338,42,069
"Lancaster County, Pennsylvania",526839,257612,269227,468217,20803,938,10695,29,16153,10004,2031,7973,477855,48984,0.4175,26892,28342,29134,13179,16528,18390,22431,23634,12002,10186,42,071
"Lawrence County, Pennsylvania",89859,43351,46508,83876,3662,62,302,8,431,1518,92,1426,88853,1006,0.4355,23519,24292,24369,15395,12540,42534,28683,,12627,8716,42,073
"Lebanon County, Pennsylvania",135184,65974,69210,119698,2550,168,1430,0,8138,3200,1208,1992,121074,14110,0.4081,27060,28643,29122,13740,17389,24230,27748,-666666666,13505,9850,42,075
"Lehigh County, Pennsylvania",354537,172366,182171,283138,23075,800,10951,9,26304,10260,2087,8173,282553,71984,0.4450,28139,30722,33203,13292,17258,21866,36072,,12648,13026,42,077
"Luzerne County, Pennsylvania",320392,157499,162893,291506,12063,944,3192,122,7595,4970,1117,3853,294763,25629,0.4518,25091,26302,27041,11235,10619,8916,31243,10293,11540,9374,42,079
"Lycoming County, Pennsylvania",116676,57253,59423,107551,5522,148,687,32,607,2129,131,1998,114779,1897,0.4224,23531,24433,24469,14733,12886,13139,32000,,8070,8160,42,081
"McKean County, Pennsylvania",43024,22054,20970,40866,1036,115,212,0,235,560,92,468,42195,829,0.4177,23034,22542,22557,19687,49672,10465,28960,-666666666,18099,12031,42,083
"Mercer County, Pennsylvania",115739,56870,58869,105827,6640,80,817,10,459,1906,121,1785,114371,1368,0.4303,23195,24181,24231,15201,13256,23823,15530,,17912,7727,42,085
"Mifflin County, Pennsylvania",46705,23006,23699,45553,331,28,206,7,73,507,63,444,46121,584,0.4020,20772,20931,20953,14977,23826,13732,18456,,1670,7897,42,087
"Monroe County, Pennsylvania",168342,83140,85202,132910,22960,612,3428,85,3962,4385,697,3688,144932,23410,0.4051,25266,25939,26841,18559,24071,32284,29694,,16206,15155,42,089
"Montgomery County, Pennsylvania",809372,392969,416403,658510,71761,777,54828,113,6515,16868,1685,15183,772782,36590,0.4604,41699,44399,45271,23253,27120,23482,38208,29283,20133,18928,42,091
"Montour County, Pennsylvania",18475,8936,9539,17489,303,11,487,0,39,146,53,93,18083,392,0.4731,30455,30391,30759,9571,13271,34018,48424,-666666666,37403,11819,42,093
"Northampton County, Pennsylvania",299225,146479,152746,258567,15394,914,8084,50,7669,8547,1453,7094,265443,33782,0.4322,30116,31567,32598,17607,22240,23145,31161,50472,15355,13292,42,095
"Northumberland County, Pennsylvania",94294,47612,46682,89921,2426,169,296,60,476,946,206,740,91689,2605,0.4206,22633,23248,23513,8447,6331,11219,27316,983,6688,15956,42,097
"Perry County, Pennsylvania",45788,22909,22879,44477,297,47,160,2,226,579,14,565,45097,691,0.3660,26242,26595,26719,13650,13861,19047,16413,,14087,13615,42,099
"Philadelphia County, Pennsylvania",1546920,730499,816421,642945,665750,5289,103400,1538,87388,40610,8071,32539,1345345,201575,0.5104,22542,31111,33391,12956,16902,14436,19530,13748,11194,12822,42,101
"Pike County, Pennsylvania",56883,28351,28532,50800,3065,64,732,16,849,1357,274,1083,51415,5468,0.4053,27935,28186,28387,24757,29986,18047,32761,,24431,13763,42,103
"Potter County, Pennsylvania",17451,8725,8726,17076,89,27,52,3,46,158,9,149,17260,191,0.4393,22997,23193,23282,13831,15154,16948,10029,,34489,8310,42,105
"Schuylkill County, Pennsylvania",147146,74906,72240,138936,4156,138,859,31,1209,1817,212,1605,142453,4693,0.4152,23249,24062,24308,10930,7300,10098,18042,13994,10813,9504,42,107
"Snyder County, Pennsylvania",39922,19804,20118,38706,360,25,278,5,199,349,35,314,39136,786,0.4320,23886,23895,24111,9942,22181,,51741,5360,10266,8603,42,109
"Somerset County, Pennsylvania",77011,39793,37218,73765,1924,118,215,7,312,670,47,623,76067,944,0.4198,22618,23159,23230,9072,5249,22203,30782,,5278,18273,42,111
"Sullivan County, Pennsylvania",6400,3275,3125,6070,166,20,36,33,12,63,0,63,6322,78,0.4191,23418,24169,24239,17854,3659,24155,30000,,32517,4930,42,113
"Susquehanna County, Pennsylvania",42708,21490,21218,41833,233,108,100,0,110,324,3,321,42037,671,0.4172,25454,25708,25837,14421,17333,17058,23992,-666666666,10277,6938,42,115
"Tioga County, Pennsylvania",42358,20962,21396,41199,252,72,218,5,26,586,43,543,41832,526,0.4279,23596,23858,23973,13681,9529,12829,22851,,4108,13842,42,117
"Union County, Pennsylvania",44955,24652,20303,39409,3295,168,540,11,674,858,209,649,42475,2480,0.4496,22858,24747,25371,6144,8717,2146,12733,,6757,13744,42,119
"Venango County, Pennsylvania",54265,26610,27655,52530,459,40,214,1,77,944,63,881,53723,542,0.4101,22923,23172,23233,10139,18639,3788,15808,,13083,14402,42,121
"Warren County, Pennsylvania",41218,20625,20593,40291,257,108,167,0,72,323,18,305,40864,354,0.4359,25054,25137,25211,11168,8154,15202,61895,-666666666,5786,16615,42,123
"Washington County, Pennsylvania",208157,101521,106636,195764,6580,82,1685,0,468,3578,134,3444,205413,2744,0.4468,29816,30546,30634,19350,18290,5600,33242,-666666666,15212,11907,42,125
"Wayne County, Pennsylvania",51967,27489,24478,48993,1783,95,291,10,275,520,93,427,49975,1992,0.4178,24132,24896,25046,17536,8842,9661,31288,,9533,11037,42,127
"Westmoreland County, Pennsylvania",362587,176656,185931,344938,8518,488,3194,28,549,4872,288,4584,358970,3617,0.4397,28654,29191,29241,18862,15810,20129,32479,24504,15955,12921,42,129
"Wyoming County, Pennsylvania",28229,14245,13984,27482,187,10,135,0,81,334,15,319,27753,476,0.4149,25306,25573,25778,12589,11463,19210,34624,-666666666,16119,9751,42,131
"York County, Pennsylvania",438052,216406,221646,388492,24005,367,5991,68,8788,10341,1224,9117,411285,26767,0.4124,28454,29889,30511,12294,18109,28378,32525,18485,12484,9866,42,133
"Bristol County, Rhode Island",49338,23626,25712,47039,341,50,756,16,140,996,49,947,48257,1081,0.4770,38312,39085,39313,21455,40472,,28644,12594,4871,15283,44,001
"Kent County, Rhode Island",165253,79773,85480,153331,2289,206,3939,11,2299,3178,512,2666,159079,6174,0.4432,34110,34907,35250,20659,32730,26682,27671,,21644,13886,44,003
"Newport County, Rhode Island",82772,40552,42220,74217,2871,195,1281,106,1202,2900,264,2636,78788,3984,0.4639,41326,43465,44244,17862,24699,10991,39754,,14641,18262,44,005
"Providence County, Rhode Island",629280,304502,324778,463553,59433,3449,24613,397,57311,20524,5688,14836,504136,125144,0.4809,26690,30541,32859,12970,16167,14152,21468,16685,13641,15211,44,007
"Washington County, Rhode Island",126609,61373,65236,118465,1893,1051,2405,6,1042,1747,199,1548,123160,3449,0.4329,36805,37948,38119,25656,14411,22261,26661,,24489,13740,44,009
"Abbeville County, South Carolina",25100,12188,12912,17417,7233,40,1,0,29,380,9,371,24961,139,0.4280,18303,20660,20502,37758,13452,20150,,-666666666,8838,3195,45,001
"Aiken County, South Carolina",162991,78854,84137,114191,40583,373,1321,16,3659,2848,114,2734,154568,8423,0.4570,25093,28525,28885,14778,16392,21201,47505,,10441,20536,45,003
"Allendale County, South Carolina",10027,5334,4693,2439,7412,3,0,0,167,6,0,6,9758,269,0.4636,12277,19266,19898,10220,9888,,-666666666,-666666666,13541,,45,005
"Anderson County, South Carolina",189763,91562,98201,152139,31146,453,1297,84,1515,3129,236,2893,183686,6077,0.4458,22216,24086,24235,15956,15086,14411,22967,31493,10507,8485,45,007
"Bamberg County, South Carolina",15649,7488,8161,5619,9759,0,60,0,159,52,0,52,15459,190,0.5167,19136,29210,29378,16805,13350,-666666666,28382,-666666666,19123,5723,45,009
"Barnwell County, South Carolina",22287,10555,11732,11566,9985,145,158,0,293,140,0,140,21798,489,0.4843,18695,23190,23198,22816,13466,14613,6078,-666666666,28560,18082,45,011
"Beaufort County, South Carolina",168453,83022,85431,123152,31513,434,1959,67,7558,3770,575,3195,148748,19705,0.4604,32290,37752,40088,13870,17395,29940,33448,20722,14581,13761,45,013
"Berkeley County, South Carolina",188835,94192,94643,127306,46763,973,4586,134,3788,5285,575,4710,177447,11388,0.4231,24474,27558,28162,16777,18172,11685,22085,43334,16643,15504,45,015
"Calhoun County, South Carolina",15031,7208,7823,8137,6351,15,6,0,327,195,22,173,14549,482,0.4564,23042,29948,30256,12405,14859,,,-666666666,12486,9337,45,017
"Charleston County, South Carolina",365674,177204,188470,243775,105752,574,4651,139,3724,7059,547,6512,346634,19040,0.4965,31198,38776,40154,15722,15328,24453,34883,31471,14363,14271,45,019
"Cherokee County, South Carolina",55707,27050,28657,42297,11119,135,247,11,869,1029,79,950,53539,2168,0.4820,19185,20605,21094,9489,15418,4105,6382,,14511,10707,45,021
"Chester County, South Carolina",32708,15924,16784,19612,12303,210,62,9,43,469,99,370,32171,537,0.4767,18433,21145,21191,13878,14255,13406,54144,,3553,13797,45,023
"Chesterfield County, South Carolina",46333,22609,23724,29884,15238,281,64,0,232,634,43,591,44585,1748,0.4606,17317,19792,20137,13220,12923,21404,10772,-666666666,12734,6805,45,025
"Clarendon County, South Carolina",34439,16894,17545,16472,17006,46,38,0,432,445,45,400,33471,968,0.4835,17517,24365,24745,7822,11351,12609,2876,-666666666,10314,8439,45,027
"Colleton County, South Carolina",38247,18287,19960,22259,14723,284,8,370,240,363,52,311,37133,1114,0.4541,18517,22345,22813,9401,13787,7948,,3284,8548,6361,45,029
"Darlington County, South Carolina",68161,32188,35973,38624,27651,161,352,0,301,1072,30,1042,66932,1229,0.4745,19800,25171,25428,11906,12958,16504,20220,-666666666,4913,7268,45,031
"Dillon County, South Carolina",31529,14614,16915,15084,14509,708,92,6,492,638,0,638,30733,796,0.4705,15010,18915,18915,9588,11694,11895,39518,,9000,2635,45,033
"Dorchester County, South Carolina",142772,69529,73243,97593,36189,850,2308,113,1110,4609,258,4351,136085,6687,0.4081,24633,28082,28673,13975,17615,19720,23110,15858,12434,11545,45,035
"Edgefield County, South Carolina",26573,14426,12147,15835,9762,69,84,0,382,441,118,323,25110,1463,0.4369,20809,25097,26248,7510,14974,6223,23048,-666666666,10657,6666,45,037
"Fairfield County, South Carolina",23382,11185,12197,9046,13481,0,56,0,271,528,31,497,22957,425,0.4976,20993,29237,29262,18568,16130,-666666666,34909,-666666666,16159,4912,45,039
"Florence County, South Carolina",138058,64618,73440,76053,57391,278,1556,0,524,2256,49,2207,134862,3196,0.4697,22522,27900,28180,16544,15365,22645,45331,-666666666,18707,8450,45,041
"Georgetown County, South Carolina",60389,28757,31632,38459,20036,103,245,15,1120,411,104,307,58530,1859,0.4852,24483,30981,31237,11781,12953,,19341,,9266,26572,45,043
"Greenville County, South Carolina",467087,226871,240216,357002,84979,1072,9749,206,5494,8585,1303,7282,427520,39567,0.4752,27097,29928,31324,14808,17298,25411,31136,13447,13093,11316,45,045
"Greenwood County, South Carolina",69708,32597,37111,44378,21631,16,549,87,1511,1536,90,1446,65778,3930,0.4756,21050,25042,25780,8245,14717,3525,17296,,6553,11175,45,047
"Hampton County, South Carolina",20670,10643,10027,8809,11092,27,89,29,437,187,25,162,19891,779,0.4878,19849,28472,26632,35991,13715,5259,15116,,8216,8769,45,049
"Horry County, South Carolina",283280,137948,145332,227453,38980,942,3321,190,7542,4852,388,4464,265890,17390,0.4453,23693,25975,26472,12379,14606,14129,23880,8071,11828,10491,45,051
"Jasper County, South Carolina",26042,13716,12326,12287,11685,0,156,0,1533,381,0,381,22308,3734,0.4263,17606,21196,23120,12255,14553,-666666666,32216,-666666666,13769,4912,45,053
"Kershaw County, South Carolina",62342,30061,32281,44386,15541,113,280,0,900,1122,174,948,59843,2499,0.4369,21851,24697,24879,14250,15399,19883,12410,-666666666,10839,10033,45,055
"Lancaster County, South Carolina",79515,39092,40423,58803,18453,320,516,51,529,843,79,764,75720,3795,0.4489,21943,25070,25785,11236,12637,29836,21113,124237,8049,7638,45,057
"Laurens County, South Carolina",66390,32150,34240,47014,16881,74,176,0,1143,1102,66,1036,63577,2813,0.4478,19953,22014,22339,9465,15780,29949,9286,-666666666,6340,11119,45,059
"Lee County, South Carolina",18708,9792,8916,6194,11973,25,19,0,193,304,35,269,18337,371,0.4537,15095,22558,22583,9832,11515,8520,,-666666666,8517,8656,45,061
"Lexington County, South Carolina",270263,132046,138217,216946,38656,745,3890,134,3949,5943,698,5245,254846,15417,0.4271,27026,29335,30051,15105,18005,23766,24967,17426,13595,12310,45,063
"McCormick County, South Carolina",10003,5476,4527,4922,4949,6,11,0,0,115,0,115,9897,106,0.4869,21730,32693,32837,17918,11190,,,-666666666,-666666666,6914,45,065
"Marion County, South Carolina",32411,14862,17549,13333,18106,155,225,0,195,397,22,375,31557,854,0.4802,16743,23698,24259,11475,11781,13207,21907,-666666666,19523,6499,45,067
"Marlboro County, South Carolina",28294,14942,13352,11709,14386,1295,76,27,298,503,175,328,27446,848,0.4741,14925,18176,18696,9375,12753,9915,36754,1856,9889,14691,45,069
"Newberry County, South Carolina",37593,18259,19334,23102,11395,37,207,17,2190,645,138,507,34851,2742,0.4416,22073,27296,27657,12915,13581,,24779,,14640,9665,45,071
"Oconee County, South Carolina",74656,36772,37884,66105,5649,121,438,0,906,1437,281,1156,71172,3484,0.4742,24321,25468,25946,11014,16298,39158,27920,-666666666,10942,9198,45,073
"Orangeburg County, South Carolina",91262,43000,48262,31417,56695,560,915,16,839,820,46,774,89435,1827,0.4750,17645,24783,25151,7038,13920,11148,22320,,10360,8702,45,075
"Pickens County, South Carolina",119577,59561,60016,106133,7810,453,2022,107,1218,1834,324,1510,115654,3923,0.4504,21090,21925,22120,13092,15418,11282,19597,,11721,8152,45,077
"Richland County, South Carolina",393707,191300,202407,185545,180848,674,10106,325,6705,9504,1029,8475,374295,19412,0.4643,25920,33658,34500,17689,19088,22530,23152,12530,18132,13994,45,079
"Saluda County, South Carolina",19973,10142,9831,12577,5261,11,0,0,1878,246,39,207,17051,2922,0.4531,19601,24051,24738,12074,12469,,-666666666,-666666666,10082,17759,45,081
"Spartanburg County, South Carolina",288728,140128,148600,210995,59639,575,6240,86,5706,5487,629,4858,271056,17672,0.4476,22330,24971,25602,12370,15632,14610,19385,24259,12873,7541,45,083
"Sumter County, South Carolina",107782,51909,55873,52752,50095,251,1383,0,933,2368,256,2112,103968,3814,0.4407,20395,25917,26305,17081,15266,9705,17846,-666666666,16906,9878,45,085
"Union County, South Carolina",28329,13539,14790,18817,8723,46,49,0,121,573,4,569,28020,309,0.4416,19253,22205,22141,18376,14043,11587,,-666666666,5729,5125,45,087
"Williamsburg County, South Carolina",33560,16348,17212,10748,22153,5,65,0,148,441,152,289,32836,724,0.5016,15933,22445,22847,12391,12950,,9917,-666666666,14993,8311,45,089
"York County, South Carolina",235285,113478,121807,177995,43862,1479,3566,87,2381,5915,178,5737,224150,11135,0.4495,26875,29703,30387,15876,18520,16153,28419,19878,18073,9111,45,091
"Aurora County, South Dakota",2729,1395,1334,2568,37,72,10,0,22,20,2,18,2581,148,0.4028,24074,25064,25536,10007,21524,2846,,-666666666,,,46,003
"Beadle County, South Dakota",17922,8966,8956,16119,112,221,1022,0,208,240,44,196,16344,1578,0.4355,24265,25721,27265,9859,35575,8123,7880,-666666666,20523,9058,46,005
"Bennett County, South Dakota",3440,1667,1773,1029,36,1825,0,0,0,550,0,550,3309,131,0.4920,16032,26538,27925,8105,7086,12217,-666666666,-666666666,-666666666,9619,46,007
"Bon Homme County, South Dakota",7032,4069,2963,6354,44,392,37,0,113,92,0,92,6744,288,0.4495,21983,23227,22851,22269,8170,5256,54143,-666666666,6790,19679,46,009
"Brookings County, South Dakota",32647,16725,15922,30296,424,291,911,37,214,474,17,457,31912,735,0.4506,24694,25300,25538,9471,12830,7296,24832,23157,9211,14054,46,011
"Brown County, South Dakota",37528,18246,19282,34683,540,1319,597,7,29,353,27,326,36792,736,0.4188,27958,28649,28978,10205,18258,15184,24261,,8283,30796,46,013
"Brule County, South Dakota",5311,2572,2739,4675,0,478,0,0,7,151,0,151,5204,107,0.3938,22083,23358,23332,25377,-666666666,13359,-666666666,-666666666,,10284,46,015
"Buffalo County, South Dakota",2013,1027,986,343,11,1545,0,39,0,75,0,75,1989,24,0.4203,11719,20538,20538,,,10121,-666666666,,-666666666,2755,46,017
"Butte County, South Dakota",10259,5099,5160,9687,6,92,10,0,77,387,23,364,9912,347,0.4269,22459,22897,23114,19992,3067,11067,,-666666666,34745,12411,46,019
"Campbell County, South Dakota",1440,670,770,1349,0,69,12,0,0,10,0,10,1439,1,0.5564,31665,33385,33379,,-666666666,6596,,-666666666,-666666666,,46,021
"Charles Mix County, South Dakota",9209,4567,4642,5917,11,2987,17,0,33,244,9,235,9002,207,0.4645,19901,26420,26408,16398,25027,7982,,-666666666,13158,8617,46,023
"Clark County, South Dakota",3631,1841,1790,3467,34,59,30,0,23,18,0,18,3550,81,0.5004,28434,29242,29473,13360,3397,11124,,-666666666,5474,12694,46,025
"Clay County, South Dakota",13968,6975,6993,12654,202,444,247,0,112,309,0,309,13629,339,0.4996,21044,22065,21768,27014,15248,8054,17552,-666666666,12326,7615,46,027
"Codington County, South Dakota",27598,13811,13787,26212,54,728,143,0,140,321,0,321,27113,485,0.4282,25624,26414,26579,12191,18617,9966,11069,-666666666,11359,10462,46,029
"Corson County, South Dakota",4122,2120,2002,1262,11,2782,10,0,19,38,0,38,4083,39,0.5597,15854,34722,34767,1779,15600,7487,,-666666666,3011,7547,46,031
"Custer County, South Dakota",8358,4202,4156,7779,16,360,23,0,56,124,0,124,8133,225,0.4223,28855,30012,30103,15646,3156,11908,14130,-666666666,6150,21750,46,033
"Davison County, South Dakota",19730,10009,9721,18579,109,658,23,0,105,256,0,256,19330,400,0.4038,25544,26415,26583,18641,12709,8613,,-666666666,30516,8573,46,035
"Day County, South Dakota",5664,2872,2792,4984,0,583,16,0,3,78,3,75,5603,61,0.4845,23651,25389,25572,7498,-666666666,11292,,-666666666,,9695,46,037
"Deuel County, South Dakota",4340,2240,2100,4274,36,1,0,0,9,20,2,18,4228,112,0.4152,28810,29023,29323,16256,13750,,-666666666,-666666666,,20150,46,039
"Dewey County, South Dakota",5510,2736,2774,1190,20,4191,0,0,13,96,0,96,5353,157,0.4714,15404,28979,28979,2882,,11440,-666666666,-666666666,,24345,46,041
"Douglas County, South Dakota",2990,1482,1508,2864,0,99,1,0,0,26,12,14,2965,25,0.4498,27978,28550,28622,15600,-666666666,14741,,-666666666,-666666666,16262,46,043
"Edmunds County, South Dakota",4036,2084,1952,3960,2,51,21,0,0,2,2,0,4025,11,0.4088,27271,27405,27423,15773,,7276,,-666666666,-666666666,,46,045
"Fall River County, South Dakota",6957,3500,3457,6061,71,430,29,0,109,257,0,257,6767,190,0.4242,25191,26534,26292,32264,14932,11556,,-666666666,,19629,46,047
"Faulk County, South Dakota",2371,1212,1159,2329,0,40,2,0,0,0,0,0,2279,92,0.4663,25494,25644,26364,5574,-666666666,16883,,-666666666,-666666666,-666666666,46,049
"Grant County, South Dakota",7281,3786,3495,7106,23,112,7,0,6,27,0,27,7095,186,0.4119,26219,26631,26879,17078,,12678,16843,-666666666,,730,46,051
"Gregory County, South Dakota",4235,2167,2068,3779,7,341,9,0,5,94,3,91,4185,50,0.4675,23879,25821,25909,8728,,7789,,-666666666,,4601,46,053
"Haakon County, South Dakota",2092,1042,1050,1946,4,97,0,0,0,45,0,45,2080,12,0.4371,24265,25508,25639,,,4070,-666666666,-666666666,-666666666,16200,46,055
"Hamlin County, South Dakota",5949,3009,2940,5785,10,21,6,0,75,52,0,52,5774,175,0.3983,25861,26086,26187,20833,,13695,,-666666666,21493,17663,46,057
"Hand County, South Dakota",3344,1692,1652,3321,0,7,5,0,0,11,0,11,3321,23,0.4386,27345,27251,27316,17948,-666666666,,,-666666666,-666666666,53845,46,059
"Hanson County, South Dakota",3392,1725,1667,3193,103,59,7,11,0,19,0,19,3356,36,0.4096,23460,24454,24615,,7220,5953,,,-666666666,,46,061
"Harding County, South Dakota",1263,646,617,1207,8,21,11,0,0,16,0,16,1257,6,0.4182,23472,23305,23343,,,2524,,-666666666,-666666666,,46,063
"Hughes County, South Dakota",17379,8538,8841,14624,133,1608,128,0,96,790,80,710,16953,426,0.4049,29501,33062,33187,16309,12687,10914,,-666666666,14873,10184,46,065
"Hutchinson County, South Dakota",7221,3598,3623,7010,15,128,2,0,23,43,0,43,7089,132,0.4679,26093,26547,26661,19360,,3105,,-666666666,,22360,46,067
"Hyde County, South Dakota",1460,714,746,1274,0,114,9,0,8,55,0,55,1434,26,0.3790,27010,28998,29361,,-666666666,13040,,-666666666,,11833,46,069
"Jackson County, South Dakota",3180,1594,1586,1548,5,1458,16,0,21,132,0,132,3132,48,0.4199,19333,25473,25566,14767,,10020,,-666666666,,51162,46,071
"Jerauld County, South Dakota",2051,987,1064,2007,0,33,0,0,6,5,0,5,1991,60,0.4694,28985,29308,29792,11973,-666666666,12106,-666666666,-666666666,,,46,073
"Jones County, South Dakota",805,412,393,774,10,19,2,0,0,0,0,0,801,4,0.4091,26504,27330,27182,,,6800,,-666666666,-666666666,-666666666,46,075
"Kingsbury County, South Dakota",5141,2582,2559,4982,22,4,38,0,55,40,0,40,5036,105,0.4088,28092,28506,28787,9920,,,30076,-666666666,10947,7815,46,077
"Lake County, South Dakota",11831,6009,5822,11374,58,20,100,0,45,234,0,234,11591,240,0.4549,28245,29050,29413,6885,595,4855,7630,-666666666,2313,11737,46,079
"Lawrence County, South Dakota",24478,12177,12301,22842,68,893,179,0,154,342,58,284,23737,741,0.4702,28120,28767,28721,24055,7603,15776,17297,-666666666,25347,28065,46,081
"Lincoln County, South Dakota",48326,24074,24252,46180,474,163,585,0,169,755,40,715,47567,759,0.4035,34624,34932,34661,44323,27278,76629,42801,-666666666,6589,11290,46,083
"Lyman County, South Dakota",3831,2015,1816,2216,0,1473,20,0,0,122,0,122,3814,17,0.3913,20923,28482,28508,1224,-666666666,10730,,-666666666,-666666666,9539,46,085
"McCook County, South Dakota",5615,2800,2815,5466,21,64,0,0,26,38,0,38,5474,141,0.4222,27830,26933,27264,16351,5533,110873,-666666666,-666666666,14108,38813,46,087
"McPherson County, South Dakota",2401,1239,1162,2250,2,136,7,0,0,6,2,4,2349,52,0.4590,22515,23607,23915,9677,,6643,5829,-666666666,-666666666,,46,089
"Marshall County, South Dakota",4668,2461,2207,3995,2,340,4,0,92,235,90,145,4338,330,0.4522,26460,29014,29388,8805,,13176,,-666666666,20645,5075,46,091
"Meade County, South Dakota",26108,13681,12427,23626,411,634,245,14,373,805,25,780,25126,982,0.4263,27114,28345,28578,16752,26778,12704,15432,,19243,10165,46,093
"Mellette County, South Dakota",2084,1048,1036,834,0,1192,0,0,0,58,2,56,2008,76,0.4204,14882,23255,23255,7149,-666666666,9391,-666666666,-666666666,-666666666,7309,46,095
"Miner County, South Dakota",2340,1190,1150,2250,11,3,0,0,13,63,0,63,2290,50,0.5192,31017,31512,31843,21864,18773,,-666666666,-666666666,,12905,46,097
"Minnehaha County, South Dakota",176014,87995,88019,153592,7315,4708,3159,44,3569,3627,386,3241,168076,7938,0.4221,27143,29396,29720,14493,11478,10127,18013,14793,13049,7349,46,099
"Moody County, South Dakota",6445,3246,3199,5191,47,802,75,0,36,294,3,291,6279,166,0.4331,26995,30106,30282,9917,,14842,23052,-666666666,12642,9354,46,101
"Pennington County, South Dakota",104574,52477,52097,86988,1361,8727,1093,41,616,5748,354,5394,99846,4728,0.4322,26906,29681,30029,14149,25133,10134,24729,22917,23403,11602,46,103
"Perkins County, South Dakota",3024,1555,1469,2916,2,71,0,0,11,24,0,24,2981,43,0.4943,25458,25854,25939,33826,,11806,-666666666,-666666666,,7096,46,105
"Potter County, South Dakota",2312,1096,1216,2202,0,64,19,0,0,27,0,27,2299,13,0.4398,26923,27747,27848,,-666666666,13839,5484,-666666666,-666666666,5844,46,107
"Roberts County, South Dakota",10303,5176,5127,6223,43,3630,11,0,7,389,31,358,10110,193,0.4450,22674,30152,29322,45084,15265,11167,,-666666666,18714,10232,46,109
"Sanborn County, South Dakota",2341,1205,1136,2317,0,6,3,0,10,5,0,5,2308,33,0.4088,27076,27078,27169,22267,-666666666,,,-666666666,32100,,46,111
"Shannon County, South Dakota",14005,6761,7244,617,18,13250,2,0,9,109,0,109,13857,148,0.5059,9226,39142,37670,21364,,7557,,-666666666,,42913,46,113
"Spink County, South Dakota",6552,3331,3221,6359,16,99,0,0,53,25,0,25,6438,114,0.4748,27971,28469,28543,22832,19475,3968,-666666666,-666666666,27945,1868,46,115
"Stanley County, South Dakota",2984,1494,1490,2619,0,286,0,0,0,79,5,74,2928,56,0.4435,30188,33406,32600,45473,-666666666,5559,-666666666,-666666666,-666666666,12692,46,117
"Sully County, South Dakota",1461,817,644,1442,0,4,0,0,0,15,0,15,1422,39,0.4543,36707,36985,37666,12521,-666666666,,-666666666,-666666666,-666666666,,46,119
"Todd County, South Dakota",9859,4858,5001,1058,34,7540,59,0,15,1153,7,1146,9536,323,0.4499,11101,25875,27149,7501,,8304,40359,-666666666,,13360,46,121
"Tripp County, South Dakota",5549,2856,2693,4571,4,700,15,0,12,247,7,240,5510,39,0.4490,24308,27234,27234,,,11669,,-666666666,,6143,46,123
"Turner County, South Dakota",8339,4187,4152,8119,44,47,2,0,31,96,0,96,8184,155,0.4021,26263,26557,26828,8014,1386,35787,,-666666666,11719,12894,46,125
"Union County, South Dakota",14751,7371,7380,13990,120,92,185,0,111,253,50,203,14338,413,0.4644,37326,37613,37881,17824,51272,12475,73053,-666666666,22351,4364,46,127
"Walworth County, South Dakota",5498,2680,2818,4495,18,662,118,36,44,125,0,125,5429,69,0.4740,27095,29006,29043,12064,,22032,15550,,11245,9429,46,129
"Yankton County, South Dakota",22580,11727,10853,20890,444,572,151,0,216,307,47,260,21882,698,0.4543,26831,28298,28731,7840,6160,9277,18815,-666666666,6659,7717,46,135
"Ziebach County, South Dakota",2837,1389,1448,683,13,2099,0,0,0,42,0,42,2742,95,0.4797,12764,23525,23515,5452,,9497,-666666666,-666666666,-666666666,3576,46,137
"Anderson County, Tennessee",75346,36488,38858,69453,2975,168,999,0,161,1590,90,1500,73519,1827,0.4579,25353,25784,25965,16265,21116,41136,29863,-666666666,11829,11299,47,001
"Bedford County, Tennessee",45660,22678,22982,38954,2810,366,363,0,1552,1615,0,1615,40426,5234,0.4443,19855,21117,22175,8368,19498,8587,21721,-666666666,6764,4749,47,003
"Benton County, Tennessee",16345,8020,8325,15603,581,28,51,0,17,65,4,61,16015,330,0.4347,19168,19229,19333,14301,19084,25046,,-666666666,18847,17752,47,005
"Bledsoe County, Tennessee",13240,7289,5951,12390,576,14,13,0,0,247,1,246,12950,290,0.4443,16631,17063,17212,10497,13387,5586,,-666666666,-666666666,2398,47,007
"Blount County, Tennessee",124435,60357,64078,117279,3658,511,998,8,393,1588,13,1575,120817,3618,0.4434,24507,25083,25412,13335,13952,16182,21757,,19601,11825,47,009
"Bradley County, Tennessee",101004,49177,51827,92821,4551,164,993,184,575,1716,299,1417,95815,5189,0.4649,22294,22839,23452,10911,14398,30253,28997,,14951,13238,47,011
"Campbell County, Tennessee",40361,19530,20831,39382,237,123,132,0,168,319,13,306,39860,501,0.4412,17242,17184,17281,9038,16689,26103,34761,-666666666,13252,16181,47,013
"Cannon County, Tennessee",13786,6817,6969,13248,205,11,47,0,67,208,0,208,13555,231,0.4502,20974,21237,21374,7632,15453,,8864,-666666666,3743,18200,47,015
"Carroll County, Tennessee",28511,13893,14618,24726,2851,129,52,2,185,566,45,521,27867,644,0.4536,19461,20652,20757,11220,13498,10363,22329,,7063,3334,47,017
"Carter County, Tennessee",57298,27975,29323,55237,705,131,138,0,126,961,138,823,56365,933,0.4575,19385,19326,19382,15611,19344,66268,17019,-666666666,31835,15128,47,019
"Cheatham County, Tennessee",39324,19599,19725,37480,614,50,186,88,445,461,11,450,38319,1005,0.3945,23730,23900,24037,14527,20752,37840,32061,,10920,24071,47,021
"Chester County, Tennessee",17270,8161,9109,14985,1813,49,52,5,246,120,8,112,16862,408,0.4584,19059,20145,20287,6069,13089,10184,16492,,7311,2930,47,023
"Claiborne County, Tennessee",31841,15602,16239,30724,289,58,122,21,30,597,97,500,31540,301,0.4581,18322,18478,18453,16694,4035,4545,9289,,,21952,47,025
"Clay County, Tennessee",7802,3866,3936,7539,162,52,12,0,14,23,23,0,7666,136,0.4406,16802,17173,17234,10611,3659,14763,,-666666666,,,47,027
"Cocke County, Tennessee",35453,17273,18180,33741,496,45,82,12,210,867,37,830,34743,710,0.4793,18113,18470,18236,27011,15473,,7054,,11754,8987,47,029
"Coffee County, Tennessee",53151,25749,27402,48384,1151,194,563,3,1010,1846,123,1723,51088,2063,0.4577,21123,22015,22204,10016,15149,8513,14367,,10964,10428,47,031
"Crockett County, Tennessee",14599,6930,7669,11718,1949,20,24,0,592,296,59,237,13250,1349,0.4257,19270,20786,21273,9325,15601,,22942,-666666666,8291,4891,47,033
"Cumberland County, Tennessee",57064,27722,29342,55441,319,222,214,0,116,752,157,595,55605,1459,0.4336,21674,21669,21762,14424,32734,7450,64479,-666666666,14139,10524,47,035
"Davidson County, Tennessee",648048,312710,335338,402078,179411,1845,20427,328,28705,15254,2215,13039,584258,63790,0.4905,28971,35099,36754,13709,19412,20448,28556,21120,11198,15079,47,037
"Decatur County, Tennessee",11675,5693,5982,11002,335,2,28,5,124,179,19,160,11340,335,0.5101,23760,24324,24637,10093,14057,,16325,,13159,14657,47,039
"DeKalb County, Tennessee",18968,9571,9397,18085,281,28,169,0,279,126,24,102,17629,1339,0.5062,22451,22295,22435,16396,18509,3914,20997,-666666666,5763,96662,47,041
"Dickson County, Tennessee",50115,24461,25654,46115,1986,70,224,0,532,1188,91,1097,48556,1559,0.4380,22191,23010,23214,11374,16895,4634,18723,-666666666,12007,5508,47,043
"Dyer County, Tennessee",38156,18500,19656,31281,5217,42,142,7,325,1142,189,953,37054,1102,0.4536,22925,24637,24878,12622,16471,4286,17230,,21591,6949,47,045
"Fayette County, Tennessee",38664,19107,19557,26821,10758,41,253,0,476,315,7,308,37732,932,0.4645,28946,33988,34116,16994,17846,18271,20229,-666666666,10604,14756,47,047
"Fentress County, Tennessee",17922,8841,9081,17574,34,56,36,0,27,195,18,177,17708,214,0.4542,16283,16293,16340,10599,14238,14043,35361,-666666666,,13400,47,049
"Franklin County, Tennessee",41069,19811,21258,37035,1443,174,249,12,693,1463,71,1392,39971,1098,0.4635,23099,23352,23420,13371,17632,27231,81864,,14448,15735,47,051
"Gibson County, Tennessee",49632,23557,26075,39185,9272,134,158,9,249,625,130,495,48502,1130,0.4401,20189,22169,22294,14791,12960,9656,20063,,20875,5125,47,053
"Giles County, Tennessee",29064,14176,14888,25093,3070,10,172,27,212,480,9,471,28527,537,0.4374,20182,21317,21475,9096,13714,,22409,,4105,9648,47,055
"Grainger County, Tennessee",22724,11301,11423,22181,169,6,24,0,78,266,35,231,22144,580,0.4389,18475,18706,18556,21278,17304,,10792,-666666666,2935,5220,47,057
"Greene County, Tennessee",68596,33513,35083,65452,1571,51,341,16,389,776,31,745,66790,1806,0.4401,19998,20435,20648,9957,12222,15104,16888,,6958,6614,47,059
"Grundy County, Tennessee",13574,6721,6853,11206,37,49,49,6,73,2154,9,2145,13438,136,0.4588,15581,16002,16014,6660,9203,5102,47937,,573,13536,47,061
"Hamblen County, Tennessee",62863,30667,32196,56386,2299,55,456,0,2263,1404,78,1326,56028,6835,0.4608,20675,21507,22384,9511,17933,20091,27886,-666666666,6442,12337,47,063
"Hamilton County, Tennessee",344772,166094,178678,258373,68961,639,6617,151,4193,5838,575,5263,328333,16439,0.4789,27464,30901,31580,13671,16144,22791,33161,46883,11532,14089,47,065
"Hancock County, Tennessee",6706,3319,3387,6541,40,31,26,0,4,64,0,64,6704,2,0.4553,15464,15350,15355,,1163,10013,,-666666666,,7397,47,067
"Hardeman County, Tennessee",26560,14484,12076,14939,11006,139,211,0,96,169,2,167,26162,398,0.4479,14954,18086,18192,10733,10763,7232,26915,-666666666,8305,6275,47,069
"Sunflower County, Mississippi",28314,14885,13429,7202,20681,55,54,0,223,99,10,89,27903,411,0.5071,13936,24069,24234,8686,10520,6165,9854,-666666666,7084,12417,28,133
"Tallahatchie County, Mississippi",15124,8629,6495,6570,7214,58,205,20,993,64,9,55,13026,2098,0.4305,13460,19676,22005,4261,9918,-666666666,5796,,320,7248,28,135
"Tate County, Mississippi",28557,13925,14632,19098,8760,0,119,0,260,320,22,298,27876,681,0.4693,21795,26182,26468,9109,12973,-666666666,42054,-666666666,4568,7957,28,137
"Tippah County, Mississippi",22069,10851,11218,17776,3319,45,143,0,306,480,92,388,21018,1051,0.4626,18954,19624,20093,19454,15261,9860,8634,-666666666,18863,23690,28,139
"Tishomingo County, Mississippi",19532,9438,10094,18426,482,66,67,0,332,159,1,158,19012,520,0.4271,18350,18796,18879,9214,13943,,6543,-666666666,9252,2303,28,141
"Tunica County, Mississippi",10583,4989,5594,2322,7953,0,86,0,133,89,0,89,10444,139,0.4429,15298,26389,26686,6719,12202,-666666666,12070,-666666666,11659,11118,28,143
"Union County, Mississippi",27536,13360,14176,22695,3813,85,195,30,339,379,37,342,26289,1247,0.4572,19116,20731,21201,7564,12407,21736,18536,,3790,4747,28,145
"Walthall County, Mississippi",15126,7250,7876,8053,6814,0,51,0,85,123,24,99,14875,251,0.4717,17684,23310,23401,7080,11294,-666666666,9941,-666666666,11721,10704,28,147
"Warren County, Mississippi",48291,23067,25224,24164,23022,35,450,0,277,343,0,343,47328,963,0.4708,22368,29704,29774,22606,14608,52231,34903,-666666666,8993,17734,28,149
"Washington County, Mississippi",50038,23360,26678,13459,35563,93,272,0,336,315,56,259,49427,611,0.5054,16738,28256,28442,15378,12279,16009,41825,-666666666,17811,5461,28,151
"Wayne County, Mississippi",20611,9864,10747,12225,8044,26,43,0,79,194,0,194,20335,276,0.5081,19040,23525,23655,11242,12551,,24756,-666666666,10967,6637,28,153
"Webster County, Mississippi",10077,4934,5143,7935,1935,5,16,0,22,164,4,160,9956,121,0.4884,20392,23061,23203,13846,10736,,27081,-666666666,9686,4283,28,155
"Wilkinson County, Mississippi",9481,5051,4430,2735,6746,0,0,0,0,0,0,0,9472,9,0.4490,16458,23472,23549,,13614,-666666666,-666666666,-666666666,-666666666,-666666666,28,157
"Winston County, Mississippi",18882,9191,9691,9737,8943,35,74,0,50,43,7,36,18678,204,0.4847,19172,25522,25637,41257,12506,19074,8347,-666666666,,,28,159
"Yalobusha County, Mississippi",12433,6006,6427,7423,4890,50,7,0,6,57,13,44,12249,184,0.4574,18727,21451,21614,17782,14722,17674,,-666666666,,9595,28,161
"Yazoo County, Mississippi",28076,15491,12585,10859,16033,93,66,0,696,329,97,232,26647,1429,0.4994,14269,21861,22625,5211,9776,19127,14976,-666666666,1526,8078,28,163
"Adair County, Missouri",25642,12064,13578,24099,538,102,559,42,47,255,24,231,25027,615,0.4805,19076,19744,20040,6976,9810,10248,8242,,7666,8008,29,001
"Andrew County, Missouri",17373,8544,8829,16800,217,87,45,0,27,197,14,183,17021,352,0.4193,26086,26242,26411,16221,19935,53129,26902,-666666666,17889,8530,29,003
"Atchison County, Missouri",5520,2743,2777,5412,30,20,9,0,1,48,8,40,5456,64,0.4203,25538,25746,25710,32419,1773,14265,11444,-666666666,,24398,29,005
"Audrain County, Missouri",25637,11712,13925,23055,1510,82,73,0,194,723,44,679,24953,684,0.4009,19797,20752,20898,8963,12680,50806,18077,-666666666,3699,5177,29,007
"Barry County, Missouri",35681,17844,17837,32984,23,199,461,20,1144,850,94,756,32747,2934,0.4142,19680,20323,20929,9169,11587,14003,12522,11615,10109,13233,29,009
"Barton County, Missouri",12286,6085,6201,11604,27,108,125,0,173,249,2,247,12015,271,0.4375,20275,20840,20941,10092,8370,21812,14218,-666666666,10336,4495,29,011
"Bates County, Missouri",16780,8261,8519,16065,113,103,12,0,170,317,15,302,16454,326,0.4300,21369,21574,21662,11622,7092,30791,,-666666666,12005,17739,29,013
"Benton County, Missouri",18961,9423,9538,18406,51,79,34,4,43,344,41,303,18643,318,0.4272,19412,19700,19847,10420,10235,15339,19394,,29235,5070,29,015
"Bollinger County, Missouri",12394,6191,6203,12137,41,9,102,0,0,105,0,105,12284,110,0.4545,20186,20436,20592,3361,4927,,14481,-666666666,-666666666,4535,29,017
"Boone County, Missouri",168268,81402,86866,138849,14684,467,6739,128,1109,6292,442,5850,163009,5259,0.4881,27098,29131,29294,19396,15846,10271,25365,8654,13525,14371,29,019
"Buchanan County, Missouri",89536,44816,44720,79837,4447,310,758,163,863,3158,239,2919,84433,5103,0.4541,22839,24013,23670,26105,14091,11276,22057,13471,12542,10087,29,021
"Butler County, Missouri",42957,20684,22273,39002,2247,222,237,0,171,1078,14,1064,42249,708,0.4381,19186,19623,19745,7818,14509,17450,45323,-666666666,3511,10205,29,023
"Caldwell County, Missouri",9176,4594,4582,8870,68,13,17,0,28,180,16,164,9012,164,0.4199,22135,22251,22343,17388,13375,45138,11571,-666666666,25704,18507,29,025
"Callaway County, Missouri",44483,22707,21776,40837,1719,244,347,0,269,1067,47,1020,43687,796,0.4215,22901,23512,23744,9506,19634,49065,20006,-666666666,2941,4755,29,027
"Camden County, Missouri",43873,21669,22204,42443,200,279,297,0,263,391,0,391,42807,1066,0.4276,23251,23710,23991,7908,2987,12915,4805,-666666666,5534,17052,29,029
"Cape Girardeau County, Missouri",77031,37223,39808,68364,5695,189,989,117,279,1398,60,1338,75397,1634,0.4517,23684,25294,25300,19192,11441,12457,15503,,7844,7079,29,031
"Carroll County, Missouri",9157,4425,4732,8750,81,2,6,0,60,258,0,258,9037,120,0.4505,23424,24194,24319,7920,16701,,,-666666666,9678,2892,29,033
"Carter County, Missouri",6283,2966,3317,6035,37,80,0,0,18,113,0,113,6164,119,0.4878,19318,19787,20000,4713,,7284,-666666666,-666666666,,9223,29,035
"Cass County, Missouri",100339,49234,51105,92595,3745,460,665,31,761,2082,114,1968,96194,4145,0.4027,28013,28560,28834,20428,25035,33212,19484,19639,25564,11624,29,037
"Cedar County, Missouri",13912,6933,6979,13444,36,10,71,34,1,316,0,316,13739,173,0.4611,17744,18016,18070,13967,1217,,12432,,,10348,29,039
"Chariton County, Missouri",7727,3815,3912,7448,173,8,17,0,1,80,1,79,7666,61,0.4310,20300,20683,20744,10028,8539,27275,10724,-666666666,,11649,29,041
"Christian County, Missouri",79856,38875,40981,76693,528,425,315,39,212,1644,45,1599,77709,2147,0.4077,25428,25702,25956,13343,16424,29017,31563,,6971,15731,29,043
"Clark County, Missouri",7001,3516,3485,6841,34,21,8,0,13,84,0,84,6968,33,0.4377,23583,23906,23976,,3044,29029,,-666666666,,8283,29,045
"Clay County, Missouri",227984,111575,116409,198862,12295,805,4691,505,2922,7904,1252,6652,213715,14269,0.3996,29455,30851,31379,19446,21155,23699,24962,29227,19362,14235,29,047
"Clinton County, Missouri",20545,10325,10220,19603,394,148,51,34,70,245,0,245,20176,369,0.3844,25307,25861,25651,35785,12998,12463,19041,,31396,11517,29,049
"Cole County, Missouri",76426,38688,37738,63563,8732,333,849,79,1524,1346,21,1325,74441,1985,0.4246,26254,28993,29216,11405,12222,15003,30871,3144,9359,8281,29,051
"Cooper County, Missouri",17585,9326,8259,15770,1006,38,53,0,118,600,5,595,17330,255,0.4422,23193,24654,24753,12453,8356,18900,30674,-666666666,7284,12419,29,053
"Crawford County, Missouri",24680,12155,12525,24126,65,174,36,2,3,274,0,274,24284,396,0.4465,19099,19351,19394,16662,9946,6171,,,,8372,29,055
"Dade County, Missouri",7678,3900,3778,7351,43,23,2,4,24,231,0,231,7548,130,0.4482,20360,20572,20767,13499,5523,22839,,,,13679,29,057
"Dallas County, Missouri",16632,8259,8373,15907,8,39,10,0,127,541,45,496,16344,288,0.4089,17663,17939,18004,7697,7475,,,-666666666,17517,9681,29,059
"Daviess County, Missouri",8324,4161,4163,8099,59,37,14,0,16,99,31,68,8217,107,0.4119,19726,19999,20023,11613,9164,23478,-666666666,-666666666,18756,5265,29,061
"DeKalb County, Missouri",12824,8074,4750,10835,1384,42,99,2,54,408,6,402,12580,244,0.4238,17288,19743,20019,4866,666,8107,52305,,378,3100,29,063
"Dent County, Missouri",15681,7783,7898,15023,76,280,68,0,7,227,0,227,15491,190,0.4531,19589,19822,19927,10699,17516,18925,3715,-666666666,,9140,29,065
"Douglas County, Missouri",13575,6750,6825,13358,0,56,0,0,78,83,0,83,13439,136,0.4275,16780,16744,16729,13741,-666666666,48564,-666666666,-666666666,7210,10101,29,067
"Dunklin County, Missouri",31778,15283,16495,27422,3334,87,25,0,450,460,13,447,29891,1887,0.4634,18158,19210,19648,12964,11071,9085,39844,-666666666,20604,4964,29,069
"Franklin County, Missouri",101682,50553,51129,98244,1175,209,477,53,420,1104,108,996,100121,1561,0.4260,24732,24726,24818,13496,14345,41943,46346,13153,5368,31660,29,071
"Gasconade County, Missouri",15014,7390,7624,14698,91,55,44,0,14,112,0,112,14834,180,0.4070,22067,22291,22454,7716,16876,13669,20932,-666666666,,3633,29,073
"Gentry County, Missouri",6792,3290,3502,6649,47,18,26,0,16,36,7,29,6739,53,0.4015,20223,20454,20436,17677,8647,6122,22038,-666666666,12819,1803,29,075
"Greene County, Missouri",280657,136688,143969,256105,8501,1354,4676,354,1935,7732,561,7171,271617,9040,0.4600,23765,24570,24808,13394,15734,15139,24014,19389,8511,11308,29,077
"Grundy County, Missouri",10279,4934,5345,9890,105,106,47,0,8,123,1,122,10161,118,0.4256,19299,19534,19676,2044,7210,19522,21562,-666666666,,10680,29,079
"Harrison County, Missouri",8795,4415,4380,8597,76,4,2,4,7,105,0,105,8632,163,0.4022,19648,19901,20020,12477,6314,6725,,,,9587,29,081
"Henry County, Missouri",22134,10813,11321,21294,326,135,39,41,32,267,0,267,21715,419,0.4357,22230,22508,22728,10400,15261,14950,14403,22963,,13882,29,083
"Hickory County, Missouri",9420,4583,4837,9125,26,87,45,6,20,111,0,111,9304,116,0.4187,17804,18135,18105,19431,4927,3274,,,12170,10715,29,085
"Holt County, Missouri",4695,2332,2363,4557,30,26,18,0,5,59,0,59,4682,13,0.4057,23917,24346,24371,16946,8873,12942,17150,-666666666,,5107,29,087
"Howard County, Missouri",10183,5058,5125,9340,514,76,18,15,42,178,0,178,10046,137,0.4725,23082,24084,24305,1184,16764,9755,8356,3567,,2937,29,089
"Howell County, Missouri",40469,19637,20832,38877,114,190,259,0,224,805,43,762,39734,735,0.4692,18771,18736,18877,6614,13603,11533,69674,-666666666,4217,10571,29,091
"Iron County, Missouri",10424,5182,5242,10001,187,46,0,0,41,149,0,149,10274,150,0.4309,19984,20169,20007,30016,13341,7950,-666666666,-666666666,17166,20386,29,093
"Jackson County, Missouri",678167,327817,350350,452199,161305,3229,11706,1548,26829,21351,3497,17854,620195,57972,0.4642,26328,30969,31800,14145,17611,18859,26964,30180,11854,12589,29,095
"Jasper County, Missouri",116996,56984,60012,106486,2647,1460,1076,336,1341,3650,329,3321,108588,8408,0.4497,21904,22378,23072,11779,15895,24355,38382,6219,15760,10278,29,097
"Jefferson County, Missouri",220558,109667,110891,212700,1925,526,1429,140,747,3091,147,2944,216810,3748,0.3852,25034,25283,25276,23335,12919,17221,37863,38563,14123,12929,29,099
"Johnson County, Missouri",53879,27572,26307,48269,2409,366,745,74,124,1892,90,1802,51933,1946,0.4112,22394,23146,23409,14825,17101,22688,22197,27673,11694,10483,29,101
"Knox County, Missouri",4078,2021,2057,3949,51,0,0,21,0,57,0,57,4061,17,0.5080,22363,22845,22859,3247,12014,-666666666,-666666666,238,-666666666,6349,29,103
"Laclede County, Missouri",35544,17485,18059,34088,189,201,226,4,45,791,80,711,34782,762,0.4181,19218,19357,19503,14456,5679,14453,30007,,71282,11643,29,105
"Lafayette County, Missouri",33069,16340,16729,31233,697,128,74,3,54,880,19,861,32267,802,0.3801,24175,24506,24731,13318,21132,15088,3112,,27652,17782,29,107
"Lawrence County, Missouri",38306,19120,19186,36552,68,176,198,0,544,768,25,743,35729,2577,0.4253,19463,19878,20460,8332,3759,21057,14612,-666666666,4837,12338,29,109
"Lewis County, Missouri",10176,5120,5056,9568,269,30,31,15,29,234,37,197,10010,166,0.3917,19514,20100,20085,19495,14348,13077,13926,,21545,4055,29,111
"Lincoln County, Missouri",53458,26730,26728,50525,1166,182,243,25,374,943,84,859,52350,1108,0.3842,22006,22480,22595,10790,14145,14819,13948,,8598,14437,29,113
"Linn County, Missouri",12494,5936,6558,12004,74,10,26,1,91,288,42,246,12281,213,0.4205,18989,19466,19406,12277,12047,13240,27650,,3123,5259,29,115
"Livingston County, Missouri",15034,6769,8265,14287,355,96,49,24,10,213,30,183,14824,210,0.4402,21882,22336,22415,13445,4675,10378,118898,-666666666,,5578,29,117
"McDonald County, Missouri",22851,11509,11342,20439,308,496,280,140,203,985,34,951,20261,2590,0.4379,18093,18533,19689,9056,8084,14840,11941,8665,11282,18208,29,119
"Macon County, Missouri",15527,7567,7960,14710,500,63,74,0,16,164,9,155,15353,174,0.4291,19970,20596,20622,9600,8385,2379,18772,-666666666,17813,6630,29,121
"Madison County, Missouri",12353,6060,6293,11997,76,5,78,6,0,191,0,191,12101,252,0.4032,17459,17603,17427,24653,14555,,27882,,-666666666,5439,29,123
"Maries County, Missouri",9098,4498,4600,8850,47,114,45,0,7,35,10,25,9003,95,0.4028,21316,21540,21688,2619,1664,21787,7769,-666666666,4014,10449,29,125
"Marion County, Missouri",28844,13853,14991,26348,1627,115,247,6,45,456,24,432,28410,434,0.4564,22731,22614,22567,34754,26538,3796,52215,,13462,5659,29,127
"Mercer County, Missouri",3735,1872,1863,3656,15,2,10,5,5,42,0,42,3688,47,0.4051,19906,20072,20229,7006,7053,,12660,,,12843,29,129
"Miller County, Missouri",24905,12294,12611,23931,113,114,98,0,187,462,0,462,24495,410,0.4384,19969,20243,20327,6581,6958,17236,3461,-666666666,6918,18455,29,131
"Mississippi County, Missouri",14276,7618,6658,10581,3424,27,6,0,1,237,29,208,14013,263,0.4469,15032,17553,17866,2241,8025,25848,,-666666666,,2753,29,133
"Moniteau County, Missouri",15719,8206,7513,14587,574,82,20,5,211,240,22,218,15055,664,0.3842,19540,20406,20746,11302,5756,9533,13695,,14530,8551,29,135
"Monroe County, Missouri",8725,4326,4399,8284,267,54,20,14,1,85,4,81,8634,91,0.3707,20303,20817,20948,7019,9267,12744,24320,,,6976,29,137
"Montgomery County, Missouri",12054,5980,6074,11591,100,15,34,6,17,291,10,281,11868,186,0.4172,20529,20878,20983,13722,21570,26187,9959,,17576,7710,29,139
"Morgan County, Missouri",20314,10239,10075,19554,257,9,1,0,76,417,22,395,19933,381,0.4316,18445,18771,18767,15517,14325,,,-666666666,,6621,29,141
"New Madrid County, Missouri",18568,8919,9649,15145,2984,26,15,0,37,361,48,313,18308,260,0.4960,20896,21969,22061,12796,16265,,14087,-666666666,26627,9052,29,143
"Newton County, Missouri",58683,29106,29577,53267,586,1710,848,157,494,1621,94,1527,55908,2775,0.4538,22350,22782,23286,10563,13622,22173,23674,17320,11234,14653,29,145
"Nodaway County, Missouri",23296,11556,11740,21969,642,67,335,33,22,228,14,214,22963,333,0.4473,18329,18988,19117,6561,4338,3924,15173,6861,22009,4403,29,147
"Oregon County, Missouri",10975,5386,5589,10510,19,106,7,0,47,286,11,275,10821,154,0.4441,16877,17150,17033,22650,14242,16320,,-666666666,12670,7756,29,149
"Osage County, Missouri",13812,7220,6592,13589,91,39,5,2,54,32,1,31,13717,95,0.3668,23362,23636,23709,13351,4263,15710,,,,8644,29,151
"Ozark County, Missouri",9612,4912,4700,9294,15,20,0,0,76,207,15,192,9467,145,0.3944,17324,17312,17296,12459,,17200,-666666666,-666666666,6132,23244,29,153
"Pemiscot County, Missouri",18010,8482,9528,12771,4851,70,8,0,38,272,11,261,17618,392,0.4645,17387,20225,20355,15485,10501,11183,,-666666666,19366,8563,29,155
"Perry County, Missouri",19042,9471,9571,18511,82,41,16,0,101,291,28,263,18668,374,0.3884,23539,23858,24073,9048,6591,16502,,-666666666,12886,12602,29,157
"Pettis County, Missouri",42213,20709,21504,38051,1157,104,195,91,1323,1292,242,1050,38901,3312,0.4381,20571,21267,21753,9998,18985,10156,26464,27081,8482,13356,29,159
"Phelps County, Missouri",45091,23512,21579,41117,1125,329,1462,0,79,979,28,951,44055,1036,0.4485,20900,21508,21684,11981,12338,14339,15824,-666666666,17606,15253,29,161
"Pike County, Missouri",18573,10283,8290,16702,1096,180,45,0,130,420,13,407,18199,374,0.4208,18738,19675,19852,6007,7651,25024,9776,-666666666,8467,11871,29,163
"Platte County, Missouri",92149,45454,46695,79959,5833,400,2385,370,1149,2053,142,1911,87176,4973,0.4237,35333,37068,37685,23294,27317,19295,22372,7395,28072,17824,29,165
"Polk County, Missouri",31122,15268,15854,29812,288,197,115,0,92,618,0,618,30490,632,0.4188,19357,19588,19721,12135,4198,25314,6014,-666666666,20325,15763,29,167
"Pulaski County, Missouri",53343,30097,23246,40350,6125,579,1520,354,1365,3050,441,2609,48027,5316,0.3776,20019,20834,21009,17805,19866,12126,17442,13630,22282,12064,29,169
"Putnam County, Missouri",4911,2447,2464,4809,27,1,28,0,3,43,15,28,4862,49,0.4208,20069,20149,20136,17553,28322,,23661,-666666666,,1407,29,171
"Ralls County, Missouri",10224,5057,5167,9905,75,34,11,0,29,170,10,160,10106,118,0.3696,23588,23962,23889,26543,23932,10350,,-666666666,17745,6616,29,173
"Randolph County, Missouri",25207,13203,12004,22863,1428,95,115,15,86,605,46,559,24761,446,0.4243,18263,19107,19237,12906,7222,8926,12854,,33358,13004,29,175
"Ray County, Missouri",23166,11508,11658,22158,317,68,43,3,104,473,49,424,22683,483,0.4114,23957,24229,24385,10327,14431,48335,57309,,15692,12981,29,177
"Reynolds County, Missouri",6644,3390,3254,6429,62,49,4,2,25,73,2,71,6520,124,0.4393,18791,19005,19194,6654,8806,15676,,,,17090,29,179
"Ripley County, Missouri",14056,6931,7125,13592,12,22,10,0,26,394,6,388,13895,161,0.4042,16843,17016,17134,7399,12117,,,-666666666,22631,10851,29,181
"St. Charles County, Missouri",369781,181478,188303,334958,16894,617,8635,140,1822,6715,630,6085,358843,10938,0.3866,32473,33304,33617,18460,25738,28681,30026,21390,18417,15491,29,183
"St. Clair County, Missouri",9609,4850,4759,9221,85,18,30,0,45,210,3,207,9419,190,0.4302,18098,18333,18140,21463,3588,10828,86167,-666666666,9016,6467,29,185
"Ste. Genevieve County, Missouri",18017,9133,8884,17482,87,9,0,286,15,138,0,138,17849,168,0.4226,23780,24202,24286,15568,7720,,-666666666,,,8286,29,186
"St. Francois County, Missouri",65813,35465,30348,61355,2974,189,232,0,230,833,68,765,64933,880,0.4383,19044,19919,19994,9000,4541,4626,24355,-666666666,5790,11786,29,187
"St. Louis County, Missouri",1000423,473575,526848,699860,233119,1438,35778,93,5954,24181,1965,22216,974218,26205,0.4858,35388,41316,41692,23294,19457,21980,39400,31041,15806,17095,29,189
"Saline County, Missouri",23363,11616,11747,19790,1269,31,111,117,1136,909,243,666,21248,2115,0.4158,19774,20945,21272,11564,15961,25810,13039,18438,12755,9173,29,195
"Schuyler County, Missouri",4388,2140,2248,4303,31,17,8,8,0,21,3,18,4372,16,0.4314,18631,18735,18774,,11606,,10738,8038,-666666666,11233,29,197
"Scotland County, Missouri",4862,2402,2460,4806,42,0,0,0,0,14,0,14,4818,44,0.4513,20556,20722,20721,20889,1779,-666666666,-666666666,-666666666,-666666666,19814,29,199
"Scott County, Missouri",39137,19056,20081,33678,4357,118,183,0,67,734,53,681,38348,789,0.4359,20637,21858,21991,14457,13488,22070,22507,-666666666,9887,7325,29,201
"Shannon County, Missouri",8360,4109,4251,8013,28,203,0,0,34,82,0,82,8210,150,0.4464,18931,19291,19387,10059,8536,9783,-666666666,-666666666,,17462,29,203
"Shelby County, Missouri",6218,3074,3144,6102,82,5,4,5,0,20,3,17,6139,79,0.4150,20256,20550,20624,14325,3063,,,,-666666666,8275,29,205
"Stoddard County, Missouri",29864,14541,15323,29082,402,46,11,0,22,301,0,301,29437,427,0.4811,23923,23997,24070,19265,26955,10939,,-666666666,,14892,29,207
"Stone County, Missouri",31593,15447,16146,30582,19,73,6,0,115,798,105,693,31002,591,0.4071,21555,21903,21881,17960,8042,16789,,-666666666,12477,10422,29,209
"Sullivan County, Missouri",6551,3389,3162,6218,64,7,32,0,171,59,3,56,5361,1190,0.4176,19856,20110,20937,15837,19389,7014,12369,-666666666,16495,8885,29,211
"Taney County, Missouri",53086,25811,27275,49622,355,295,90,20,946,1758,114,1644,50371,2715,0.4352,19844,20280,20525,12127,23994,16362,11679,25800,9649,13114,29,213
"Texas County, Missouri",25796,13219,12577,24003,683,348,17,0,81,664,39,625,25307,489,0.4527,18178,18869,19023,7792,1980,18903,14747,-666666666,5633,11106,29,215
"Vernon County, Missouri",20984,10125,10859,20213,161,90,138,3,25,354,5,349,20599,385,0.4181,20406,20781,21110,3334,6127,11594,3596,,30060,13621,29,217
"Warren County, Missouri",32847,16455,16392,31019,630,54,88,65,296,695,0,695,31836,1011,0.4140,25138,25844,26197,11090,15437,35137,16245,15175,14551,8217,29,219
"Washington County, Missouri",25113,12934,12179,23866,488,168,39,9,18,525,9,516,25014,99,0.4453,17565,17873,17873,16580,4506,24695,22738,,10439,13574,29,221
"Wayne County, Missouri",13430,6730,6700,12966,60,78,18,2,4,302,0,302,13350,80,0.4447,18707,18995,19021,13254,11963,22382,,,,6413,29,223
"Webster County, Missouri",36461,18582,17879,34871,429,185,83,46,300,547,40,507,35802,659,0.4119,20183,20506,20584,11440,7367,23584,27620,,13648,12631,29,225
"Worth County, Missouri",2102,1028,1074,2080,0,0,0,0,0,22,13,9,2087,15,0.4256,23730,23598,23699,,-666666666,-666666666,-666666666,-666666666,-666666666,36182,29,227
"Wright County, Missouri",18565,9209,9356,17884,89,51,64,0,142,335,0,335,18282,283,0.4253,16026,15394,15444,15961,10690,8657,,-666666666,26720,7639,29,229
"St. Louis city, Missouri",318727,153977,164750,144883,153355,705,8887,112,2393,8392,629,7763,307068,11659,0.5062,23244,33350,34247,17969,14617,23581,19956,10554,15869,12143,29,510
"Beaverhead County, Montana",9294,4637,4657,8878,4,101,125,5,19,162,0,162,8954,340,0.4419,25294,25910,26235,17688,,15949,6205,,23684,12820,30,001
"Big Horn County, Montana",13079,6469,6610,4311,0,8317,33,0,55,363,0,363,12445,634,0.4490,16279,24192,25842,8648,-666666666,11848,56036,-666666666,29675,18177,30,003
"Blaine County, Montana",6576,3347,3229,3154,8,3240,5,28,54,87,3,84,6436,140,0.4473,17529,24722,24783,13194,,10779,,27314,8180,11072,30,005
"Broadwater County, Montana",5697,2950,2747,5414,36,90,65,0,9,83,0,83,5637,60,0.4239,27243,28324,28360,20862,,9446,,-666666666,,12055,30,007
"Carbon County, Montana",10189,5124,5065,9852,0,76,44,6,70,141,0,141,9958,231,0.4317,27808,28075,28404,13723,-666666666,29607,30305,,22941,10293,30,009
"Carter County, Montana",1205,617,588,1201,0,3,0,0,0,1,0,1,1197,8,0.4897,28271,28308,28389,16200,-666666666,,-666666666,-666666666,-666666666,,30,011
"Cascade County, Montana",81953,40989,40964,73208,1097,3680,681,33,374,2880,133,2747,78863,3090,0.4337,25216,26291,26651,17517,22039,11583,41756,11667,39634,10899,30,013
"Chouteau County, Montana",5859,2913,2946,4452,0,1200,21,0,58,128,0,128,5748,111,0.4438,23085,27526,27548,8078,-666666666,8637,21519,-666666666,3260,13302,30,015
"Custer County, Montana",11869,5848,6021,11318,42,200,50,5,54,200,14,186,11557,312,0.4376,24876,25173,25336,30217,,7565,22500,,96167,12487,30,017
"Daniels County, Montana",1813,924,889,1771,0,25,1,0,16,0,0,0,1772,41,0.4445,32686,33184,32884,37012,-666666666,12500,,-666666666,,-666666666,30,019
"Dawson County, Montana",9219,4865,4354,8802,55,145,40,10,43,124,0,124,8999,220,0.4162,27244,27227,26782,39311,4462,16706,,,1495,17964,30,021
"Deer Lodge County, Montana",9243,4886,4357,8648,108,163,45,113,34,132,23,109,8967,276,0.4403,23951,24948,25254,11326,2582,10250,-666666666,11138,,18365,30,023
"Fallon County, Montana",3028,1553,1475,2941,33,8,10,0,0,36,1,35,3006,22,0.4858,32353,32244,32267,27691,,24213,,-666666666,-666666666,17311,30,025
"Fergus County, Montana",11496,5764,5732,11067,13,141,128,0,46,101,0,101,11277,219,0.4146,25867,26046,26381,11493,,13272,11616,-666666666,,40565,30,027
"Flathead County, Montana",92373,46068,46305,88140,204,1570,479,16,228,1736,106,1630,90085,2288,0.4506,25789,26340,26560,18143,15441,14507,15788,8069,49556,9041,30,029
"Gallatin County, Montana",93108,47971,45137,88599,308,938,986,82,245,1950,97,1853,90366,2742,0.4517,29468,30187,30510,16247,13556,13324,22820,21684,11020,13080,30,031
"Garfield County, Montana",1097,521,576,1077,0,17,0,0,0,3,0,3,1092,5,0.4362,27218,27586,27658,6760,-666666666,8259,-666666666,-666666666,-666666666,,30,033
"Glacier County, Montana",13641,6594,7047,4458,40,8751,72,15,56,249,0,249,13322,319,0.4976,16710,27495,28052,6047,16198,11469,21649,,,9414,30,035
"Golden Valley County, Montana",738,367,371,708,0,0,0,0,2,28,0,28,730,8,0.3707,23356,24000,24174,,-666666666,-666666666,-666666666,-666666666,,7864,30,037
"Granite County, Montana",3133,1612,1521,3043,2,21,0,0,0,67,1,66,3078,55,0.4007,26868,27356,27708,7764,,20167,-666666666,-666666666,-666666666,7457,30,039
"Hill County, Montana",16434,8325,8109,11932,56,3867,62,23,70,424,25,399,15954,480,0.4254,21119,24336,24542,9542,5018,12423,19942,46926,17563,11388,30,041
"Jefferson County, Montana",11465,5953,5512,10914,48,118,49,0,34,302,8,294,11224,241,0.4078,30721,31580,31513,30534,,16102,23110,-666666666,17315,12358,30,043
"Judith Basin County, Montana",2023,1004,1019,1997,0,17,0,0,4,5,0,5,2003,20,0.4349,26274,26268,26233,25785,-666666666,32618,-666666666,-666666666,,,30,045
"Lake County, Montana",28987,14254,14733,20073,25,6827,139,5,108,1810,25,1785,27865,1122,0.4684,21927,25101,25451,14023,4984,14420,16616,,11252,16363,30,047
"Lewis and Clark County, Montana",64772,32221,32551,60597,304,1759,381,26,190,1515,204,1311,62981,1791,0.3990,28651,29398,29699,12715,15053,14529,24093,,31161,18909,30,049
"Liberty County, Montana",2235,1056,1179,2146,6,27,0,16,18,22,13,9,2219,16,0.4880,24908,25391,25391,,,,-666666666,,,12382,30,051
"Lincoln County, Montana",19455,9853,9602,18617,26,421,98,13,37,243,0,243,18960,495,0.4466,22464,22431,22634,13139,,29773,10047,,532,23106,30,053
"McCone County, Montana",1758,939,819,1684,0,38,3,0,0,33,26,7,1735,23,0.4305,29428,29719,29719,,-666666666,,,-666666666,-666666666,,30,055
"Madison County, Montana",7723,3998,3725,7503,47,33,4,22,14,100,12,88,7509,214,0.5189,33124,33799,34351,11640,6940,9876,,,,14629,30,057
"Meagher County, Montana",2026,1004,1022,2008,0,5,4,0,5,4,0,4,1997,29,0.3717,19561,19700,19872,4410,-666666666,14400,,-666666666,,,30,059
"Mineral County, Montana",4230,2146,2084,4147,35,31,6,0,0,11,4,7,4190,40,0.4558,20363,20633,20678,12075,,5839,35400,-666666666,-666666666,6482,30,061
"Missoula County, Montana",111011,55810,55201,102712,455,2935,1159,170,179,3401,382,3019,107806,3205,0.4522,26559,27411,27684,15418,9709,19153,20638,15893,32754,11702,30,063
"Musselshell County, Montana",4760,2418,2342,4513,46,50,30,0,0,121,7,114,4698,62,0.4215,23309,23706,23776,17832,32783,31704,5103,-666666666,-666666666,5936,30,065
"Park County, Montana",15642,7796,7846,15070,30,128,9,3,16,386,19,367,15259,383,0.4277,25818,26347,26687,8958,,14218,27700,,,9787,30,067
"Petroleum County, Montana",489,248,241,466,23,0,0,0,0,0,0,0,482,7,0.4071,22567,23559,23609,,,-666666666,-666666666,-666666666,-666666666,-666666666,30,069
"Phillips County, Montana",4194,2114,2080,3672,0,397,0,0,21,104,0,104,4118,76,0.4263,22450,23179,23529,10092,-666666666,17624,-666666666,-666666666,,15994,30,071
"Pondera County, Montana",6211,3042,3169,5134,25,885,23,0,22,122,0,122,6106,105,0.4620,22868,25308,25529,7691,,10818,16691,-666666666,4964,12796,30,073
"Powder River County, Montana",1710,823,887,1628,0,18,0,0,0,64,0,64,1680,30,0.4640,28849,29794,30234,6357,-666666666,28444,-666666666,-666666666,-666666666,4922,30,075
"Powell County, Montana",7010,4336,2674,6468,27,309,45,15,10,136,0,136,6856,154,0.4185,20650,21774,21472,32269,7259,5860,9073,7360,,7206,30,077
"Prairie County, Montana",1282,682,600,1231,0,26,0,1,0,24,0,24,1275,7,0.4110,22028,22682,22385,,-666666666,5785,-666666666,,-666666666,,30,079
"Ravalli County, Montana",40640,20114,20526,38943,112,253,221,0,67,1044,48,996,39357,1283,0.4426,22516,22973,23320,11016,5650,16398,24580,-666666666,9339,9176,30,081
"Richland County, Montana",10686,5560,5126,10085,47,245,36,0,146,127,0,127,10259,427,0.4607,31840,32344,32624,21442,,29282,13222,-666666666,20999,24414,30,083
"Roosevelt County, Montana",10861,5391,5470,3973,11,5982,20,0,57,818,0,818,10753,108,0.4742,16720,26932,27087,14357,345,10015,28470,-666666666,16244,16119,30,085
"Rosebud County, Montana",9335,4610,4725,5693,29,3166,79,0,124,244,0,244,8965,370,0.4222,23118,29506,30204,8010,38276,12204,7051,-666666666,12216,24640,30,087
"Sanders County, Montana",11373,5794,5579,10426,15,564,19,0,29,320,65,255,11109,264,0.4118,19145,19776,19918,9432,32467,12989,12684,-666666666,16969,9368,30,089
"Sheridan County, Montana",3510,1775,1735,3274,4,38,7,0,38,149,2,147,3454,56,0.4679,31642,32908,32235,64145,,11421,,-666666666,,13299,30,091
"Silver Bow County, Montana",34462,17570,16892,32736,147,576,192,0,145,666,23,643,33114,1348,0.4657,23698,24174,24549,14031,11184,10426,43861,-666666666,17018,10197,30,093
"Stillwater County, Montana",9214,4715,4499,8872,32,40,33,0,66,171,6,165,8955,259,0.4086,29298,29782,29696,23731,45738,32918,33315,-666666666,1853,10085,30,095
"Sweet Grass County, Montana",3622,1837,1785,3473,7,0,22,0,0,120,6,114,3537,85,0.4373,24437,25156,25652,3691,,-666666666,18745,-666666666,-666666666,5697,30,097
"Teton County, Montana",6075,3015,3060,5816,4,110,19,0,27,99,4,95,5989,86,0.4282,23871,24341,24598,5402,7650,17892,13605,-666666666,,12063,30,099
"Toole County, Montana",5208,2939,2269,4742,8,246,21,13,45,133,17,116,5043,165,0.4316,22837,22948,23228,11705,,24713,,,7896,16750,30,101
"Treasure County, Montana",761,405,356,682,0,5,4,0,40,30,0,30,712,49,0.3730,22419,23953,24069,7300,-666666666,9680,,-666666666,7295,2703,30,103
"Valley County, Montana",7518,3763,3755,6522,11,794,13,5,15,158,0,158,7386,132,0.4256,26331,28478,28628,12942,8018,12260,4038,,7287,13747,30,105
"Wheatland County, Montana",2126,1072,1054,2061,0,11,0,0,4,50,0,50,2106,20,0.4043,18935,19303,19407,6645,-666666666,5591,-666666666,-666666666,,7558,30,107
"Wibaux County, Montana",987,485,502,987,0,0,0,0,0,0,0,0,966,21,0.4643,25112,25112,25053,27810,-666666666,-666666666,-666666666,-666666666,-666666666,-666666666,30,109
"Yellowstone County, Montana",151965,74450,77515,137664,1033,6503,1168,74,2051,3472,113,3359,144357,7608,0.4537,28918,30313,30615,17406,26631,14587,20262,20800,12631,13833,30,111
"Adams County, Nebraska",31396,15768,15628,29496,261,45,428,17,582,567,66,501,28755,2641,0.4409,27001,27768,28613,13615,12547,9142,36688,7859,10936,4946,31,001
"Antelope County, Nebraska",6531,3250,3281,6441,5,2,9,0,13,61,0,61,6339,192,0.4560,26312,26553,26631,22664,,,,-666666666,6662,9982,31,003
"Arthur County, Nebraska",476,236,240,472,0,0,0,0,0,4,0,4,476,0,0.4032,18709,18636,18636,-666666666,-666666666,-666666666,-666666666,-666666666,-666666666,,31,005
"Banner County, Nebraska",788,370,418,759,14,0,2,0,5,8,0,8,749,39,0.5498,33226,34226,35600,6862,,-666666666,,-666666666,,,31,007
"Blaine County, Nebraska",594,312,282,587,0,0,1,3,0,3,0,3,594,0,0.4164,23684,23788,23788,-666666666,-666666666,-666666666,,,-666666666,,31,009
"Boone County, Nebraska",5404,2697,2707,5371,5,0,8,2,4,14,6,8,5328,76,0.4442,25985,26073,26280,7918,,-666666666,26038,,8525,,31,011
"Box Butte County, Nebraska",11308,5577,5731,10487,13,571,14,4,48,171,18,153,10041,1267,0.4187,24865,26122,27736,12346,19223,5432,,,38413,11199,31,013
"Boyd County, Nebraska",2067,1045,1022,2007,16,14,0,0,7,23,0,23,2055,12,0.4201,22783,23230,23264,9258,,7486,-666666666,-666666666,,13096,31,015
"Brown County, Nebraska",3090,1467,1623,3027,1,0,8,0,0,54,6,48,3060,30,0.4489,24287,24517,24631,13940,,-666666666,,-666666666,-666666666,14711,31,017
"Buffalo County, Nebraska",47388,23512,23876,44090,429,85,631,0,1299,854,74,780,43576,3812,0.4126,25154,25862,26641,11982,19021,23707,17902,-666666666,14296,13695,31,019
"Burt County, Nebraska",6690,3323,3367,6382,54,109,11,0,65,69,0,69,6519,171,0.4116,24841,25433,25561,15329,5789,16294,,-666666666,16300,8658,31,021
"Butler County, Nebraska",8312,4173,4139,8078,67,31,19,0,94,23,3,20,8088,224,0.4498,28525,28794,29050,11913,21552,14174,65042,-666666666,12983,7091,31,023
"Cass County, Nebraska",25315,12733,12582,24497,233,31,128,0,126,300,59,241,24614,701,0.3925,30413,30934,31081,22510,15512,27116,10845,-666666666,23747,10931,31,025
"Cedar County, Nebraska",8736,4422,4314,8640,12,27,8,2,0,47,0,47,8604,132,0.4576,26702,26914,27175,9952,1450,7170,14125,,-666666666,7983,31,027
"Chase County, Nebraska",3990,1934,2056,3917,1,0,0,0,12,60,0,60,3504,486,0.5118,30881,31261,34283,9398,,-666666666,-666666666,-666666666,12883,10213,31,029
"Cherry County, Nebraska",5749,2735,3014,5226,3,157,21,0,0,342,0,342,5613,136,0.4067,24942,26548,26751,9699,21067,4697,,-666666666,-666666666,10178,31,031
"Cheyenne County, Nebraska",10044,5021,5023,9653,30,42,154,0,16,149,5,144,9408,636,0.4079,29728,30172,31095,15492,2630,10802,35801,-666666666,11694,7405,31,033
"Clay County, Nebraska",6425,3262,3163,6220,35,5,17,0,41,107,13,94,5884,541,0.4052,25664,26107,27283,10250,12091,,22900,-666666666,12302,11107,31,035
"Colfax County, Nebraska",10512,5370,5142,9558,239,123,5,9,329,249,67,182,6053,4459,0.4256,23688,24687,32354,13040,14895,13695,,,13706,12663,31,037
"Cuming County, Nebraska",9081,4535,4546,8625,54,34,25,0,251,92,20,72,8270,811,0.4191,25363,26063,27201,9478,12083,7621,18076,-666666666,13406,8680,31,039
"Custer County, Nebraska",10820,5372,5448,10551,50,7,16,0,40,156,20,136,10573,247,0.4375,26105,26051,26260,11535,4340,18729,30113,-666666666,10133,40772,31,041
"Dakota County, Nebraska",20902,10212,10690,14612,895,527,639,0,3968,261,14,247,13271,7631,0.4213,20735,24694,27941,12924,7886,3471,18240,-666666666,11936,17874,31,043
"Dawes County, Nebraska",9141,4440,4701,8206,69,297,150,135,33,251,19,232,8784,357,0.4495,22654,24145,23228,41550,5588,9775,11682,,2318,9123,31,045
"Dawson County, Nebraska",24205,12201,12004,20935,1029,210,18,0,1693,320,119,201,16313,7892,0.3781,21046,22307,26529,11719,15161,9373,,-666666666,12266,12019,31,047
"Deuel County, Nebraska",1951,981,970,1898,0,2,0,0,28,23,2,21,1786,165,0.4413,28163,28560,30123,7231,-666666666,,-666666666,-666666666,,29322,31,049
"Dixon County, Nebraska",5900,2916,2984,5624,18,7,0,9,158,84,0,84,5225,675,0.3958,24173,24658,26106,11363,14228,,-666666666,11122,17090,6823,31,051
"Dodge County, Nebraska",36742,18030,18712,35153,174,99,226,81,279,730,85,645,32818,3924,0.4198,24754,25284,26920,9836,1686,13377,18768,28332,13989,11864,31,053
"Douglas County, Nebraska",531057,261222,269835,420226,59848,3481,15554,229,16392,15327,1841,13486,469541,61516,0.4637,29123,32531,34693,12701,15726,12288,26167,27117,13315,11773,31,055
"Dundy County, Nebraska",1966,1001,965,1941,1,1,15,0,4,4,0,4,1842,124,0.4706,29111,29148,30276,13291,,,,-666666666,,,31,057
"Fillmore County, Nebraska",5767,2811,2956,5589,38,6,9,0,81,44,17,27,5569,198,0.3958,26873,27566,27915,5440,10647,21733,,-666666666,3216,2711,31,059
"Franklin County, Nebraska",3161,1584,1577,3106,8,3,10,0,1,33,5,28,3117,44,0.4363,26349,26415,26546,16491,125,,16780,-666666666,,30794,31,061
"Frontier County, Nebraska",2540,1290,1250,2497,0,11,0,0,1,31,0,31,2519,21,0.4310,25361,25593,25728,8962,-666666666,,-666666666,-666666666,,15797,31,063
"Furnas County, Nebraska",4908,2380,2528,4788,6,25,16,0,28,45,0,45,4761,147,0.4109,22554,22831,23312,5353,,4144,,-666666666,14964,8984,31,065
"Gage County, Nebraska",21889,10785,11104,21187,38,27,76,40,129,392,8,384,21467,422,0.4160,25166,25473,25661,12673,17729,18759,17428,,14733,13964,31,067
"Garden County, Nebraska",1939,979,960,1876,0,0,12,0,1,50,0,50,1906,33,0.4551,28149,29015,29518,,-666666666,-666666666,,-666666666,,2660,31,069
"Garfield County, Nebraska",1954,969,985,1928,9,0,0,0,2,15,0,15,1937,17,0.3927,21939,22132,22131,22359,,-666666666,-666666666,-666666666,,12087,31,071
"Gosper County, Nebraska",1997,938,1059,1959,0,16,0,0,11,11,11,0,1958,39,0.3600,24856,25300,25404,6987,-666666666,,-666666666,-666666666,,,31,073
"Grant County, Nebraska",649,335,314,649,0,0,0,0,0,0,0,0,636,13,0.3369,21471,21471,21856,,-666666666,-666666666,-666666666,-666666666,-666666666,-666666666,31,075
"Greeley County, Nebraska",2500,1250,1250,2461,13,1,7,0,1,17,0,17,2450,50,0.4426,23902,24069,24494,3324,,,,-666666666,,18612,31,077
"Hall County, Nebraska",60223,30157,30066,55899,1324,391,713,0,1237,659,152,507,45201,15022,0.4249,24075,24395,28211,12745,28395,12565,21691,-666666666,18165,8755,31,079
"Hamilton County, Nebraska",9098,4545,4553,8866,39,47,14,0,49,83,5,78,8869,229,0.4083,28982,29347,29609,10998,,10902,,-666666666,18039,5928,31,081
"Harlan County, Nebraska",3462,1838,1624,3376,4,10,6,0,10,56,0,56,3368,94,0.3883,24417,24774,24246,41162,,7370,,-666666666,6500,,31,083
"Hayes County, Nebraska",1145,618,527,1135,2,0,0,0,5,3,0,3,1084,61,0.3936,24590,24671,25202,14226,,-666666666,-666666666,-666666666,22040,,31,085
"Hitchcock County, Nebraska",2884,1475,1409,2823,6,14,8,0,11,22,0,22,2817,67,0.4166,22958,23208,23465,9218,9733,18057,,-666666666,,16114,31,087
"Holt County, Nebraska",10432,5113,5319,10026,4,79,30,0,205,88,37,51,10066,366,0.4302,24624,25200,25384,9678,19550,13197,3713,-666666666,13130,3430,31,089
"Hooker County, Nebraska",688,334,354,678,0,2,3,0,3,2,0,2,668,20,0.4180,22940,22895,22587,30570,-666666666,,,-666666666,,,31,091
"Howard County, Nebraska",6315,3207,3108,6199,7,48,7,16,9,29,0,29,6178,137,0.4519,27363,27606,27878,14221,,11017,,42856,,8317,31,093
"Jefferson County, Nebraska",7505,3657,3848,7331,1,45,19,0,4,105,0,105,7268,237,0.4351,25291,25617,25881,15638,,12989,,-666666666,,11522,31,095
"Johnson County, Nebraska",5178,2989,2189,4519,300,75,78,0,142,64,11,53,4685,493,0.4392,20624,22589,23867,4871,4198,1219,19695,-666666666,10141,6003,31,097
"Kearney County, Nebraska",6560,3225,3335,6449,6,7,14,0,12,72,0,72,6259,301,0.3920,26991,27219,27816,15343,2883,,24286,-666666666,,8897,31,099
"Keith County, Nebraska",8206,4080,4126,7939,10,41,30,13,13,160,24,136,7708,498,0.4240,26605,27031,27804,13168,10520,19661,10387,,15692,14207,31,101
"Keya Paha County, Nebraska",741,401,340,732,1,0,4,0,0,4,0,4,741,0,0.4272,28104,28370,28370,-666666666,,-666666666,,-666666666,-666666666,,31,103
"Kimball County, Nebraska",3760,1886,1874,3605,16,36,24,0,24,55,3,52,3496,264,0.4281,25133,25570,26311,14581,25556,10547,22350,-666666666,13129,12367,31,105
"Knox County, Nebraska",8573,4171,4402,7546,11,774,34,5,47,156,18,138,8377,196,0.4523,26287,28478,28604,8548,,9853,10709,,13234,11858,31,107
"Lancaster County, Nebraska",293726,147131,146595,258061,11529,1681,11496,206,3010,7743,926,6817,275386,18340,0.4444,27512,29250,30052,13291,13439,15433,19257,18384,17184,9682,31,109
"Lincoln County, Nebraska",36054,17821,18233,34181,300,123,193,15,606,636,69,567,33243,2811,0.4328,26896,27413,28321,15199,11799,10729,28198,,26225,9489,31,111
"Logan County, Nebraska",736,356,380,716,2,1,0,0,10,7,0,7,717,19,0.4329,24599,24522,24731,11226,,,-666666666,-666666666,,32086,31,113
"Loup County, Nebraska",559,285,274,523,0,8,0,0,11,17,0,17,548,11,0.3859,25806,27017,27017,,-666666666,,-666666666,-666666666,,,31,115
"McPherson County, Nebraska",426,214,212,422,0,0,0,0,0,4,0,4,422,4,0.3932,25760,25995,26076,,-666666666,-666666666,-666666666,-666666666,-666666666,,31,117
"Madison County, Nebraska",35103,17272,17831,32512,560,488,178,21,730,614,134,480,30291,4812,0.4366,25279,25620,27389,11163,12071,7045,181267,,10241,7286,31,119
"Merrick County, Nebraska",7790,3871,3919,7500,45,33,24,0,65,123,6,117,7492,298,0.4341,25403,25319,25869,10906,4898,12652,,-666666666,20985,42082,31,121
"Morrill County, Nebraska",4918,2507,2411,4751,13,15,26,0,33,80,18,62,4219,699,0.4167,23268,23255,25008,12236,5885,5160,89762,-666666666,24224,8265,31,123
"Nance County, Nebraska",3667,1840,1827,3645,3,9,2,3,0,5,0,5,3582,85,0.4325,25499,25630,25607,23861,,,,,-666666666,,31,125
"Nemaha County, Nebraska",7214,3479,3735,6946,101,42,22,0,42,61,8,53,7052,162,0.4425,26837,27563,27872,7086,6704,7581,18714,-666666666,10131,5161,31,127
"Nuckolls County, Nebraska",4431,2208,2223,4348,2,4,21,0,7,49,0,49,4329,102,0.3888,23935,24174,24467,9761,,,3400,-666666666,,16633,31,129
"Otoe County, Nebraska",15750,7783,7967,15183,28,97,86,0,79,277,72,205,14752,998,0.3852,25700,26203,27077,12065,23779,10294,22595,-666666666,16534,7262,31,131
"Pawnee County, Nebraska",2754,1383,1371,2728,0,2,0,0,0,24,0,24,2706,48,0.4657,25138,25170,25351,15052,-666666666,,-666666666,-666666666,-666666666,22133,31,133
"Perkins County, Nebraska",2938,1496,1442,2900,4,0,0,0,8,26,0,26,2835,103,0.3960,29634,29771,30373,10673,,-666666666,-666666666,-666666666,17738,14908,31,135
"Phelps County, Nebraska",9189,4569,4620,8967,9,19,11,8,30,145,0,145,8748,441,0.3985,27126,27513,28102,12892,9422,,22818,12550,20807,6176,31,137
"Pierce County, Nebraska",7201,3660,3541,7063,11,12,21,0,23,71,19,52,7096,105,0.3872,25938,26057,26244,7580,116473,16042,9052,-666666666,14587,10379,31,139
"Platte County, Nebraska",32485,16345,16140,31013,97,14,183,0,627,551,101,450,27497,4988,0.3921,25815,26452,28521,13418,8948,48729,13621,-666666666,15753,7841,31,141
"Polk County, Nebraska",5307,2617,2690,5128,3,12,9,0,82,73,0,73,5127,180,0.4233,29567,30183,30585,11377,,22283,4856,-666666666,11720,11808,31,143
"Red Willow County, Nebraska",10993,5459,5534,10658,140,53,31,0,24,87,13,74,10481,512,0.4072,23912,24432,24995,11491,1996,17291,,-666666666,9983,4820,31,145
"Richardson County, Nebraska",8237,4012,4225,7712,7,230,29,0,10,249,0,249,8103,134,0.4255,24703,25431,25439,13104,15671,9054,17114,-666666666,13920,18174,31,147
"Rock County, Nebraska",1436,691,745,1381,10,0,3,0,6,36,0,36,1432,4,0.4209,28158,28765,28848,,,-666666666,,-666666666,16600,16439,31,149
"Saline County, Nebraska",14317,7353,6964,13278,110,9,341,17,398,164,48,116,11204,3113,0.4068,21230,22066,25140,9646,5563,,13527,,11304,6787,31,151
"Sarpy County, Nebraska",165955,82827,83128,147424,7076,728,3203,228,2033,5263,522,4741,152917,13038,0.3767,30539,31663,32624,18258,25843,14339,22787,21480,27932,13729,31,153
"Saunders County, Nebraska",20867,10556,10311,20318,113,66,46,0,116,208,23,185,20439,428,0.4163,29175,29638,29842,14487,1240,13883,43900,-666666666,14272,9029,31,155
"Scotts Bluff County, Nebraska",36844,17796,19048,34220,243,445,255,30,1026,625,62,563,28760,8084,0.4418,24417,25271,27969,14398,6495,8793,16817,1660,14980,15417,31,157
"Seward County, Nebraska",16939,8647,8292,16400,87,17,86,0,145,204,31,173,16600,339,0.4091,27579,28144,28316,11260,19071,12182,13803,-666666666,9353,5878,31,159
"Sheridan County, Nebraska",5342,2583,2759,4589,24,441,45,0,5,238,30,208,5138,204,0.4187,22665,24635,25166,6805,32738,9290,8384,-666666666,,11525,31,161
"Sherman County, Nebraska",3120,1538,1582,3068,34,7,2,0,9,0,0,0,3072,48,0.3871,24505,24782,24979,12535,,20071,,-666666666,25644,-666666666,31,163
"Sioux County, Nebraska",1279,670,609,1238,0,0,5,0,8,28,5,23,1213,66,0.4796,27669,27970,28708,19132,-666666666,-666666666,,-666666666,,7932,31,165
"Stanton County, Nebraska",6112,3101,3011,5963,29,20,10,0,5,85,0,85,5812,300,0.4496,28682,29171,30001,12607,12390,16795,25240,-666666666,,2376,31,167
"Thayer County, Nebraska",5194,2599,2595,5042,0,6,0,0,0,146,0,146,5153,41,0.4781,27626,28224,28287,20593,-666666666,,-666666666,-666666666,-666666666,8091,31,169
"Thomas County, Nebraska",747,381,366,721,0,3,12,0,2,9,0,9,743,4,0.4235,28421,26838,26913,,-666666666,,51408,-666666666,,136244,31,171
"Thurston County, Nebraska",6934,3447,3487,2843,23,3878,19,8,34,129,13,116,6659,275,0.4829,18251,31194,32718,4415,7113,9107,24479,,5562,11513,31,173
"Valley County, Nebraska",4269,2113,2156,4169,1,18,0,0,39,42,0,42,4208,61,0.4224,24165,24645,24730,6393,,,-666666666,-666666666,5208,,31,175
"Washington County, Nebraska",20264,10068,10196,19753,127,25,11,9,52,287,29,258,19793,471,0.3851,30438,30911,31266,13736,15610,49116,,,10037,8417,31,177
"Wayne County, Nebraska",9488,4799,4689,9047,219,37,18,0,101,66,0,66,9002,486,0.4338,25523,25977,26733,10640,11478,14192,83456,-666666666,21863,6068,31,179
"Webster County, Nebraska",3733,1804,1929,3608,4,0,55,3,5,58,7,51,3580,153,0.4202,22328,22705,23022,15025,3750,-666666666,12569,,,11598,31,181
"Wheeler County, Nebraska",848,435,413,835,0,0,0,0,12,1,0,1,836,12,0.4723,27996,28184,28184,,-666666666,-666666666,-666666666,-666666666,,,31,183
"York County, Nebraska",13797,6747,7050,13098,70,55,32,37,169,336,41,295,13194,603,0.4387,28271,29143,29761,7762,2261,37515,2856,,11564,8420,31,185
"Churchill County, Nevada",24347,12233,12114,20003,606,1148,802,91,925,772,363,409,21228,3119,0.4086,23823,26129,26992,13266,15449,15592,17006,13000,9004,8992,32,001
"Clark County, Nevada",2003613,1005553,998060,1300909,214491,11725,180163,13948,191293,91084,14159,76925,1407026,596587,0.4481,26040,29336,34619,15328,20602,19227,26710,20551,14701,15974,32,003
"Douglas County, Nevada",47135,23713,23422,42185,203,1100,564,98,1568,1417,56,1361,41665,5470,0.4579,34090,35936,37548,17129,14218,17075,28967,16205,15920,18577,32,005
"Elko County, Nevada",50991,26632,24359,44835,627,2636,500,114,1396,883,109,774,38932,12059,0.3916,29762,31230,35014,18349,27293,20445,17419,21072,17871,11702,32,007
"Esmeralda County, Nevada",1041,510,531,909,0,39,0,0,83,10,0,10,884,157,0.4372,20513,21312,21919,13559,-666666666,5533,-666666666,-666666666,12187,75350,32,009
"Eureka County, Nevada",1761,911,850,1678,10,26,0,9,31,7,7,0,1709,52,0.3903,31057,30973,31184,16002,1330,,-666666666,,,,32,011
"Humboldt County, Nevada",17003,8965,8038,14916,88,819,41,25,553,561,46,515,12731,4272,0.3970,26547,27960,30511,19878,20741,13197,18980,4336,25580,11862,32,013
"Lander County, Nevada",5930,3114,2816,5324,8,240,26,14,136,182,46,136,4551,1379,0.3606,29302,30788,32523,24487,,26474,,,11307,7587,32,015
"Lincoln County, Nevada",5282,2893,2389,4850,128,209,2,0,38,55,3,52,4810,472,0.5282,23523,24908,26828,6016,6662,7209,,-666666666,26232,1644,32,017
"Lyon County, Nevada",51579,26047,25532,45212,529,1483,742,86,1814,1713,324,1389,43688,7891,0.3821,22709,23408,24570,15864,21978,18121,25669,21219,18547,11662,32,019
"Mineral County, Nevada",4627,2395,2232,3090,81,805,193,2,156,300,22,278,4013,614,0.4274,23222,28265,29497,11402,25963,11453,25223,,15338,5089,32,021
"Nye County, Nevada",42938,21652,21286,37617,1135,874,719,129,1743,721,82,639,36912,6026,0.4335,23035,23859,25091,14145,15888,19269,28648,12204,11987,18889,32,023
"Pershing County, Nevada",6741,4311,2430,5488,269,289,7,21,467,200,21,179,5208,1533,0.4130,18623,21131,24103,7753,3991,6899,-666666666,15524,6973,14588,32,027
"Storey County, Nevada",3934,1862,2072,3733,21,67,38,9,10,56,1,55,3771,163,0.4150,37215,37827,38656,18680,3319,40422,18445,,17210,27570,32,029
"Washoe County, Nevada",429985,216395,213590,350364,10202,6771,22461,2518,21408,16261,2369,13892,331314,98671,0.4685,28621,30958,35104,14352,20180,19378,24361,14266,14109,14614,32,031
"White Pine County, Nevada",10043,5662,4381,8739,402,529,70,13,66,224,3,221,8609,1434,0.4212,25857,28304,29965,17009,6633,9875,28869,2654,17208,5586,32,033
"Carson City, Nevada",54634,28073,26561,45527,838,1395,1282,130,3850,1612,311,1301,42484,12150,0.4375,25893,27928,30364,14377,29276,13179,25442,14098,12763,10348,32,510
"Belknap County, New Hampshire",60252,29355,30897,58050,489,182,657,0,155,719,78,641,59380,872,0.4257,31044,31447,31642,14628,9443,28142,27243,-666666666,11756,21595,33,001
"Carroll County, New Hampshire",47623,23786,23837,46385,134,51,256,0,19,778,37,741,47036,587,0.4646,32860,32927,33119,13531,17809,34545,52854,-666666666,10305,25310,33,003
"Cheshire County, New Hampshire",76596,37283,39313,73308,601,217,880,22,311,1257,234,1023,75401,1195,0.4429,29591,29789,29792,19452,28008,14459,49123,,14364,11103,33,005
"Coos County, New Hampshire",32202,16524,15678,31078,351,120,132,0,202,319,36,283,31743,459,0.4306,24737,25071,25184,11190,5531,12284,29878,-666666666,22472,17294,33,007
"Grafton County, New Hampshire",89360,44009,45351,83314,794,393,2754,98,225,1782,117,1665,87569,1791,0.4533,31221,31948,32209,17243,15164,19874,22788,65450,25285,18803,33,009
"Hillsborough County, New Hampshire",402776,199502,203274,365766,8756,574,14096,93,4609,8882,1201,7681,380070,22706,0.4257,34767,35679,36470,17574,23896,29975,33881,27484,19390,17689,33,011
"Merrimack County, New Hampshire",146880,72226,74654,139662,1604,119,2486,28,546,2435,100,2335,144248,2632,0.4159,31579,32210,32346,24014,18117,25406,21856,,29344,14760,33,013
"Rockingham County, New Hampshire",297702,147129,150573,284095,2383,401,5402,26,897,4498,419,4079,290704,6998,0.4207,39605,40214,40511,22483,29095,28641,32643,,20322,20000,33,015
"Strafford County, New Hampshire",124387,60789,63598,116193,1026,215,3542,0,585,2826,256,2570,121900,2487,0.4355,29757,30183,30278,22716,21561,16892,27970,-666666666,23021,19868,33,017
"Sullivan County, New Hampshire",43291,21206,22085,41692,155,238,355,13,256,582,77,505,42717,574,0.4111,29073,29418,29348,27608,34956,17488,28859,,16658,12788,33,019
"Atlantic County, New Jersey",275325,133392,141933,184867,43646,571,22338,159,14426,9318,3655,5663,226460,48865,0.4505,27411,31895,34614,15393,18768,13863,20810,32908,16041,13116,34,001
"Bergen County, New Jersey",920456,444844,475612,655209,52849,1881,140014,143,50266,20094,5075,15019,760263,160193,0.4811,43194,46702,50145,26740,33327,28938,40372,45861,25193,20744,34,003
"Burlington County, New Jersey",450155,221307,228848,329978,73047,436,20307,199,10910,15278,2457,12821,418412,31743,0.4215,37511,40330,41126,23259,28953,32539,45572,31571,21314,18605,34,005
"Camden County, New Jersey",512632,247625,265007,324438,99823,1454,27768,109,43957,15083,4389,10694,435676,76956,0.4603,30667,36255,37382,15350,22304,15259,30460,24358,14501,14859,34,007
"Cape May County, New Jersey",96286,46957,49329,87495,4389,388,1072,57,1420,1465,170,1295,89782,6504,0.4527,33499,34854,35855,15266,21630,10618,38165,13223,13450,11014,34,009
"Cumberland County, New Jersey",157429,81133,76296,96899,32802,1277,2011,0,18565,5875,1991,3884,113060,44369,0.4434,22425,26896,29525,14408,16121,16858,27464,-666666666,13215,12474,34,011
"Essex County, New Jersey",789616,379041,410575,334962,316984,2324,38169,319,72007,24851,6086,18765,621243,168373,0.5368,32327,46229,53897,18774,21095,19378,43137,15864,16811,17986,34,013
"Gloucester County, New Jersey",289705,140730,148975,238755,29798,441,8381,80,5699,6551,1180,5371,274585,15120,0.4078,33609,35261,35532,20604,27569,26557,33265,9156,14718,18510,34,015
"Hudson County, New Jersey",654878,324965,329913,361426,84186,2225,93189,270,93329,20253,7890,12363,375166,279712,0.4906,32678,36165,49003,19984,24217,18993,43661,27918,17793,25242,34,017
"Hunterdon County, New Jersey",126746,63256,63490,115618,3229,81,4448,226,1729,1415,345,1070,119533,7213,0.4397,50846,52964,53870,29922,15883,15442,47777,23928,15940,16238,34,019
"Mercer County, New Jersey",369526,180915,188611,230476,74614,667,35398,14,20748,7609,1718,5891,310793,58733,0.4873,38076,44445,48884,18061,21391,14906,48375,,17464,19133,34,021
"Middlesex County, New Jersey",824046,405015,419031,507667,79558,1457,188063,299,28111,18891,5699,13192,665882,158164,0.4210,34616,35472,40394,20039,28809,21669,38112,23851,22554,20394,34,023
"Monmouth County, New Jersey",629702,306294,323408,522220,45548,909,32858,108,14229,13830,1929,11901,566214,63488,0.4681,43548,46297,48232,22141,25000,17804,47887,16834,18009,18679,34,025
"Morris County, New Jersey",497103,243487,253616,406912,16039,485,47072,69,17188,9338,2088,7250,436615,60488,0.4510,48928,51081,53735,25877,35052,45794,50153,16674,20208,26052,34,027
"Ocean County, New Jersey",581413,279156,302257,534146,17844,636,10375,105,9306,9001,1518,7483,531207,50206,0.4333,30951,31544,32445,18645,22789,16128,39303,4083,17123,17919,34,029
"Passaic County, New Jersey",505403,245785,259618,332659,64025,1967,26239,96,61077,19340,4029,15311,311090,194313,0.4733,27795,32583,39358,16707,18356,16700,33027,9289,14102,14073,34,031
"Salem County, New Jersey",65501,31836,33665,52725,9383,127,586,5,1402,1273,163,1110,60619,4882,0.4191,28987,31634,32613,12873,18786,17565,30829,,12857,12598,34,033
"Somerset County, New Jersey",328704,160245,168459,227182,29273,448,50187,32,14361,7221,1330,5891,283732,44972,0.4513,48646,52887,56279,26333,31542,12617,51715,,20353,21865,34,035
"Sussex County, New Jersey",146888,72897,73991,137249,3001,169,2607,25,1602,2235,387,1848,136783,10105,0.3976,38454,39006,39639,26706,29037,36319,50283,,19875,17318,34,037
"Union County, New Jersey",545236,265252,279984,316762,116887,819,25969,347,74418,10034,2642,7392,388144,157092,0.4898,35411,43060,50501,19607,25188,18837,48072,25022,16647,21152,34,039
"Warren County, New Jersey",107624,52386,55238,96407,4414,159,2790,9,2357,1488,305,1183,99331,8293,0.4107,34016,35145,36108,18770,29030,12964,25905,,17578,19341,34,041
"Bernalillo County, New Mexico",671429,329088,342341,481651,19358,29705,15802,658,97406,26849,9699,17150,345982,325447,0.4683,26916,30191,37741,18752,21989,17051,31599,16221,16578,17652,35,001
"Catron County, New Mexico",3651,1956,1695,3405,23,88,9,0,72,54,39,15,2918,733,0.4241,19254,19895,20686,15433,,5002,,-666666666,10379,12776,35,003
"Chaves County, New Mexico",65850,32575,33275,52463,1139,780,588,40,9181,1659,750,909,30592,35258,0.4443,20356,21983,28264,14329,17820,14868,14846,20850,13427,13525,35,005
"Cibola County, New Mexico",27392,13822,13570,12299,236,10980,196,27,2861,793,252,541,17186,10206,0.4415,16362,21101,26487,15908,15075,11290,24174,11574,15740,13942,35,006
"Colfax County, New Mexico",13264,6755,6509,11090,65,382,141,0,1335,251,102,149,6872,6392,0.4485,20975,22593,26940,15911,3192,7496,6557,-666666666,15808,10178,35,007
"Curry County, New Mexico",50173,25788,24385,36293,3259,656,716,55,7624,1570,518,1052,30334,19839,0.4650,21886,24374,26937,16152,16603,18642,25686,11327,13886,14170,35,009
"De Baca County, New Mexico",1967,889,1078,1570,0,0,0,0,316,81,0,81,1198,769,0.4586,25942,29689,35910,14128,-666666666,-666666666,-666666666,-666666666,13812,,35,011
"Do?a Ana County, New Mexico",212942,104630,108312,190021,3538,2566,2393,15,10167,4242,1709,2533,71855,141087,0.4813,20058,20239,33180,14036,28284,13156,22562,15793,15963,17687,35,013
"Eddy County, New Mexico",54834,27760,27074,48393,783,751,339,38,3560,970,389,581,29994,24840,0.4724,27630,28464,36513,17726,31392,25095,17625,31345,18652,21217,35,015
"Grant County, New Mexico",29303,14583,14720,25345,104,523,79,4,2471,777,133,644,14977,14326,0.4688,23411,24554,30553,17023,12091,11811,12932,,17893,14102,35,017
"Guadalupe County, New Mexico",4594,2727,1867,3837,110,90,1,9,453,94,55,39,1104,3490,0.4443,15192,16705,15358,15801,4482,9804,,,8454,5216,35,019
"Harding County, New Mexico",655,294,361,629,0,1,1,0,19,5,1,4,413,242,0.4572,18565,18509,19080,17726,-666666666,,,-666666666,19453,23900,35,021
"Hidalgo County, New Mexico",4734,2357,2377,4187,13,22,0,0,368,144,55,89,2056,2678,0.4475,19400,20219,25314,15169,,14632,-666666666,-666666666,16204,6224,35,023
"Lea County, New Mexico",66876,34219,32657,59190,2202,576,120,0,3144,1644,359,1285,31129,35747,0.4344,22962,23282,31960,16072,23254,22964,38275,-666666666,19601,16350,35,025
"Lincoln County, New Mexico",20162,10060,10102,17234,103,478,34,10,1819,484,156,328,13954,6208,0.4587,24732,26763,30906,13718,7602,13959,23515,10390,12833,11784,35,027
"Los Alamos County, New Mexico",17974,9115,8859,15778,89,183,1126,17,416,365,114,251,15144,2830,0.3718,50723,52819,57184,27631,49273,19023,42627,,30277,25565,35,028
"Luna County, New Mexico",24947,12348,12599,22416,267,310,88,31,1478,357,216,141,9145,15802,0.4547,15549,15739,23817,11146,16948,7535,34218,,13658,12566,35,029
"McKinley County, New Mexico",73082,35603,37479,12174,448,54351,652,50,3073,2334,605,1729,62999,10083,0.5057,12800,23729,27889,14948,28795,9946,18433,14386,17921,10834,35,031
"Mora County, New Mexico",4722,2378,2344,3140,4,21,0,0,1521,36,25,11,741,3981,0.4557,18950,22425,22788,18218,,9467,-666666666,-666666666,11886,18836,35,033
"Otero County, New Mexico",65415,33440,31975,50457,2598,4694,832,59,4497,2278,787,1491,42185,23230,0.4322,19803,21592,26500,11587,18577,10988,23841,30037,13295,10867,35,035
"Quay County, New Mexico",8822,4254,4568,8209,44,103,0,0,266,200,136,64,4983,3839,0.4277,16719,16999,20161,12547,4282,14332,-666666666,-666666666,13942,12912,35,037
"Rio Arriba County, New Mexico",40155,19750,20405,26672,165,6101,192,2,6233,790,426,364,11479,28676,0.4564,19483,20885,26904,18955,30055,14617,29591,,19031,8685,35,039
"Roosevelt County, New Mexico",20065,10179,9886,14864,492,245,182,6,3817,459,74,385,12052,8013,0.4417,17668,19225,21879,12453,6183,20232,7159,,13783,14908,35,041
"Sandoval County, New Mexico",135191,66215,68976,96733,3542,16835,1932,63,11285,4801,1548,3253,86034,49157,0.4343,26916,30611,35886,20509,26935,12846,30363,18162,21192,13987,35,043
"San Juan County, New Mexico",127358,63149,64209,67447,731,47371,470,100,6976,4263,1209,3054,102699,24659,0.4583,21992,28959,32393,16774,22635,13214,19105,33154,20721,11329,35,045
"San Miguel County, New Mexico",28899,14226,14673,17837,528,291,210,17,9048,968,498,470,6664,22235,0.5115,18355,21121,23722,17428,5980,14074,8664,,14362,14798,35,047
"Santa Fe County, New Mexico",146361,71323,75038,122044,1097,4507,1675,70,12972,3996,1378,2618,71711,74650,0.4859,32454,34687,47749,20206,33491,17280,29597,51200,20064,22166,35,049
"Sierra County, New Mexico",11774,5723,6051,10777,26,252,113,0,366,240,60,180,8380,3394,0.4249,18589,19046,20935,13410,,14831,19515,-666666666,9620,15705,35,051
"Socorro County, New Mexico",17608,9220,8388,13872,163,2215,55,0,972,331,174,157,8979,8629,0.5073,17969,20219,28411,13541,8736,6657,5202,-666666666,19411,1830,35,053
"Taos County, New Mexico",32956,16118,16838,21613,155,1922,253,0,7844,1169,664,505,14459,18497,0.4830,22107,25362,31168,16902,43785,17108,14895,-666666666,15862,10735,35,055
"Torrance County, New Mexico",16037,8246,7791,13953,213,395,6,0,919,551,149,402,9588,6449,0.4642,18278,19324,22391,13385,12778,10379,,-666666666,11526,9710,35,057
"Union County, New Mexico",4413,2477,1936,3430,119,87,5,0,690,82,39,43,2628,1785,0.4683,20511,23132,27082,13144,4143,13706,,-666666666,12210,10068,35,059
"Valencia County, New Mexico",76480,38490,37990,52853,901,2869,368,0,17229,2260,1099,1161,31462,45018,0.4436,19646,22063,27165,15326,12432,18597,20676,-666666666,13246,15936,35,061
"Albany County, New York",306124,148019,158105,237018,38932,423,16647,92,4047,8965,1261,7704,289788,16336,0.4500,32624,36259,36755,18213,19171,28225,26107,16437,17010,14472,36,001
"Allegany County, New York",48387,24481,23906,46317,754,169,596,0,205,346,56,290,47671,716,0.4184,20881,21386,21478,9312,5280,19535,13687,-666666666,6829,8626,36,003
"Bronx County, New York",1413566,664506,749060,304110,477844,7936,50800,660,520667,51549,26945,24604,646060,767506,0.4946,18269,25856,33802,14716,18543,18284,20638,18073,13699,14802,36,005
"Broome County, New York",198797,97538,101259,173887,9912,527,7593,59,2006,4813,409,4404,191570,7227,0.4484,24820,26356,26709,10473,12165,17301,19879,30063,9974,10112,36,007
"Cattaraugus County, New York",79397,39367,40030,73497,1156,2276,650,0,290,1528,118,1410,77930,1467,0.4196,22486,23028,23175,10123,12010,16859,37535,-666666666,7714,9160,36,009
"Cayuga County, New York",79481,40650,38831,73422,3315,286,449,0,527,1482,194,1288,77432,2049,0.4122,25070,26390,26637,8085,7681,16994,20260,-666666666,6624,8149,36,011
"Chautauqua County, New York",133556,66053,67503,124356,3399,696,857,73,1961,2214,236,1978,124770,8786,0.4323,22483,23359,24012,10063,11388,14804,14597,21207,10934,6038,36,013
"Chemung County, New York",88681,44148,44533,78658,5003,356,1346,0,135,3183,375,2808,86222,2459,0.4566,25967,27492,27730,12915,11452,15470,37186,-666666666,14813,7996,36,015
"Chenango County, New York",49868,24818,25050,48079,332,129,244,17,254,813,43,770,48881,987,0.4106,22339,22600,22628,17476,18147,13181,25485,,12837,12327,36,017
"Clinton County, New York",81829,42070,39759,75186,3430,259,1082,5,781,1086,167,919,79665,2164,0.4385,25279,26744,26992,7482,4848,13193,19487,,6461,10667,36,019
"Columbia County, New York",62525,31495,31030,56560,2554,79,1050,29,476,1777,107,1670,59918,2607,0.4527,32665,33905,34323,18488,21800,14185,34105,,21025,11847,36,021
"Cortland County, New York",49231,23903,25328,46213,955,40,361,23,507,1132,33,1099,48010,1221,0.4219,23581,24264,24358,14458,14928,19928,14222,,12612,11351,36,023
"Delaware County, New York",47223,23726,23497,44853,918,86,393,4,391,578,102,476,45612,1611,0.4284,23911,24471,24740,11350,10878,26098,19367,,10134,13335,36,025
"Dutchess County, New York",297388,147928,149460,235083,29890,1009,11476,3,11416,8511,1352,7159,264530,32858,0.4317,33962,36614,37638,20034,23863,21274,38054,,16433,15687,36,027
"Erie County, New York",920694,444960,475734,728482,121480,4425,26911,211,18307,20878,3143,17735,876094,44600,0.4570,28512,31487,31871,14605,17066,16675,24621,31572,12318,12997,36,029
"Essex County, New York",39072,20385,18687,36453,1197,118,187,16,564,537,89,448,37971,1101,0.4231,26755,28105,28235,8022,5835,6939,11048,9675,5823,14055,36,031
"Franklin County, New York",51508,28340,23168,42915,3045,3602,207,21,643,1075,100,975,49872,1636,0.4357,22322,24198,24422,9256,3389,17922,67759,30495,8070,15416,36,033
"Fulton County, New York",54870,27345,27525,52292,826,103,383,4,440,822,37,785,53458,1412,0.4236,24265,24825,25092,10638,16433,27422,14818,,11708,7276,36,035
"Genesee County, New York",59702,29876,29826,55157,1778,615,434,0,738,980,13,967,57979,1723,0.4107,25721,26703,26859,12727,12043,20861,14450,-666666666,14196,11982,36,037
"Greene County, New York",48618,25302,23316,43609,3030,41,367,0,364,1207,333,874,46108,2510,0.4375,25770,27453,27908,11423,9684,28959,34619,-666666666,10358,7172,36,039
"Hamilton County, New York",4783,2489,2294,4630,20,1,5,0,18,109,3,106,4727,56,0.4030,29974,30379,30562,39238,5865,,41180,-666666666,106656,4126,36,041
"Herkimer County, New York",64329,31718,32611,61877,615,127,297,65,354,994,122,872,63136,1193,0.4185,23607,23986,24104,12237,10822,15212,27725,,22698,8973,36,043
"Jefferson County, New York",118885,61515,57370,102932,6177,552,1744,331,2442,4707,747,3960,111076,7809,0.4159,23681,24700,24972,15793,18699,20032,31067,18424,16278,9846,36,045
"Kings County, New York",2570801,1216040,1354761,1121903,871044,9135,286727,621,224112,57259,15092,42167,2064786,506015,0.5111,25932,33040,36110,17229,21378,16549,21470,50927,15071,22021,36,047
"Lewis County, New York",27164,13720,13444,26389,290,59,109,0,115,202,42,160,26740,424,0.4136,23723,23965,24099,12029,20705,7473,22070,-666666666,17125,5715,36,049
"Livingston County, New York",64867,32481,32386,60626,1657,112,840,15,391,1226,96,1130,62851,2016,0.3991,23981,24971,25340,7461,7492,43641,8621,9073,9645,10788,36,051
"Madison County, New York",72731,35811,36920,69019,1546,445,601,3,105,1012,56,956,71317,1414,0.4236,25786,26399,26621,9393,6924,21736,32982,,24677,10456,36,053
"Monroe County, New York",748076,361297,386779,569686,113581,2644,25778,167,17036,19184,3058,16126,690394,57682,0.4631,29170,32930,33910,14411,16032,15239,27487,29175,14842,12200,36,055
"Montgomery County, New York",49951,24564,25387,44837,1123,101,286,29,2295,1280,301,979,43979,5972,0.4472,23809,24986,25598,13933,12282,14871,16336,,13153,14282,36,057
"Nassau County, New York",1350601,654217,696384,957680,151846,3013,111051,110,86386,40515,15023,25492,1142605,207996,0.4523,42949,48677,51067,22853,28385,17503,40483,40275,19510,20760,36,059
"New York County, New York",1618398,762733,855665,918058,245256,5988,184945,1052,197648,65451,14450,51001,1202232,416166,0.5975,63610,88060,99243,21653,24131,18042,58605,42553,16348,29979,36,061
"Niagara County, New York",214973,104372,110601,189885,15558,2042,2321,368,951,3848,523,3325,209802,5171,0.4391,26710,28336,28505,16029,14450,17766,17502,27456,11778,9982,36,063
"Oneida County, New York",233944,116513,117431,201993,14012,491,7912,28,3614,5894,975,4919,222267,11677,0.4462,25633,27688,28168,9550,12660,16078,17317,,8829,8397,36,065
"Onondaga County, New York",467846,225727,242119,377487,51623,3253,16185,72,5303,13923,2236,11687,447565,20281,0.4573,29156,32340,32776,15122,15353,21761,20136,4419,13209,12396,36,067
"Ontario County, New York",108975,53445,55530,101910,2486,330,1299,73,887,1990,209,1781,104738,4237,0.4276,30346,31321,31782,15607,14485,16014,24044,,16759,13629,36,069
"Orange County, New York",374518,187404,187114,282492,38093,1080,9680,67,30684,12422,3568,8854,304211,70307,0.4323,30561,32973,34076,21204,25551,22009,35469,46666,19228,15915,36,071
"Orleans County, New York",42492,20903,21589,38079,2515,294,239,21,655,689,103,586,40644,1848,0.4063,22350,23587,23981,8272,13047,16447,21295,,5492,7351,36,073
"Oswego County, New York",121659,60737,60922,116463,1101,298,767,6,998,2026,188,1838,118949,2710,0.4280,23472,23849,23941,12699,22092,22707,21052,,7577,11369,36,075
"Otsego County, New York",61778,29915,31863,58215,1159,99,644,0,551,1110,95,1015,59726,2052,0.4370,24263,24855,25136,11769,9714,23586,34633,-666666666,9579,9741,36,077
"Putnam County, New York",99697,49685,50012,89281,2019,363,2284,0,3364,2386,442,1944,87393,12304,0.4194,40967,42142,43724,24434,38702,19639,46532,-666666666,25176,19101,36,079
"Queens County, New York",2280602,1105061,1175541,946565,424129,8771,546900,1191,272214,80832,33758,47074,1645672,634930,0.4457,26580,31645,37535,20125,24891,21759,23927,26100,18951,20309,36,081
"Rensselaer County, New York",159600,78748,80852,139612,8596,247,3608,23,1379,6135,341,5794,152958,6642,0.4235,30285,32227,32730,15233,15509,25663,20805,,19601,15012,36,083
"Richmond County, New York",471522,228224,243298,356125,49435,1057,37617,48,17335,9905,2508,7397,388156,83366,0.4410,32091,34769,36748,22317,22877,28172,29262,22063,17510,18497,36,085
"Rockland County, New York",318186,156073,162113,227643,39688,788,19940,19,23454,6654,1966,4688,265897,52289,0.4496,34833,37292,38721,21329,28507,25447,43421,,17803,23933,36,087
"St. Lawrence County, New York",112015,56867,55148,104533,2458,889,1213,70,705,2147,436,1711,109706,2309,0.4561,22908,23668,23750,11480,5372,15066,28957,20730,10763,9856,36,089
"Saratoga County, New York",222512,109617,112895,209540,3537,279,4525,35,779,3817,426,3391,216493,6019,0.4126,35860,36278,36568,23015,25431,26415,44275,9537,24980,15726,36,091
"Schenectady County, New York",155178,75230,79948,123222,15620,473,6308,0,4578,4977,987,3990,145577,9601,0.4327,28609,31933,32815,12390,14833,12751,22955,-666666666,12438,13107,36,093
"Schoharie County, New York",32153,15961,16192,30781,496,42,239,9,204,382,83,299,31207,946,0.4222,26097,26700,26892,14403,9089,19924,23053,,8887,11546,36,095
"Schuyler County, New York",18458,9242,9216,17867,160,34,84,0,25,288,10,278,18170,288,0.3852,24529,25046,25200,10136,5553,21285,7770,-666666666,16280,8958,36,097
"Seneca County, New York",35232,18451,16781,32529,1688,131,225,40,77,542,20,522,34187,1045,0.4171,23823,25098,25609,7975,7093,12153,9080,,44487,7158,36,099
"Steuben County, New York",98917,49001,49916,94036,1683,142,1465,9,299,1283,96,1187,97439,1478,0.4374,25696,25772,25616,31356,19557,18479,43145,,21277,10100,36,101
"Suffolk County, New York",1500373,738625,761748,1215779,113313,3389,53969,374,79008,34541,10834,23707,1239196,261177,0.4267,37427,40702,43285,21454,24745,23837,33756,35845,17523,16367,36,103
"Sullivan County, New York",76892,39333,37559,62381,6797,244,1214,0,3670,2586,436,2150,65907,10985,0.4542,25336,27110,28070,17104,16749,11557,32789,-666666666,16756,15111,36,105
"Tioga County, New York",50464,24885,25579,48898,402,76,302,17,104,665,31,634,49696,768,0.4326,28803,28726,28766,24534,45695,21462,52139,,33411,13714,36,107
"Tompkins County, New York",103179,50835,52344,84180,4566,287,10187,1,983,2975,225,2750,98473,4706,0.4925,27829,30477,30951,15402,13863,32625,18285,,15339,10714,36,109
"Ulster County, New York",181598,90391,91207,158254,10381,228,3333,26,2765,6611,889,5722,164757,16841,0.4556,30868,32927,33926,17519,17388,21385,24555,,15710,12723,36,111
"Warren County, New York",65388,31846,33542,63000,738,139,634,13,111,753,162,591,64083,1305,0.4335,30662,31222,31449,16725,11873,20923,15193,,21020,17731,36,113
"Washington County, New York",62910,32547,30363,59311,1861,70,338,71,430,829,73,756,61391,1519,0.3972,23877,24859,25035,8744,3012,16173,21611,,7894,11369,36,115
"Wayne County, New York",92887,45912,46975,86619,3132,225,629,0,689,1593,287,1306,89258,3629,0.4018,25643,26384,26702,14755,16196,17024,17986,-666666666,21441,9975,36,117
"Westchester County, New York",962319,464043,498276,640230,137275,3354,53749,60,97366,30285,8906,21379,742594,219725,0.5342,48487,58670,64730,21658,27956,23025,52887,43788,17559,20737,36,119
"Wyoming County, New York",41679,22551,19128,38271,2390,95,195,0,265,463,98,365,40398,1281,0.3870,23708,25500,25894,5344,1189,16139,13216,-666666666,1323,10614,36,121
"Yates County, New York",25281,12339,12942,24553,232,10,128,7,55,296,37,259,24792,489,0.4398,25436,25792,25886,20077,13265,26940,11944,,17609,13052,36,123
"Alamance County, North Carolina",153713,73188,80525,108337,27645,512,2013,189,10320,4697,949,3748,135914,17799,0.4545,23324,26253,27223,10230,19430,17506,21145,4714,10042,10169,37,001
"Alexander County, North Carolina",37175,18889,18286,33069,2334,81,32,14,1055,590,7,583,35559,1616,0.4187,20112,21207,21427,9401,13859,23420,17009,,9243,3139,37,003
"Alleghany County, North Carolina",10974,5479,5495,10018,114,198,28,0,453,163,0,163,9966,1008,0.4340,19452,20730,21148,8956,5739,7068,,-666666666,7230,2881,37,005
"Anson County, North Carolina",26309,13692,12617,12710,12797,94,319,0,137,252,7,245,25448,861,0.4518,17091,22337,23171,8115,12401,2327,9508,-666666666,6047,11790,37,007
"Ashe County, North Carolina",27173,13388,13785,25668,176,103,80,0,829,317,68,249,25819,1354,0.4497,21149,21809,21937,9381,8472,25318,45845,-666666666,7636,2528,37,009
"Avery County, North Carolina",17739,9702,8037,15441,771,143,162,14,312,896,16,880,16921,818,0.4863,21541,23752,24155,10476,1858,15659,6358,,10613,7586,37,011
"Beaufort County, North Carolina",47587,22801,24786,32947,12350,23,74,50,1372,771,113,658,44197,3390,0.4482,21789,25269,25870,7991,15165,52100,23041,,6241,6829,37,013
"Bertie County, North Carolina",20677,10347,10330,7474,12868,124,75,0,15,121,30,91,20359,318,0.4634,16557,23898,24468,7743,12463,13258,13108,-666666666,10727,4745,37,015
"Bladen County, North Carolina",34915,16693,18222,20183,12325,847,72,0,893,595,116,479,32333,2582,0.4913,19059,22782,23811,7865,14401,14988,15985,-666666666,10897,7704,37,017
"Brunswick County, North Carolina",112907,55006,57901,94649,12273,419,610,459,2015,2482,102,2380,107352,5555,0.4488,27260,29416,29959,11680,16446,16507,32570,7625,10678,16079,37,019
"Buncombe County, North Carolina",244599,117723,126876,216524,16022,761,2694,123,1876,6599,1390,5209,229361,15238,0.4603,26930,28227,28938,13859,16775,18828,29706,40008,14766,12032,37,021
"Burke County, North Carolina",90164,45074,45090,76388,5666,428,3165,61,2829,1627,132,1495,85146,5018,0.4444,20346,21836,22213,7476,14407,25555,13619,,6535,7508,37,023
"Cabarrus County, North Carolina",184855,90204,94651,141025,29712,612,4281,32,5719,3474,447,3027,166928,17927,0.4203,25544,27396,28755,11278,19101,22759,36460,,12645,13706,37,025
"Caldwell County, North Carolina",82140,40365,41775,73869,4054,454,476,70,2044,1173,169,1004,78216,3924,0.4567,19397,20424,20619,10259,10050,9338,9342,13471,11440,9170,37,027
"Camden County, North Carolina",10127,5073,5054,8330,1388,53,222,0,72,62,0,62,9880,247,0.3626,26388,28505,29016,11416,16922,3889,10993,-666666666,41139,11061,37,029
"Carteret County, North Carolina",67851,33309,34542,60283,4190,416,701,35,868,1358,72,1286,65229,2622,0.4501,27975,29568,29878,14702,15137,13853,27555,,13185,11268,37,031
"Caswell County, North Carolina",23357,11813,11544,14624,7802,61,98,12,352,408,13,395,22570,787,0.4267,19057,21006,21301,8081,16626,9536,14565,,9755,6344,37,033
"Catawba County, North Carolina",154457,75678,78779,126247,13244,500,5541,48,5885,2992,400,2592,141163,13294,0.4464,23355,25718,26504,10817,14999,13964,13003,,9938,7954,37,035
"Chatham County, North Carolina",66050,32387,33663,51924,8487,290,880,10,3077,1382,421,961,57594,8456,0.4765,32369,35596,38070,11064,20791,17173,68339,,10885,10656,37,037
"Cherokee County, North Carolina",27156,13290,13866,25328,460,560,80,2,208,518,70,448,26427,729,0.4262,18556,19094,19080,12682,6406,9040,22820,,8175,16845,37,039
"Chowan County, North Carolina",14703,7094,7609,9380,4834,92,217,2,49,129,0,129,14234,469,0.4729,21179,25481,26443,6709,13589,16320,21705,,,3307,37,041
"Clay County, North Carolina",10616,5187,5429,10244,68,13,12,0,212,67,48,19,10322,294,0.4801,21935,22418,22521,5464,7737,,,-666666666,,17436,37,043
"Cleveland County, North Carolina",97464,46756,50708,74179,20276,228,941,0,483,1357,64,1293,94540,2924,0.4584,20512,22484,22752,12483,14131,16110,29185,-666666666,9622,6632,37,045
"Columbus County, North Carolina",57512,28358,29154,35163,17451,1832,158,12,2118,778,24,754,54800,2712,0.4737,19289,22396,22616,10659,14903,16474,3772,,11061,9449,37,047
"Craven County, North Carolina",104574,52684,51890,73726,22425,427,2187,95,2332,3382,148,3234,97588,6986,0.4406,24582,28317,29028,14164,16944,13898,13024,18784,13430,10484,37,049
"Cumberland County, North Carolina",324002,157667,166335,168638,117148,3991,7584,1063,8060,17518,1326,16192,290447,33555,0.4368,23204,26422,27456,16640,20559,18436,28397,21615,15797,12258,37,051
"Currituck County, North Carolina",24212,12120,12092,21698,1589,114,87,0,151,573,70,503,23414,798,0.3808,26703,27309,27225,24168,25321,27106,31083,-666666666,23740,7622,37,053
"Dare County, North Carolina",34530,17165,17365,31336,1013,247,180,0,1158,596,62,534,32213,2317,0.4143,30958,32127,32690,11987,14340,7500,78697,-666666666,11564,30702,37,055
"Davidson County, North Carolina",163545,80115,83430,141608,15142,648,2017,73,2025,2032,348,1684,152835,10710,0.4287,22465,23624,24361,11380,15331,15858,18772,37481,11036,11467,37,057
"Davie County, North Carolina",41411,20248,21163,36431,2779,168,179,31,1401,422,1,421,38819,2592,0.4601,26739,28350,28900,13567,16192,10057,19777,,12721,13605,37,059
"Duplin County, North Carolina",59455,29350,30105,34990,15126,66,86,0,8274,913,276,637,46912,12543,0.4496,17677,21981,23620,8651,13399,12248,13980,-666666666,8856,4281,37,061
"Durham County, North Carolina",282422,135655,146767,142157,105885,1126,12357,114,12766,8017,1406,6611,244533,37889,0.4770,29801,38170,42874,13428,21312,24668,33084,32661,12674,16428,37,063
"Edgecombe County, North Carolina",55779,26011,29768,21639,31718,145,44,59,1355,819,20,799,53588,2191,0.4438,17652,23642,24092,10479,14321,11889,23391,,8822,5004,37,065
"Forsyth County, North Carolina",358130,170038,188092,239125,93612,806,7393,106,11069,6019,805,5214,314201,43929,0.4837,26670,31244,34350,10409,17488,24389,27832,9284,10027,17582,37,067
"Franklin County, North Carolina",61723,30670,31053,41711,15922,380,263,0,2004,1443,148,1295,56855,4868,0.4232,21836,25058,25753,14099,15193,15810,37480,-666666666,17915,6211,37,069
"Gaston County, North Carolina",208379,100973,107406,160670,31500,764,2903,14,8093,4435,534,3901,195570,12809,0.4585,22654,24788,25007,12796,16624,20688,28553,,10440,7003,37,071
"Gates County, North Carolina",11877,5913,5964,7616,3973,14,49,0,33,192,0,192,11672,205,0.3823,22207,25000,25354,11768,17345,,43549,-666666666,,9207,37,073
"Graham County, North Carolina",8743,4285,4458,7804,25,611,94,0,102,107,3,104,8507,236,0.4583,20525,21833,21964,7928,23380,9757,7090,-666666666,13123,4809,37,075
"Granville County, North Carolina",57955,29549,28406,35678,18119,357,261,12,1962,1566,445,1121,53705,4250,0.4114,22756,27287,27721,13444,16889,12390,18043,,8806,8115,37,077
"Greene County, North Carolina",21353,11439,9914,11192,7690,154,65,0,1733,519,252,267,18225,3128,0.4269,18477,24108,26043,6492,14067,5255,19168,-666666666,6746,5402,37,079
"Guilford County, North Carolina",500899,238318,262581,286755,166006,2500,21434,243,13181,10780,1459,9321,463923,36976,0.4782,26322,33117,34677,12566,17759,18613,19349,22552,12241,10381,37,081
"Halifax County, North Carolina",53803,25754,28049,21529,27741,1785,429,8,503,1808,212,1596,52493,1310,0.4783,18728,25347,25482,15517,14072,20675,18626,,22255,8485,37,083
"Harnett County, North Carolina",121789,59921,61868,83794,25581,1138,1509,40,4910,4817,704,4113,107931,13858,0.4235,20274,23009,23910,11311,15793,13020,19476,11020,11180,7817,37,085
"Haywood County, North Carolina",59012,28618,30394,56551,617,176,260,51,385,972,179,793,56946,2066,0.4379,24870,25025,25298,14883,23953,22928,23544,,16587,19890,37,087
"Henderson County, North Carolina",108642,52551,56091,99242,3476,284,1066,153,2313,2108,243,1865,97941,10701,0.4352,25617,26584,27939,10754,15866,36723,26084,10278,9896,12804,37,089
"Hertford County, North Carolina",24460,12218,12242,8789,14457,296,169,1,168,580,15,565,23666,794,0.4835,17289,23825,25061,4487,13541,16041,17660,,15156,12507,37,091
"Hoke County, North Carolina",50034,24456,25578,23703,16827,4030,651,116,1979,2728,228,2500,43835,6199,0.4208,19036,22921,23944,15347,17420,11631,13565,46802,14764,9425,37,093
"Hyde County, North Carolina",5757,3195,2562,3596,2110,14,19,0,17,1,0,1,5453,304,0.3703,19796,26006,27819,5187,9446,,,-666666666,6635,,37,095
"Iredell County, North Carolina",162999,80206,82793,132659,20064,779,3511,39,3604,2343,295,2048,151466,11533,0.4696,27125,29690,30506,13077,15242,19518,26989,26849,10864,11429,37,097
"Jackson County, North Carolina",40598,20102,20496,33875,1316,3686,347,33,481,860,174,686,38509,2089,0.4739,21033,22818,23232,6370,6377,14321,13490,39688,11240,9745,37,099
"Johnston County, North Carolina",175343,86311,89032,137721,26422,788,1145,18,5353,3896,601,3295,152352,22991,0.4104,22589,24755,26581,10235,16708,17221,14285,,8138,9344,37,101
"Jones County, North Carolina",10184,4921,5263,6508,3156,31,15,47,200,227,0,227,9769,415,0.4369,20634,24320,24996,8163,14514,40448,2600,5800,12587,8682,37,103
"Lee County, North Carolina",59096,28919,30177,40384,11385,393,696,22,4743,1473,363,1110,47838,11258,0.4176,21556,25117,27411,10908,15598,20348,15601,,10766,8180,37,105
"Lenoir County, North Carolina",59095,28128,30967,31966,24024,149,317,15,1298,1326,168,1158,54955,4140,0.4470,19330,23293,24256,8885,14943,35840,22057,,10354,9777,37,107
"Lincoln County, North Carolina",79041,39119,39922,71228,4170,196,318,0,1485,1644,181,1463,73539,5502,0.4466,25693,26933,27642,13436,15681,19588,32535,-666666666,12770,8472,37,109
"McDowell County, North Carolina",44982,22789,22193,40597,1698,131,349,29,1412,766,161,605,42512,2470,0.4352,18730,19806,19942,8807,11194,11006,12724,,7979,2948,37,111
"Macon County, North Carolina",33840,16520,17320,31598,166,207,218,0,1074,577,8,569,31627,2213,0.4755,24120,24589,25045,16606,10981,8983,22248,-666666666,21178,13843,37,113
"Madison County, North Carolina",20951,10366,10585,20147,323,102,140,0,101,138,0,138,20458,493,0.4395,20791,21268,21517,7930,8103,4468,172,-666666666,2693,27028,37,115
"Martin County, North Carolina",23947,11277,12670,12858,10368,94,109,6,337,175,70,105,23135,812,0.4238,19313,23209,23569,9562,15004,13228,30983,,8284,6185,37,117
"Mecklenburg County, North Carolina",968500,466889,501611,551684,299381,3655,48043,722,38902,26113,3051,23062,848132,120368,0.4945,32817,41906,45692,15130,20877,17485,30153,11516,12927,14959,37,119
"Mitchell County, North Carolina",15380,7538,7842,14884,123,75,48,10,178,62,0,62,14707,673,0.4704,21388,21855,22257,8490,5555,10280,23281,,3841,4605,37,121
"Montgomery County, North Carolina",27626,13482,14144,21264,4874,423,442,7,375,241,54,187,23578,4048,0.4842,19193,21893,24704,8218,10317,7551,14689,,8756,6016,37,123
"Moore County, North Carolina",90579,43410,47169,74988,11160,615,900,0,643,2273,178,2095,85026,5553,0.4816,29570,32266,33582,12273,15842,13374,59073,-666666666,7004,7129,37,125
"Nash County, North Carolina",95174,45833,49341,52411,35965,629,769,0,3235,2165,471,1694,89066,6108,0.4507,23056,29222,29995,10517,16423,15354,14736,-666666666,9527,9409,37,127
"New Hanover County, North Carolina",209586,101171,108415,169358,30191,878,2807,108,2514,3730,245,3485,198378,11208,0.4830,29742,32723,33686,14328,16570,26686,24215,21666,14402,16466,37,129
"Northampton County, North Carolina",21310,10366,10944,8553,12018,34,20,12,49,624,6,618,20939,371,0.4560,18546,24725,25270,9132,14986,14203,39450,,4122,3264,37,131
"Onslow County, North Carolina",182921,98843,84078,136405,29206,1131,3570,531,4951,7127,1220,5907,162369,20552,0.3991,21583,23214,23768,17057,17441,17624,21450,25022,17112,10869,37,133
"Orange County, North Carolina",137275,65519,71756,103550,15834,443,9701,20,3284,4443,710,3733,125965,11310,0.5250,35406,39403,41160,14765,20787,21907,36211,9770,10540,12439,37,135
"Pamlico County, North Carolina",13062,6740,6322,10036,2497,132,28,80,36,253,0,253,12634,428,0.4423,24854,28340,28908,11773,14258,14364,17886,2069,13319,6226,37,137
"Pasquotank County, North Carolina",40233,19580,20653,23437,15041,32,575,118,264,766,65,701,38476,1757,0.4656,22466,28441,28287,27010,14381,,16195,23381,15072,4909,37,139
"Pender County, North Carolina",54218,27196,27022,41487,9437,243,330,21,1797,903,282,621,50829,3389,0.4619,23383,26539,26934,11197,14003,14497,23861,,9030,7740,37,141
"Perquimans County, North Carolina",13507,6488,7019,9803,3331,16,2,0,58,297,9,288,13209,298,0.4413,23260,26336,26500,38577,13423,,,-666666666,17122,30465,37,143
"Person County, North Carolina",39303,19134,20169,27023,10804,294,150,0,624,408,148,260,37669,1634,0.4227,21191,23777,24134,10861,15617,15125,50456,-666666666,8657,10354,37,145
"Pitt County, North Carolina",172438,81322,91116,101040,58787,551,2880,15,5357,3808,488,3320,162636,9802,0.4911,23439,29286,29867,12290,15101,19279,30068,-666666666,10096,11450,37,147
"Polk County, North Carolina",20352,9839,10513,18500,1052,39,36,0,568,157,23,134,19212,1140,0.4394,26686,28278,28369,14776,11798,2969,20450,-666666666,3265,30994,37,149
"Randolph County, North Carolina",142276,70243,72033,126049,7903,747,1452,28,3699,2398,97,2301,126970,15306,0.4170,20892,21541,22537,12832,16490,10388,21994,,17949,8580,37,151
"Richmond County, North Carolina",46317,22674,23643,28888,13935,1067,345,0,835,1247,1,1246,43474,2843,0.4505,17982,20827,21531,10553,13718,15489,26136,-666666666,9698,5135,37,153
"Robeson County, North Carolina",134913,65415,69498,41530,32510,50729,1070,105,5083,3886,351,3535,123977,10936,0.4845,15460,20304,22227,8599,12905,14276,16461,3710,10221,7416,37,155
"Rockingham County, North Carolina",92602,44604,47998,69883,17138,361,491,73,2648,2008,218,1790,87296,5306,0.4310,21138,23167,23549,10667,15840,22088,19715,12227,10906,9707,37,157
"Rowan County, North Carolina",138246,68226,70020,107400,22573,632,1359,0,4174,2108,340,1768,127263,10983,0.4430,21149,23585,23996,13506,13190,13337,23723,-666666666,9407,6205,37,159
"Rutherford County, North Carolina",67181,32526,34655,57666,6651,256,392,0,1080,1136,108,1028,64645,2536,0.4391,19686,20848,20990,11009,12888,11062,19593,-666666666,8288,13319,37,161
"Sampson County, North Carolina",63842,31393,32449,37361,16592,1086,210,13,6882,1698,203,1495,52701,11141,0.4703,19463,23745,25367,10178,14686,18761,19596,8238,11108,6314,37,163
"Scotland County, North Carolina",36034,17656,18378,16820,13916,3636,284,6,214,1158,71,1087,35115,919,0.4648,15787,21650,22100,10285,10819,10953,15473,,8755,6954,37,165
"Stanly County, North Carolina",60553,30308,30245,51218,6745,217,1184,10,268,911,36,875,58274,2279,0.4180,20880,22517,22987,9048,12317,13658,13428,,15042,5385,37,167
"Stokes County, North Carolina",46858,22860,23998,43781,1826,341,163,23,272,452,67,385,45568,1290,0.4307,21406,21791,21995,11426,17314,20156,18229,,12671,8749,37,169
"Surry County, North Carolina",73391,35904,37487,67709,2790,327,383,28,1026,1128,236,892,66086,7305,0.4520,20164,20816,21879,9184,13167,15117,17305,,9772,10563,37,171
"Swain County, North Carolina",14070,6841,7229,9172,385,3695,52,0,53,713,92,621,13843,227,0.4494,19312,21935,21837,24250,5557,13567,3213,-666666666,15270,24244,37,173
"Transylvania County, North Carolina",32943,15843,17100,29891,1256,123,183,0,831,659,75,584,31954,989,0.4293,24551,25773,26070,13690,14162,13920,14825,-666666666,14703,6021,37,175
"Tyrrell County, North Carolina",4219,2312,1907,2597,1187,65,105,6,145,114,0,114,3813,406,0.4380,16217,18900,19775,8010,12803,4262,14733,,10129,6997,37,177
"Union County, North Carolina",209387,103400,105987,170430,24725,837,3913,68,5900,3514,783,2731,186968,22419,0.4354,28765,30658,32332,13208,20869,19469,36542,70879,10867,15329,37,179
"Vance County, North Carolina",44998,21020,23978,19522,22500,106,69,0,2167,634,62,572,41880,3118,0.4663,18815,24158,24820,8847,15575,28078,17761,-666666666,8146,4279,37,181
"Wake County, North Carolina",952513,463511,489002,647615,197691,2949,55523,445,26647,21643,3145,18498,858347,94166,0.4428,33727,38533,41039,14967,22356,28102,34381,18564,12911,18804,37,183
"Warren County, North Carolina",20628,10529,10099,7951,10511,861,49,0,515,741,18,723,19869,759,0.4588,19022,27557,27734,7689,13735,13320,22929,-666666666,8121,16364,37,185
"Washington County, North Carolina",12837,5853,6984,6018,6457,30,0,0,233,99,79,20,12290,547,0.4720,18794,26404,26852,7345,12540,,-666666666,-666666666,4042,3193,37,187
"Watauga County, North Carolina",51903,25823,26080,48803,572,114,577,5,659,1173,103,1070,50113,1790,0.5310,21801,22624,22898,9037,11629,22432,6081,,7334,8298,37,189
"Wayne County, North Carolina",124093,60944,63149,70426,39063,199,1286,28,9275,3816,825,2991,111053,13040,0.4455,21818,26853,27262,10323,16512,17093,30447,,10050,9260,37,191
"Wilkes County, North Carolina",69093,34079,35014,62931,2971,135,248,24,1751,1033,347,686,65206,3887,0.4676,18441,19139,19425,8292,15576,11933,10541,13096,8501,3871,37,193
"Wilson County, North Carolina",81499,38699,42800,41625,31437,311,705,45,5651,1725,261,1464,73516,7983,0.4584,21426,28389,29227,9147,14658,19545,46936,8391,8680,8790,37,195
"Yadkin County, North Carolina",38101,18695,19406,34600,1287,73,72,0,1608,461,33,428,34215,3886,0.4662,22338,23395,24111,9566,21633,1642,5604,-666666666,7138,3914,37,197
"Yancey County, North Carolina",17662,8591,9071,17069,187,70,32,11,159,134,39,95,16837,825,0.4446,21330,21774,22145,9109,11666,29647,5581,,810,2958,37,199
"Adams County, North Dakota",2339,1181,1158,2231,11,39,20,0,11,27,0,27,2308,31,0.4360,33132,33608,33800,18713,25318,18462,8575,-666666666,,49915,38,001
"Barnes County, North Dakota",11096,5491,5605,10545,71,90,179,11,88,112,0,112,10939,157,0.4631,32698,33763,33814,16149,27194,10152,7463,5018,12017,13271,38,003
"Benson County, North Dakota",6764,3461,3303,2908,0,3770,12,3,21,50,0,50,6643,121,0.5074,19443,32103,32068,13500,-666666666,9736,5442,,11086,20578,38,005
"Billings County, North Dakota",855,484,371,820,4,5,26,0,0,0,0,0,854,1,0.4893,42832,44075,44129,,,,12200,-666666666,-666666666,-666666666,38,007
"Bottineau County, North Dakota",6579,3422,3157,6195,45,125,7,0,35,172,8,164,6472,107,0.4786,31638,32900,33020,13721,13471,10163,,-666666666,9449,11902,38,009
"Bowman County, North Dakota",3192,1560,1632,3041,3,32,0,0,96,20,0,20,3070,122,0.4647,34290,35368,35430,21287,,,-666666666,-666666666,19418,1660,38,011
"Burke County, North Dakota",2145,1126,1019,2076,10,26,8,0,11,14,0,14,2040,105,0.4635,33174,33946,35045,10158,30090,7054,9000,-666666666,,5514,38,013
"Burleigh County, North Dakota",86111,42541,43570,79704,647,3180,497,33,264,1786,64,1722,84768,1343,0.4275,33644,34676,34887,15327,29012,13568,82844,,18418,13276,38,015
"Cass County, North Dakota",158041,79800,78241,143099,4595,1843,3947,21,937,3599,389,3210,154530,3511,0.4603,31415,33014,33110,18383,11787,13885,25856,20448,21086,10702,38,017
"Cavalier County, North Dakota",3922,1969,1953,3785,4,47,13,0,0,73,5,68,3922,0,0.4482,36141,36895,36895,-666666666,,17543,,-666666666,-666666666,15233,38,019
"Dickey County, North Dakota",5234,2634,2600,5054,71,38,10,0,20,41,2,39,5097,137,0.4318,27056,27578,27882,14268,10777,19971,12420,-666666666,20510,4200,38,021
"Divide County, North Dakota",2239,1162,1077,2180,8,31,8,0,0,12,0,12,2239,0,0.5203,41003,41677,41677,-666666666,,23942,,-666666666,-666666666,,38,023
"Dunn County, North Dakota",3965,2115,1850,3316,7,392,59,4,36,151,39,112,3826,139,0.5058,38216,41848,42155,8533,23514,19097,17242,,,21834,38,025
"Eddy County, North Dakota",2379,1179,1200,2247,0,87,0,4,10,31,0,31,2296,83,0.4664,29059,29595,30335,12865,-666666666,13164,-666666666,36050,,26632,38,027
"Emmons County, North Dakota",3491,1796,1695,3466,0,8,6,0,0,11,0,11,3483,8,0.5095,28042,28160,28213,,-666666666,,,-666666666,-666666666,,38,029
"Foster County, North Dakota",3364,1667,1697,3319,3,10,16,0,1,15,0,15,3305,59,0.4205,30060,30228,30560,11805,,,26656,-666666666,,12093,38,031
"Golden Valley County, North Dakota",1812,866,946,1772,0,18,0,0,2,20,0,20,1802,10,0.4935,28359,28981,28880,41050,-666666666,1217,-666666666,-666666666,,490,38,033
"Grand Forks County, North Dakota",68144,35095,33049,61033,1767,1815,1485,30,310,1704,183,1521,65806,2338,0.4851,27772,29344,29509,21169,11100,11793,25513,28830,20935,8994,38,035
"Grant County, North Dakota",2363,1176,1187,2281,8,38,0,0,6,30,0,30,2355,8,0.5081,31092,31827,31831,15600,,18118,-666666666,-666666666,,2010,38,037
"Griggs County, North Dakota",2348,1153,1195,2322,13,9,2,0,0,2,0,2,2344,4,0.4185,29528,29422,29473,,,,,-666666666,-666666666,,38,039
"Hettinger County, North Dakota",2575,1214,1361,2464,17,52,0,11,3,28,6,22,2539,36,0.4328,28719,29723,29405,46556,688,9750,-666666666,4382,,1807,38,041
"Kidder County, North Dakota",2434,1248,1186,2374,0,0,0,0,26,34,18,16,2321,113,0.4563,32233,32719,33115,15685,-666666666,-666666666,-666666666,-666666666,26627,2612,38,043
"LaMoure County, North Dakota",4127,2153,1974,4068,1,6,0,0,0,52,0,52,4102,25,0.4758,33368,33649,33786,11596,,,-666666666,-666666666,-666666666,15815,38,045
"Logan County, North Dakota",1955,939,1016,1925,7,7,6,0,0,10,0,10,1927,28,0.4786,30798,31146,31331,18611,,,,-666666666,-666666666,1790,38,047
"McHenry County, North Dakota",5711,2999,2712,5577,5,43,13,0,6,67,3,64,5586,125,0.4491,29987,30359,30734,11962,8040,20016,10069,-666666666,25183,11336,38,049
"McIntosh County, North Dakota",2788,1344,1444,2693,2,5,20,0,0,68,0,68,2780,8,0.4781,27384,27688,27731,13313,,19060,27085,-666666666,-666666666,10709,38,051
"McKenzie County, North Dakota",8333,4389,3944,6581,18,1430,50,0,87,167,18,149,7967,366,0.4809,34688,40947,41903,13206,17556,10779,14056,-666666666,17879,9543,38,053
"McLean County, North Dakota",9299,4714,4585,8507,6,678,11,0,11,86,10,76,9131,168,0.4466,31187,32301,32621,14288,,19540,9373,-666666666,,15564,38,055
"Mercer County, North Dakota",8532,4407,4125,8164,46,212,23,0,19,68,5,63,8369,163,0.3981,31584,32195,31939,36732,,18841,21400,-666666666,,26456,38,057
"Morton County, North Dakota",28428,14331,14097,26398,239,943,65,0,219,564,0,564,27847,581,0.4118,30293,30969,31036,19510,15828,20297,109545,-666666666,10728,19954,38,059
"Mountrail County, North Dakota",8743,4814,3929,5735,30,2445,24,0,90,419,13,406,8308,435,0.4572,33839,42605,43018,11240,49633,16802,7900,-666666666,10127,18706,38,061
"Nelson County, North Dakota",3078,1594,1484,2980,37,43,0,0,0,18,0,18,3031,47,0.4388,30411,30715,30862,21549,11092,23979,-666666666,-666666666,-666666666,35061,38,063
"Oliver County, North Dakota",1832,924,908,1717,3,65,3,0,17,27,17,10,1786,46,0.4234,31194,32602,32710,12717,,9225,,-666666666,,,38,065
"Pembina County, North Dakota",7266,3705,3561,6910,10,185,6,0,65,90,2,88,7058,208,0.4043,29093,29777,29974,20260,25190,14981,,-666666666,22558,11580,38,067
"Pierce County, North Dakota",4402,2242,2160,4149,9,210,0,0,2,32,0,32,4342,60,0.4215,24729,25895,25894,12150,22922,4860,-666666666,-666666666,,5531,38,069
"Ramsey County, North Dakota",11522,5913,5609,10074,93,944,80,0,55,276,9,267,11300,222,0.4603,28670,31357,31537,13941,27047,7899,26131,-666666666,,7789,38,071
"Ransom County, North Dakota",5452,2799,2653,5312,28,25,18,0,6,63,0,63,5371,81,0.4336,28896,29111,29410,9217,,20048,8522,-666666666,,16800,38,073
"Renville County, North Dakota",2546,1298,1248,2480,6,16,28,0,0,16,0,16,2542,4,0.3865,31781,32106,32103,,,12588,24471,-666666666,-666666666,20294,38,075
"Richland County, North Dakota",16307,8445,7862,15358,92,420,90,14,120,213,11,202,15945,362,0.4137,28499,29132,29362,11753,9416,13200,48608,3164,14491,22374,38,077
"Rolette County, North Dakota",14341,7141,7200,2916,45,10993,7,6,34,340,46,294,14135,206,0.5006,15825,28762,29203,2564,6811,12593,,,7641,11191,38,079
"Sargent County, North Dakota",3863,2030,1833,3735,33,29,17,0,30,19,4,15,3776,87,0.4201,32086,32759,32893,17348,21864,8766,9259,-666666666,,13400,38,081
"Sheridan County, North Dakota",1320,679,641,1296,9,3,0,0,2,10,0,10,1316,4,0.4740,33010,33442,33494,,25611,,-666666666,-666666666,,,38,083
"Sioux County, North Dakota",4317,2211,2106,590,1,3551,11,3,23,138,37,101,4186,131,0.5345,16287,28504,28597,14056,,14198,56691,,,8797,38,085
"Slope County, North Dakota",715,411,304,707,2,0,0,0,0,6,0,6,712,3,0.4391,33389,33554,33678,,,-666666666,-666666666,-666666666,-666666666,,38,087
"Stark County, North Dakota",27038,13890,13148,25180,294,322,353,27,459,403,67,336,26106,932,0.4143,33396,34736,34898,18159,14925,13254,14424,,15343,12734,38,089
"Steele County, North Dakota",1982,1047,935,1971,0,0,0,0,11,0,0,0,1951,31,0.4471,33619,33552,33772,24003,-666666666,-666666666,-666666666,-666666666,,-666666666,38,091
"Stutsman County, North Dakota",21056,10669,10387,19992,108,239,78,38,162,439,26,413,20658,398,0.4416,29361,30128,30330,17232,5631,14375,18259,,28910,13122,38,093
"Towner County, North Dakota",2292,1129,1163,2158,0,37,3,0,2,92,7,85,2273,19,0.4352,34103,35410,35611,2505,-666666666,31746,,-666666666,,5966,38,095
"Traill County, North Dakota",8106,4073,4033,7845,58,102,7,0,10,84,0,84,7874,232,0.4528,29736,30355,30967,10914,14402,10378,,-666666666,46140,6526,38,097
"Walsh County, North Dakota",11052,5602,5450,10078,21,179,47,0,590,137,3,134,9941,1111,0.4504,29322,30904,31812,13366,7119,10964,23183,-666666666,12896,13160,38,099
"Ward County, North Dakota",65854,34179,31675,58744,1992,1070,720,99,865,2364,87,2277,63126,2728,0.4254,29564,30832,31245,15259,24043,23635,26975,15930,15100,12029,38,101
"Wells County, North Dakota",4210,2057,2153,4134,0,5,0,0,8,63,0,63,4195,15,0.4670,29980,30266,30289,27113,-666666666,,-666666666,-666666666,,11778,38,103
"Williams County, North Dakota",27066,14394,12672,24564,302,1127,149,8,343,573,12,561,26075,991,0.4396,41984,43364,43982,30213,23394,27904,69753,,43474,12402,38,105
"Adams County, Ohio",28342,13999,14343,27654,68,46,26,0,15,533,13,520,28102,240,0.4458,17695,17913,17914,15833,8703,16391,21600,-666666666,,7580,39,001
"Allen County, Ohio",105562,53186,52376,88027,12490,285,821,0,810,3129,228,2901,102844,2718,0.4490,22585,23762,23884,16275,15446,12267,63081,-666666666,21163,8633,39,003
"Ashland County, Ohio",53202,26006,27196,51610,397,36,294,0,217,648,0,648,52620,582,0.4186,22441,22641,22710,24477,12131,10281,13195,-666666666,44518,10352,39,005
"Ashtabula County, Ohio",100346,50307,50039,93531,3428,115,388,20,400,2464,138,2326,96721,3625,0.4256,20284,20708,21062,10298,15173,15875,37949,,15570,9622,39,007
"Athens County, Ohio",64840,32388,32452,59202,1484,267,2121,22,150,1594,43,1551,63714,1126,0.4973,17069,17480,17552,11688,12542,6559,15484,,23711,9207,39,009
"Auglaize County, Ohio",45867,22758,23109,44744,161,55,167,31,171,538,62,476,45266,601,0.3820,25033,25235,25356,12564,14611,15644,35043,21916,21115,10645,39,011
"Belmont County, Ohio",69793,35449,34344,65442,2654,66,279,2,162,1188,56,1132,69264,529,0.4329,23285,23671,23714,10803,16444,6309,78927,,11415,6859,39,013
"Brown County, Ohio",44464,21931,22533,43352,438,1,92,2,25,554,21,533,44142,322,0.4298,22088,22166,22234,12641,28746,,25774,,1408,11096,39,015
"Butler County, Ohio",371154,181704,189450,320442,28412,626,9801,143,3961,7769,439,7330,355455,15699,0.4358,27394,28505,28941,14943,20743,21949,30464,19198,10847,11047,39,017
"Carroll County, Ohio",28539,14280,14259,27840,204,3,62,8,46,376,55,321,28244,295,0.4054,22359,22526,22544,17320,15727,,18068,,4309,14845,39,019
"Champaign County, Ohio",39628,19804,19824,37460,805,56,152,16,177,962,72,890,39109,519,0.3913,23573,23971,24084,10954,17601,17700,44663,,14709,11092,39,021
"Clark County, Ohio",137303,66448,70855,118422,11727,290,998,61,1915,3890,77,3813,133284,4019,0.4414,22941,23901,24041,11966,18484,16286,41661,21077,11251,8655,39,023
"Clermont County, Ohio",199450,98518,100932,190406,2659,398,1980,60,1068,2879,106,2773,196206,3244,0.4270,28708,28913,29003,18375,28434,43886,35770,6480,11353,15293,39,025
"Clinton County, Ohio",41871,20650,21221,39641,1032,104,132,0,174,788,34,754,41235,636,0.4454,22828,22622,22746,10347,46318,21329,6670,-666666666,9029,8390,39,027
"Columbiana County, Ohio",106622,53541,53081,101701,2340,132,379,0,516,1554,15,1539,105140,1482,0.4322,22573,23001,23107,13703,11835,20399,21107,-666666666,17723,12886,39,029
"Coshocton County, Ohio",36768,18239,18529,35653,391,59,98,0,51,516,51,465,36455,313,0.4134,20799,21071,21022,29895,14645,11615,19970,-666666666,29741,6993,39,031
"Crawford County, Ohio",43036,20805,22231,41745,381,6,125,0,31,748,27,721,42469,567,0.4162,21938,22237,22344,10183,6307,,28879,-666666666,29277,11874,39,033
"Cuyahoga County, Ohio",1267513,602698,664815,809281,375406,2978,34255,211,14456,30926,3638,27288,1202995,64518,0.5008,27892,33545,34363,16886,16562,19192,36787,30799,18749,12746,39,035
"Darke County, Ohio",52537,25729,26808,51363,336,96,63,0,85,594,36,558,51832,705,0.4173,22582,22774,22890,14550,8594,29759,22573,-666666666,17094,13544,39,037
"Defiance County, Ohio",38795,19242,19553,35647,829,199,114,4,1296,706,161,545,35202,3593,0.3971,23539,24335,24820,13960,16142,9676,24228,,15225,11142,39,039
"Delaware County, Ohio",181821,89850,91971,162353,6587,205,8542,122,978,3034,146,2888,177695,4126,0.4251,41357,42082,42242,31974,34885,31327,44231,53274,23206,14561,39,041
"Erie County, Ohio",76416,37408,39008,66443,6221,291,442,58,540,2421,113,2308,73587,2829,0.4340,26909,28375,28775,14739,18845,25253,32691,43414,14799,8840,39,043
"Fairfield County, Ohio",148067,73561,74506,132857,8868,234,2003,0,845,3260,188,3072,145249,2818,0.4202,28099,28540,28674,19712,27217,18876,33385,-666666666,20132,11992,39,045
"Fayette County, Ohio",28875,14292,14583,27246,539,25,172,0,244,649,61,588,28344,531,0.4186,21033,21232,21304,12694,18829,,38487,-666666666,9612,14619,39,047
"Franklin County, Ohio",1197592,583151,614441,829283,254694,1950,49679,424,20038,41524,2719,38805,1138435,59157,0.4692,28807,33127,33858,14904,17684,19814,32284,29106,12957,14671,39,049
"Fulton County, Ohio",42541,20961,21580,40646,243,51,140,0,883,578,112,466,39099,3442,0.4291,26070,26717,27332,15364,10908,17496,10736,-666666666,12527,12110,39,051
"Gallia County, Ohio",30763,15010,15753,29105,834,32,161,0,120,511,0,511,30432,331,0.4669,21049,21169,21246,10696,14506,20816,85164,-666666666,773,9458,39,053
"Geauga County, Ohio",93819,46053,47766,90841,1067,54,599,0,69,1189,166,1023,92682,1137,0.4499,35407,35758,35817,24795,27540,17541,30839,-666666666,23388,19483,39,055
"Greene County, Ohio",163313,80129,83184,140837,12078,213,4870,44,731,4540,281,4259,159330,3983,0.4462,30629,31892,31978,24302,20243,67031,32769,3466,20617,16947,39,057
"Guernsey County, Ohio",39794,19662,20132,38184,764,33,122,1,27,663,5,658,39422,372,0.4362,21559,21833,21868,14053,10545,43130,76423,,,8114,39,059
"Hamilton County, Ohio",803272,385969,417303,553451,206204,1516,17246,316,5908,18631,1033,17598,781303,21969,0.5067,30062,35229,35535,21436,17555,16577,35942,60269,20282,13234,39,061
"Hancock County, Ohio",75290,36607,38683,70560,1052,82,1325,21,743,1507,318,1189,71685,3605,0.4312,26612,27360,27557,18872,18010,10724,22930,,16692,6489,39,063
"Hardin County, Ohio",31826,15811,16015,30614,277,82,236,2,114,501,55,446,31376,450,0.4194,20011,20305,20284,12871,10221,23088,22511,,8666,8359,39,065
"Harrison County, Ohio",15698,7813,7885,15050,324,41,12,0,27,244,3,241,15591,107,0.4282,22180,22444,22482,17236,13763,20139,16775,-666666666,27419,17107,39,067
"Henry County, Ohio",28074,13886,14188,26623,92,23,117,18,714,487,92,395,26120,1954,0.3907,24604,25254,25653,14338,11993,36287,20911,6772,13752,8397,39,069
"Highland County, Ohio",43266,21364,21902,41652,591,31,147,0,18,827,85,742,42927,339,0.4113,19587,19830,19882,14234,14085,13997,19097,-666666666,,11811,39,071
"Hocking County, Ohio",29111,14632,14479,28325,214,8,89,0,66,409,0,409,28882,229,0.4184,21253,21458,21483,12472,16597,,18699,-666666666,8523,12433,39,073
"Holmes County, Ohio",43176,21652,21524,42541,212,21,40,23,127,212,4,208,42792,384,0.3965,17716,17854,17899,9407,11518,,16975,,3815,7923,39,075
"Huron County, Ohio",59186,29159,30027,55628,559,172,165,0,1422,1240,283,957,55708,3478,0.3964,22666,23450,23752,11154,10214,15443,21562,-666666666,10068,8672,39,077
"Jackson County, Ohio",32952,16094,16858,31933,228,40,40,0,63,648,55,593,32651,301,0.4443,20250,20426,20520,10261,10900,19715,55250,-666666666,43532,10472,39,079
"Jefferson County, Ohio",68510,33187,35323,62847,3820,69,228,3,79,1464,111,1353,67668,842,0.4483,22591,23417,23491,15242,14705,30767,19596,,9803,8542,39,081
"Knox County, Ohio",61063,29889,31174,58985,530,49,458,9,95,937,27,910,60246,817,0.4357,23926,24253,24370,14954,20618,20837,22016,,20164,6938,39,083
"Lake County, Ohio",229602,112010,117592,212818,8374,230,2883,5,1578,3714,450,3264,221098,8504,0.4175,29556,30347,30795,14180,17544,23279,40168,,15277,9517,39,085
"Lawrence County, Ohio",62100,30344,31756,59292,1181,105,139,0,125,1258,160,1098,61601,499,0.4352,21760,22108,22187,10253,20873,6415,27351,-666666666,12777,7731,39,087
"Licking County, Ohio",167911,82203,85708,156194,5711,224,1582,0,455,3745,117,3628,165294,2617,0.4275,27082,27667,27743,19994,25501,28041,18144,-666666666,19889,9703,39,089
"Logan County, Ohio",45564,22365,23199,43391,723,171,251,0,132,896,33,863,44973,591,0.4165,23897,24202,24256,19081,20513,19235,41701,-666666666,24738,7625,39,091
"Lorain County, Ohio",302465,148884,153581,257939,25384,751,3007,93,4738,10553,1362,9191,275828,26637,0.4335,26487,28569,29408,15471,13925,16003,29702,7677,19671,8871,39,093
"Lucas County, Ohio",438167,212492,225675,321231,82810,1300,7216,190,8542,16878,3530,13348,410038,28129,0.4847,24683,28075,28636,13342,14812,14447,36122,20152,15764,9015,39,095
"Edwards County, Texas",2037,982,1055,1994,15,0,0,0,28,0,0,0,1040,997,0.4376,28407,28961,43635,13178,-666666666,-666666666,-666666666,-666666666,4139,-666666666,48,137
"Ellis County, Texas",154447,76308,78139,126853,13717,1781,917,28,7284,3867,795,3072,116860,37587,0.4071,25924,27515,31101,13795,20926,12444,50773,,13747,14536,48,139
"El Paso County, Texas",823862,401890,421972,672899,27991,4935,8820,1275,90020,17922,6819,11103,152916,670946,0.4676,18705,19125,35158,15625,22532,19332,28448,14854,13865,16537,48,141
"Erath County, Texas",39291,19326,19965,35752,548,255,284,0,1825,627,111,516,31567,7724,0.4956,21306,21990,23904,11465,12507,8788,54343,-666666666,9864,13436,48,143
"Falls County, Texas",17524,8244,9280,12217,4394,20,12,8,568,305,22,283,13713,3811,0.4470,16749,19532,23224,8827,10744,11685,,,9717,5086,48,145
"Fannin County, Texas",33775,17855,15920,29626,2366,145,163,16,623,836,104,732,30375,3400,0.4335,20784,22124,23401,9436,8147,14067,46279,23006,6687,15738,48,147
"Fayette County, Texas",24725,12200,12525,22404,1764,2,39,7,371,138,20,118,19957,4768,0.4960,28403,29865,33504,14519,15515,,10510,,11861,6155,48,149
"Fisher County, Texas",3882,1868,2014,3479,123,14,15,4,194,53,12,41,2809,1073,0.4381,25235,26450,30063,15393,11889,,,,18186,6104,48,151
"Floyd County, Texas",6263,3086,3177,5760,180,3,1,0,131,188,50,138,2825,3438,0.4741,22375,22932,33819,14259,14775,,,-666666666,22858,12029,48,153
"Foard County, Texas",1159,564,595,1044,12,0,9,0,94,0,0,0,990,169,0.3652,21105,22277,22946,10837,16067,-666666666,,-666666666,8609,-666666666,48,155
"Fort Bend County, Texas",632946,310934,322012,336627,133455,1408,113544,45,32357,15510,3885,11625,481330,151616,0.4284,35024,40173,49731,20378,27748,31387,34886,92542,19003,20476,48,157
"Franklin County, Texas",10600,5352,5248,9759,473,73,27,6,129,133,0,133,9211,1389,0.5215,28058,29296,31971,12565,12524,12347,,,25410,6647,48,159
"Freestone County, Texas",19661,10333,9328,15756,3248,169,31,0,267,190,19,171,16862,2799,0.4490,23008,24969,27395,11565,14277,31508,4823,-666666666,18718,11063,48,161
"Frio County, Texas",17847,10500,7347,13990,696,3,54,0,2943,161,85,76,3925,13922,0.4712,15732,16463,29641,13350,3941,,1628,-666666666,15599,10197,48,163
"Gaines County, Texas",18496,9440,9056,16814,291,146,82,58,858,247,106,141,11414,7082,0.4466,21690,22204,24247,18061,8261,30884,16488,,16988,9830,48,165
"Galveston County, Texas",302276,149539,152737,236399,40672,876,9869,51,6730,7679,1562,6117,232226,70050,0.4564,31030,33524,38341,18829,20903,28759,31067,27729,21689,16309,48,167
"Garza County, Texas",6337,4037,2300,5416,398,47,3,8,308,157,110,47,2874,3463,0.4679,17389,18999,35410,4705,10179,17779,,,7224,1138,48,169
"Gillespie County, Texas",25179,12185,12994,24281,58,119,91,18,258,354,31,323,19898,5281,0.4709,30757,30939,35326,13441,21609,18663,26097,,19731,33074,48,171
"Glasscock County, Texas",1190,654,536,1147,0,0,0,0,43,0,0,0,844,346,0.4336,39169,39789,47114,19787,-666666666,-666666666,-666666666,-666666666,22628,-666666666,48,173
"Goliad County, Texas",7357,3571,3786,5538,346,0,23,8,1295,147,25,122,4760,2597,0.4960,30556,34852,36506,22245,15307,-666666666,74126,,15980,22599,48,175
"Gonzales County, Texas",20054,10069,9985,11676,1396,27,43,0,6498,414,214,200,10309,9745,0.4798,20794,26072,30271,13481,12306,26007,13693,-666666666,13433,16508,48,177
"Gray County, Texas",22771,11928,10843,19691,1023,252,95,4,1018,688,97,591,16959,5812,0.4363,22285,23809,27445,12540,9450,17073,12901,,17418,8284,48,179
"Grayson County, Texas",121975,59446,62529,104887,7069,1504,1192,93,3648,3582,546,3036,107415,14560,0.4415,24614,26127,27523,12933,15519,20397,20681,36869,14969,10825,48,181
"Gregg County, Texas",122736,60130,62606,91230,24910,666,1684,209,2406,1631,483,1148,101506,21230,0.4662,24137,27005,30431,12662,15059,31015,30927,,13209,10825,48,183
"Grimes County, Texas",26812,14400,12412,19999,4184,371,4,0,1313,941,106,835,20874,5938,0.4648,20858,24031,26768,13173,9967,9639,,-666666666,12944,17421,48,185
"Guadalupe County, Texas",139709,68732,70977,115158,9550,511,2237,44,7931,4278,699,3579,88919,50790,0.3978,26696,27812,32894,18215,25721,26788,19623,22011,18449,17871,48,187
"Hale County, Texas",35925,18577,17348,30083,1534,172,170,2,1703,2261,458,1803,15305,20620,0.4360,18061,19527,28052,12904,6243,14592,24557,,15031,8649,48,189
"Hall County, Texas",3270,1657,1613,2735,232,4,1,0,196,102,11,91,2158,1112,0.5034,18314,20081,23476,11298,10627,,,-666666666,9178,6644,48,191
"Hamilton County, Texas",8330,4113,4217,8161,65,6,16,3,21,58,0,58,7428,902,0.4677,23734,22892,24411,10397,13866,,,,20376,15578,48,193
"Hansford County, Texas",5540,2772,2768,5078,6,40,44,0,288,84,60,24,3068,2472,0.4519,23631,24306,32177,13602,5783,19670,25375,-666666666,13787,18768,48,195
"Hardeman County, Texas",4050,1951,2099,3393,373,8,27,0,140,109,57,52,3186,864,0.4558,20373,21743,24388,12692,9647,,,-666666666,15814,22021,48,197
"Hardin County, Texas",55215,27203,28012,49992,3242,177,345,10,885,564,88,476,52462,2753,0.4320,25326,26334,26788,17557,11944,31581,18454,,20798,22466,48,199
"Harris County, Texas",4269608,2124242,2145366,2682615,807519,20728,274354,2892,392861,88639,24464,64175,2503125,1766483,0.4956,28454,32810,48802,15943,20115,21598,32613,16269,15629,18551,48,201
"Harrison County, Texas",66971,32754,34217,48661,14847,206,336,0,1735,1186,197,989,59086,7885,0.4630,23452,25612,27276,11727,18952,21547,12661,-666666666,7645,17691,48,203
"Hartley County, Texas",6091,3776,2315,5122,485,3,8,0,407,66,31,35,4573,1518,0.4223,23563,26879,31972,8337,1458,18267,,-666666666,9113,19953,48,205
"Haskell County, Texas",5875,3196,2679,5104,201,4,54,0,339,173,82,91,4424,1451,0.4591,23421,24759,29167,8239,19381,,12770,-666666666,12810,12820,48,207
"Hays County, Texas",170410,84862,85548,141909,5882,578,2327,212,14728,4774,952,3822,108547,61863,0.4610,27080,29187,34036,17116,20577,30745,30552,5173,13527,13109,48,209
"Hemphill County, Texas",4032,1992,2040,3483,5,32,9,0,380,123,87,36,2662,1370,0.4546,29473,32520,39086,12073,4360,28006,,-666666666,7014,14524,48,211
"Henderson County, Texas",78836,38701,40135,70556,5100,530,435,32,1039,1144,190,954,69801,9035,0.4595,21857,22444,23962,9992,20441,13901,15848,,9281,9778,48,213
"Hidalgo County, Texas",806447,393013,413434,735369,4744,2795,8334,66,48990,6149,3650,2499,73268,733179,0.4901,14525,14370,31258,12932,16205,11738,30715,14018,13475,19459,48,215
"Hill County, Texas",35027,17094,17933,31286,2523,299,137,0,425,357,69,288,28337,6690,0.4456,21041,21880,24149,12193,15044,9674,19620,-666666666,14374,7856,48,217
"Hockley County, Texas",23205,11407,11798,19323,806,216,85,5,2221,549,274,275,12669,10536,0.4410,22630,23988,29880,15974,10168,9700,17258,,18569,15587,48,219
"Hood County, Texas",52347,25814,26533,49007,395,375,275,0,1729,566,71,495,46602,5745,0.4372,29659,30594,32048,14462,9586,17500,24319,-666666666,13893,21548,48,221
"Hopkins County, Texas",35478,17531,17947,30163,2460,207,242,14,1867,525,77,448,29895,5583,0.4327,21674,23084,24804,11235,14400,21666,22784,,12210,7812,48,223
"Houston County, Texas",23151,12351,10800,15628,6008,10,42,0,1080,383,12,371,20737,2414,0.4818,17830,21798,23263,7168,9843,,14467,-666666666,9687,4881,48,225
"Howard County, Texas",35702,20190,15512,28966,2037,372,335,95,2572,1325,578,747,21706,13996,0.4499,21080,22846,29677,10587,15825,15558,22164,7641,11785,10839,48,227
"Hudspeth County, Texas",3344,1667,1677,3167,27,0,16,0,88,46,4,42,710,2634,0.5033,13660,13657,26164,10156,12641,-666666666,64406,-666666666,6867,9791,48,229
"Hunt County, Texas",87256,43145,44111,69414,7449,489,1045,3,7128,1728,185,1543,74818,12438,0.4502,22446,24931,25883,11931,13269,19508,13093,,11813,12496,48,231
"Hutchinson County, Texas",21947,11052,10895,19548,560,306,104,31,733,665,125,540,17265,4682,0.4302,24231,24970,26820,17155,18175,14519,32790,,15958,20485,48,233
"Irion County, Texas",1626,781,845,1507,2,0,0,0,57,60,0,60,1189,437,0.4668,30444,31892,36470,18129,,-666666666,-666666666,-666666666,20956,2483,48,235
"Jack County, Texas",8967,5021,3946,8383,354,38,13,0,76,103,19,84,7602,1365,0.4810,23126,24010,26413,10551,3248,60639,,-666666666,12271,13560,48,237
"Jackson County, Texas",14336,6916,7420,12402,1134,30,0,9,454,307,68,239,9993,4343,0.4093,23368,24601,28429,15261,17309,23443,-666666666,,17997,3790,48,239
"Jasper County, Texas",35826,17592,18234,28477,5941,158,179,7,598,466,38,428,33603,2223,0.4437,19969,22136,23045,7826,12265,11697,14601,,9456,4304,48,241
"Jeff Davis County, Texas",2282,1152,1130,2107,3,35,30,3,101,3,0,3,1430,852,0.4036,28902,29724,34788,20109,,34943,7837,,18486,,48,243
"Jefferson County, Texas",252466,129038,123428,145308,84601,832,9089,117,7885,4634,1239,3395,206802,45664,0.4942,23563,28413,32917,13741,16549,19301,27102,17878,10787,15232,48,245
"Jim Hogg County, Texas",5266,2723,2543,4967,110,2,0,0,94,93,80,13,374,4892,0.4737,19746,20199,21023,20004,124,,-666666666,-666666666,9088,29115,48,247
"Jim Wells County, Texas",41348,20473,20875,38271,343,147,148,0,2057,382,123,259,8571,32777,0.4769,20977,21280,32629,18251,13522,16554,34184,-666666666,17503,12587,48,249
"Johnson County, Texas",153854,77017,76837,141830,3727,849,1144,608,2304,3392,430,2962,124501,29353,0.4005,24787,25428,27952,14297,21621,27765,17086,15912,16743,10383,48,251
"Jones County, Texas",20092,12705,7387,15232,2855,155,74,0,1328,448,115,333,14844,5248,0.4462,15309,18515,21812,7472,4564,8268,4557,-666666666,6701,4514,48,253
"Karnes County, Texas",14884,8839,6045,9195,1320,61,84,0,4022,202,183,19,7295,7589,0.5513,22966,29448,36090,15386,8491,31856,16836,-666666666,13299,14806,48,255
"Kaufman County, Texas",107119,52591,54528,89556,10127,610,794,318,2743,2971,451,2520,87575,19544,0.4016,24959,26122,28822,13636,21286,19828,26347,14232,15497,12998,48,257
"Kendall County, Texas",36058,17613,18445,34076,250,176,212,26,779,539,14,525,28341,7717,0.4498,36169,36882,40276,22026,21155,6432,43895,,17352,33654,48,259
"Kenedy County, Texas",528,269,259,508,9,0,1,0,10,0,0,0,143,385,0.3705,13959,13707,13699,13948,,-666666666,,-666666666,16580,-666666666,48,261
"Kent County, Texas",858,444,414,831,2,1,0,0,24,0,0,0,733,125,0.4283,25222,25630,28258,7788,,,-666666666,-666666666,13604,-666666666,48,263
"Kerr County, Texas",49914,24133,25781,46255,867,255,465,9,1343,720,101,619,37489,12425,0.4640,26108,26683,30160,15254,12669,13037,29967,,15991,25955,48,265
"Kimble County, Texas",4522,2217,2305,4231,1,16,0,4,234,36,20,16,3450,1072,0.5161,27544,28717,31858,14380,,,-666666666,,11214,5939,48,267
"King County, Texas",290,147,143,281,0,0,0,0,9,0,0,0,226,64,0.4169,30871,31442,36104,12394,-666666666,-666666666,-666666666,-666666666,13056,-666666666,48,269
"Kinney County, Texas",3598,1965,1633,3490,52,34,0,0,10,12,0,12,1383,2215,0.4095,15689,15877,21746,12045,14983,5429,-666666666,-666666666,,,48,271
"Kleberg County, Texas",32142,16668,15474,27691,1288,128,683,0,1879,473,69,404,9316,22826,0.4802,19230,19899,30004,16044,14378,8452,11586,-666666666,14596,25638,48,273
"Knox County, Texas",3776,1899,1877,3263,271,27,2,1,202,10,1,9,2565,1211,0.4145,19470,20438,23974,12350,9380,22619,,,13245,98660,48,275
"Lamar County, Texas",49704,24065,25639,39986,6268,198,389,87,754,2022,90,1932,46253,3451,0.4491,21523,23003,23809,10755,14677,18398,46412,77138,10758,10610,48,277
"Lamb County, Texas",13875,7019,6856,12258,645,72,20,0,580,300,106,194,6511,7364,0.4639,19555,20418,29497,12466,14586,22531,9410,-666666666,13296,7019,48,279
"Lampasas County, Texas",20020,9843,10177,17704,938,149,115,10,480,624,98,526,16353,3667,0.4120,24134,24241,26211,14713,36430,29981,24551,,16050,7265,48,281
"La Salle County, Texas",7075,3917,3158,5593,85,58,0,0,1274,65,27,38,1107,5968,0.5475,17184,16860,41404,13314,1831,14233,-666666666,-666666666,19928,13958,48,283
"Lavaca County, Texas",19438,9405,10033,15403,1406,3,63,0,2266,297,199,98,16128,3310,0.4377,25196,28139,28544,15285,14104,,31567,-666666666,14546,4685,48,285
"Lee County, Texas",16617,8313,8304,13706,2003,46,62,0,675,125,3,122,12828,3789,0.4330,24604,25556,29125,12792,21852,20580,19081,-666666666,12758,32404,48,287
"Leon County, Texas",16784,8373,8411,14480,1331,76,21,0,714,162,19,143,14465,2319,0.4576,25946,27865,29994,11469,14015,11287,,-666666666,14485,10957,48,289
"Liberty County, Texas",76707,37773,38934,61492,8316,232,500,36,4746,1385,531,854,61840,14867,0.4330,20370,22249,24408,10986,12386,14532,20094,13869,13272,10451,48,291
"Limestone County, Texas",23531,12233,11298,18412,4172,71,131,13,439,293,26,267,18811,4720,0.4297,20550,22416,26330,8787,14218,17677,22160,,7856,11505,48,293
"Lipscomb County, Texas",3418,1825,1593,2980,17,58,22,4,216,121,36,85,2498,920,0.4586,29596,30497,34012,19117,15800,24814,44186,1650,21981,23523,48,295
"Live Oak County, Texas",11738,6429,5309,10349,467,69,133,0,549,171,19,152,7472,4266,0.4213,21357,22600,25175,16383,8171,34328,13059,-666666666,11459,15133,48,297
"Llano County, Texas",19272,9164,10108,18429,444,23,0,0,108,268,67,201,17544,1728,0.5348,34348,35058,36733,14727,12093,,-666666666,-666666666,4399,35060,48,299
"Loving County, Texas",89,61,28,41,0,16,0,0,21,11,0,11,59,30,0.4153,25629,31580,34995,23987,-666666666,,-666666666,-666666666,32710,24236,48,301
"Lubbock County, Texas",286747,141687,145060,226384,20994,1444,5886,158,23133,8748,3224,5524,192117,94630,0.4844,24454,26563,31247,15174,14647,23248,24963,17615,16958,13212,48,303
"Lynn County, Texas",5806,2930,2876,5082,68,174,5,2,397,78,54,24,3085,2721,0.4491,22767,23733,31698,13450,30509,10555,,,17409,8759,48,305
"McCulloch County, Texas",8245,4025,4220,7427,108,263,0,0,263,184,15,169,5718,2527,0.4291,21654,23071,26076,13023,14428,3697,-666666666,-666666666,8409,13277,48,307
"McLennan County, Texas",239717,116611,123106,185663,34733,1082,3420,35,9847,4937,950,3987,181167,58550,0.4700,21852,24001,27651,12939,15100,15909,15219,25591,12871,12289,48,309
"McMullen County, Texas",646,378,268,614,0,0,0,0,32,0,0,0,279,367,0.6047,36277,36118,57482,20156,-666666666,-666666666,-666666666,-666666666,39331,-666666666,48,311
"Madison County, Texas",13771,8731,5040,10286,2606,16,35,7,382,439,40,399,10882,2889,0.4322,15222,18480,22917,4039,5862,32944,11034,,5837,2539,48,313
"Marion County, Texas",10335,4971,5364,7706,2339,46,157,0,31,56,0,56,9957,378,0.4922,22610,25335,24844,32817,15265,34257,5902,-666666666,,4225,48,315
"Martin County, Texas",5096,2556,2540,4328,118,29,0,12,601,8,0,8,2756,2340,0.4822,26286,29268,35002,18022,3968,,-666666666,,10345,,48,317
"Mason County, Texas",4061,2122,1939,3799,0,10,128,0,89,35,0,35,3080,981,0.4513,27512,28170,30642,21316,-666666666,21270,3560,-666666666,22015,,48,319
"Matagorda County, Texas",36611,18078,18533,29681,3763,100,761,76,1002,1228,214,1014,22179,14432,0.4746,22072,23420,29884,14245,19034,10985,13893,,18253,8024,48,321
"Maverick County, Texas",55821,27402,28419,52090,68,723,82,0,2372,486,322,164,2624,53197,0.4737,14516,14310,26789,13850,17018,21286,89248,-666666666,11477,28428,48,323
"Medina County, Texas",46965,24197,22768,42258,1025,177,233,0,2108,1164,386,778,23291,23674,0.4208,22848,24104,31800,15611,7590,12263,7450,-666666666,11384,16146,48,325
"Menard County, Texas",2193,1120,1073,1986,23,29,0,0,11,144,35,109,1376,817,0.4948,20055,20637,24467,13801,8813,32772,-666666666,-666666666,,12791,48,327
"Midland County, Texas",146387,72629,73758,120937,9456,651,2191,112,10219,2821,743,2078,87682,58705,0.4849,34885,37706,48170,20364,19390,38478,39325,2787,20009,16777,48,329
"Milam County, Texas",24388,12114,12274,20437,2053,248,109,0,781,760,60,700,18428,5960,0.4733,21465,22912,26253,12122,14473,9323,35651,-666666666,17030,7907,48,331
"Mills County, Texas",4881,2278,2603,4790,15,0,2,0,62,12,2,10,4108,773,0.4702,22615,22881,24552,12941,2847,-666666666,,-666666666,9406,13225,48,333
"Mitchell County, Texas",9236,5668,3568,7446,940,63,38,0,507,242,88,154,5707,3529,0.4246,17330,19564,24393,11538,5587,12675,2316,-666666666,10098,12924,48,335
"Montague County, Texas",19568,9693,9875,18705,41,56,37,0,242,487,48,439,17587,1981,0.4538,26109,26808,27803,14979,3576,16693,31500,-666666666,9535,10078,48,337
"Montgomery County, Texas",487028,241062,245966,423152,21435,1925,11992,236,17270,11018,1569,9449,381402,105626,0.4646,33455,34930,39342,16825,21790,14399,42534,24903,15383,21473,48,339
"Moore County, Texas",22172,11497,10675,17771,593,166,1713,0,1231,698,129,569,10519,11653,0.3905,19434,20608,28150,14050,18152,17444,14215,-666666666,16372,9331,48,341
"Morris County, Texas",12805,6228,6577,8900,2956,57,4,0,581,307,16,291,11718,1087,0.4430,20124,22741,23435,8985,15956,19568,,-666666666,7626,8309,48,343
"Motley County, Texas",1172,655,517,1109,12,7,1,0,43,0,0,0,971,201,0.4339,20712,21311,23488,8311,2292,,,-666666666,8677,-666666666,48,345
"Nacogdoches County, Texas",65322,31158,34164,49815,11986,284,1013,0,1313,911,172,739,53455,11867,0.4833,20299,23015,26246,10103,11143,35815,16251,-666666666,9251,7829,48,347
"Navarro County, Texas",48073,23774,24299,37242,6851,977,318,79,1531,1075,180,895,36180,11893,0.4481,20491,22399,26305,10596,14623,11125,10816,7987,15791,10793,48,349
"Newton County, Texas",14323,7233,7090,10942,3068,24,109,0,129,51,0,51,13860,463,0.4640,20509,22620,23069,9884,14017,,12038,-666666666,14577,,48,351
"Nolan County, Texas",15082,7596,7486,13334,622,46,18,2,600,460,64,396,9828,5254,0.4562,20097,21146,25864,12079,8705,23643,,,15687,9726,48,353
"Nueces County, Texas",348130,171114,177016,299466,14370,1549,5936,261,19537,7011,2456,4555,133557,214573,0.4612,24875,25511,36211,19078,19732,22825,28726,30435,20201,18269,48,355
"Ochiltree County, Texas",10546,5423,5123,8639,84,228,40,0,1125,430,239,191,5250,5296,0.4406,23989,24866,32321,16292,18519,27314,56210,-666666666,19972,13203,48,357
"Oldham County, Texas",2068,1104,964,1750,147,26,29,9,21,86,3,83,1817,251,0.4875,23377,25538,27793,8711,8066,12635,26248,,3805,8829,48,359
"Orange County, Texas",82737,41009,41728,72307,6839,364,920,19,725,1563,176,1387,77401,5336,0.4535,24938,25775,26410,15171,20568,22210,23742,43211,14841,11138,48,361
"Palo Pinto County, Texas",28028,13838,14190,25263,666,256,114,0,1301,428,107,321,22730,5298,0.4821,23503,24193,25980,13290,14585,17743,32148,-666666666,13184,29158,48,363
"Panola County, Texas",23880,11531,12349,19033,4233,35,72,16,318,173,65,108,21805,2075,0.4161,25326,28075,29337,11994,14944,,7938,7038,12181,13628,48,365
"Parker County, Texas",119784,60052,59732,112295,2025,1017,794,28,1876,1749,281,1468,106612,13172,0.4377,30934,31723,33133,17488,16412,27725,36722,,14377,14246,48,367
"Parmer County, Texas",10124,5248,4876,9127,163,102,0,3,618,111,61,50,3947,6177,0.4158,20169,20962,31232,13560,16285,7714,-666666666,,14227,5607,48,369
"Pecos County, Texas",15677,8814,6863,13711,881,42,3,5,879,156,58,98,5085,10592,0.4224,19974,21190,29890,17269,5514,22360,,,16731,13399,48,371
"Polk County, Texas",45757,24511,21246,37948,5121,629,216,0,886,957,87,870,39393,6364,0.4416,20225,21717,23678,9946,12881,15137,10632,-666666666,10678,14717,48,373
"Potter County, Texas",122053,62558,59495,95810,11786,883,5404,315,3741,4114,1172,2942,77651,44402,0.4766,19967,21769,28122,12051,11017,16360,19060,17395,16486,8961,48,375
"Presidio County, Texas",7479,3688,3791,6858,19,176,175,0,212,39,39,0,1407,6072,0.4531,16176,15803,32001,13169,,30067,13874,-666666666,16546,,48,377
"Rains County, Texas",10988,5523,5465,9920,255,52,52,0,492,217,7,210,10103,885,0.4032,22933,23639,24191,11146,17420,21946,59177,-666666666,10380,17174,48,379
"Randall County, Texas",124862,61287,63575,112936,3202,737,1854,36,2915,3182,578,2604,102300,22562,0.4290,30376,31533,33770,18999,21810,31367,25379,18525,18179,11945,48,381
"Reagan County, Texas",3520,1873,1647,2443,116,0,0,0,944,17,5,12,1146,2374,0.4161,23814,26702,40650,16974,14196,-666666666,-666666666,-666666666,17372,32171,48,383
"Real County, Texas",3365,1666,1699,3314,4,0,0,0,14,33,0,33,2742,623,0.3870,19806,20034,21785,11296,1275,-666666666,-666666666,-666666666,6714,,48,385
"Red River County, Texas",12642,6072,6570,10029,2222,93,13,0,120,165,23,142,11763,879,0.4656,19128,21187,22200,8013,11296,12818,14346,-666666666,4423,14112,48,387
"Reeves County, Texas",13978,8421,5557,11899,750,188,72,0,789,280,197,83,3576,10402,0.4734,18099,18749,34118,14074,9343,23351,60467,-666666666,15728,6209,48,389
"Refugio County, Texas",7295,3597,3698,6275,428,7,25,0,233,327,6,321,3748,3547,0.4548,24090,25809,31869,18473,16066,15357,12596,-666666666,15668,8654,48,391
"Roberts County, Texas",924,465,459,915,0,1,3,0,1,4,0,4,914,10,0.4332,35797,35860,36143,8890,-666666666,,44233,-666666666,,,48,393
"Robertson County, Texas",16546,8262,8284,12394,3504,59,40,34,351,164,32,132,13411,3135,0.4558,21216,24341,27935,12698,11184,10888,20098,7450,21107,6441,48,395
"Rockwall County, Texas",83239,40836,42403,72062,4387,212,1902,272,1781,2623,511,2112,69525,13714,0.3919,34850,36233,39212,19148,26765,37394,45981,22258,17600,15130,48,397
"Runnels County, Texas",10441,5222,5219,9780,58,35,47,0,337,184,75,109,6979,3462,0.4534,20081,20298,22936,14554,10662,13886,33579,-666666666,18310,12471,48,399
"Rusk County, Texas",54159,28785,25374,42962,9646,234,304,0,378,635,97,538,45860,8299,0.4493,22084,23925,26751,11107,14512,27409,20960,-666666666,15559,14991,48,401
"Sabine County, Texas",10551,5139,5412,9529,947,9,18,0,19,29,0,29,10164,387,0.4757,18626,19999,20672,3595,4800,,,-666666666,5621,11928,48,403
"San Augustine County, Texas",8777,4254,4523,6513,1994,71,2,0,81,116,0,116,8198,579,0.4842,18177,20868,21939,7977,10065,28983,,-666666666,12052,4215,48,405
"San Jacinto County, Texas",26831,13374,13457,23031,3132,48,175,0,267,178,133,45,23708,3123,0.4796,24037,25316,26981,12541,17088,,4822,-666666666,14882,8679,48,407
"San Patricio County, Texas",65509,32776,32733,60148,1278,262,635,3,1940,1243,255,988,29318,36191,0.4341,23741,24255,32763,17149,14223,22125,30310,,18264,14208,48,409
"San Saba County, Texas",5901,3222,2679,5448,155,0,14,0,202,82,10,72,4212,1689,0.4149,19595,20598,23195,13120,3394,-666666666,,-666666666,10813,8493,48,411
"Schleicher County, Texas",3281,1640,1641,2714,4,4,14,0,521,24,16,8,1685,1596,0.5021,23074,23492,29059,16530,,,,-666666666,20393,11813,48,413
"Scurry County, Texas",17108,9163,7945,14641,700,168,35,0,1221,343,92,251,10613,6495,0.4459,23967,24985,29482,17452,17236,12971,94,-666666666,23686,3074,48,415
"Shackelford County, Texas",3359,1627,1732,3116,46,1,0,0,152,44,0,44,3005,354,0.4697,25602,26535,27891,11551,5261,,-666666666,-666666666,17986,,48,417
"Shelby County, Texas",25698,12555,13143,20425,4476,21,210,28,365,173,19,154,21274,4424,0.4854,21084,23709,27371,8543,11720,21067,3177,,8776,4453,48,419
"Sherman County, Texas",3060,1570,1490,2790,4,17,5,0,123,121,42,79,1769,1291,0.4414,23728,24628,33786,11680,-666666666,17288,,-666666666,21224,7633,48,421
"Smith County, Texas",214735,103784,110951,164419,38497,734,2913,466,4549,3157,701,2456,176034,38701,0.4676,24924,27741,31454,12887,15208,24217,21247,17698,14211,16754,48,423
"Somervell County, Texas",8575,4207,4368,7824,144,40,0,33,420,114,13,101,6932,1643,0.4398,26708,27882,30075,15594,9241,,-666666666,,15775,17911,48,425
"Starr County, Texas",62040,30182,31858,58732,26,71,270,0,2242,699,297,402,2678,59362,0.4887,11935,11839,21027,11619,6808,7528,8105,-666666666,14896,12546,48,427
"Stephens County, Texas",9485,5064,4421,8308,238,50,32,0,801,56,10,46,7401,2084,0.4395,21145,22983,25453,8119,10061,7154,34956,-666666666,6613,8020,48,429
"Sterling County, Texas",1360,713,647,1313,3,0,0,0,44,0,0,0,869,491,0.4192,19762,19955,23980,12415,,-666666666,-666666666,-666666666,15041,-666666666,48,431
"Stonewall County, Texas",1409,701,708,1239,66,0,0,0,52,52,42,10,1137,272,0.4647,23895,26432,29371,6820,6839,-666666666,-666666666,-666666666,5267,3702,48,433
"Sutton County, Texas",3995,2024,1971,3471,33,13,0,9,455,14,7,7,1680,2315,0.4252,24723,25589,32612,19218,3915,5692,-666666666,,20600,,48,435
"Swisher County, Texas",7789,4058,3731,6643,480,62,35,0,208,361,56,305,4567,3222,0.4275,18046,19095,25683,10450,12118,13160,15709,-666666666,16244,8733,48,437
"Tarrant County, Texas",1881469,921618,959851,1326481,286222,9030,90885,3116,113112,52623,10883,41740,1367729,513740,0.4603,28541,32010,38435,15433,20763,24478,27786,19186,14587,15952,48,439
"Taylor County, Texas",133560,65239,68321,109677,10165,696,2261,66,7034,3661,1069,2592,103010,30550,0.4607,23472,25246,28002,14569,14277,16408,20141,17014,17939,10018,48,441
"Terrell County, Texas",809,405,404,772,13,0,12,0,12,0,0,0,319,490,0.4769,31894,32819,48390,22891,,-666666666,,-666666666,,-666666666,48,443
"Terry County, Texas",12681,6747,5934,10582,661,36,4,0,1098,300,188,112,6160,6521,0.5014,22211,23981,34595,13493,5328,13419,,-666666666,17098,17053,48,445
"Throckmorton County, Texas",1584,773,811,1544,4,0,7,0,0,29,0,29,1424,160,0.4402,24926,25309,26289,16833,5350,-666666666,,-666666666,-666666666,12021,48,447
"Titus County, Texas",32540,16014,16526,25598,3252,100,225,0,2775,590,227,363,19330,13210,0.4380,19178,20915,28076,9911,12853,27298,25058,-666666666,11317,12031,48,449
"Tom Green County, Texas",113516,55965,57551,97822,4784,482,1376,43,6370,2639,860,1779,71705,41811,0.4649,24443,25660,30100,16888,15731,20708,25625,,16285,15068,48,451
"Travis County, Texas",1092810,550502,542308,825198,90729,5760,65465,653,72918,32087,6844,25243,724800,368010,0.4915,33943,37237,46943,17632,22163,24442,35478,25933,16367,21217,48,453
"Trinity County, Texas",14452,6986,7466,12668,1461,73,60,0,73,117,36,81,13202,1250,0.4551,19874,20946,21723,12248,12946,10764,6235,-666666666,4585,12469,48,455
"Tyler County, Texas",21552,11759,9793,18446,2358,115,51,0,320,262,13,249,19976,1576,0.4179,20675,22719,22471,22472,7408,24248,,-666666666,6972,14592,48,457
"Upshur County, Texas",39851,19782,20069,33599,3425,219,196,20,1264,1128,178,950,36987,2864,0.4324,22917,24256,24648,11386,19989,19263,11437,,11992,7002,48,459
"Upton County, Texas",3339,1610,1729,2192,95,0,0,0,976,76,0,76,1768,1571,0.4501,23383,26978,29241,16818,15338,-666666666,-666666666,-666666666,17435,6117,48,461
"Uvalde County, Texas",26763,13052,13711,24592,103,280,282,19,998,489,441,48,8064,18699,0.4482,17654,17605,28114,12975,7736,28943,42120,,13502,9748,48,463
"Val Verde County, Texas",48999,24779,24220,45322,595,196,260,54,1874,698,167,531,9689,39310,0.4485,19024,19105,31757,16097,29282,22015,23293,,14289,14868,48,465
"Van Zandt County, Texas",52605,25904,26701,49142,1363,363,235,163,463,876,100,776,47490,5115,0.4538,22707,23351,24214,14345,13006,27041,12563,15177,10757,10285,48,467
"Victoria County, Texas",88955,43546,45409,75179,5641,339,1084,19,3580,3113,654,2459,49270,39685,0.4514,25216,26386,34330,16009,21422,16050,39290,,18108,8209,48,469
"Walker County, Texas",68882,40620,28262,50494,15578,209,703,0,1060,838,90,748,56914,11968,0.4869,16571,19541,23421,5488,7957,16567,16721,-666666666,7562,8966,48,471
"Waller County, Texas",44825,22556,22269,31230,10705,160,306,0,850,1574,157,1417,31662,13163,0.4556,22645,26624,34652,12973,13376,25123,30616,-666666666,17318,7804,48,473
"Ward County, Texas",11011,5440,5571,9480,695,91,18,0,616,111,34,77,5537,5474,0.4753,23887,25014,30114,18353,20131,29941,,-666666666,12725,9555,48,475
"Washington County, Texas",34039,17016,17023,26600,5969,258,566,0,456,190,34,156,29130,4909,0.4275,23727,26417,29734,10214,13625,15736,15683,-666666666,18829,11003,48,477
"Webb County, Texas",259471,126201,133270,243573,1003,953,1519,13,10847,1563,906,657,11875,247596,0.4782,14852,14798,28881,14162,27415,10490,31136,,12841,15937,48,479
"Wharton County, Texas",41219,20218,21001,34131,5938,58,45,0,760,287,22,265,25319,15900,0.4492,20782,22005,28026,14146,15444,4616,20184,-666666666,13413,8680,48,481
"Wheeler County, Texas",5587,2810,2777,4932,98,44,53,11,322,127,21,106,4127,1460,0.4151,27816,28837,33052,12097,24741,4109,54981,,9474,36321,48,483
"Wichita County, Texas",131802,67995,63807,106782,13843,1124,2728,21,3072,4232,609,3623,108718,23084,0.4546,23006,24841,27285,12675,14767,27463,22184,9986,11492,11425,48,485
"Wilbarger County, Texas",13265,6548,6717,11225,1096,132,108,0,368,336,62,274,9630,3635,0.4133,20370,21779,24996,13315,11604,14954,31475,-666666666,14097,7325,48,487
"Willacy County, Texas",22056,11936,10120,20837,376,39,16,3,681,104,68,36,2777,19279,0.5001,11693,11639,22163,10415,13552,39795,-666666666,,11723,6501,48,489
"Williamson County, Texas",457218,224717,232501,377874,28689,1363,23988,335,10976,13993,2662,11331,349136,108082,0.3953,31709,32754,36558,20636,24566,23050,36998,9507,22404,17728,48,491
"Wilson County, Texas",44609,22218,22391,40694,701,148,130,0,1803,1133,241,892,27399,17210,0.4133,28411,29275,33288,21304,27917,30936,29568,-666666666,16114,16775,48,493
"Winkler County, Texas",7404,3654,3750,6525,196,39,37,0,357,250,37,213,3256,4148,0.3928,22885,23765,28504,18857,17091,29113,44405,-666666666,13717,13384,48,495
"Wise County, Texas",60413,30464,29949,57106,656,499,247,13,1024,868,199,669,49624,10789,0.4296,27087,27567,29252,19158,15256,27867,23145,,21405,11425,48,497
"Wood County, Texas",42431,20992,21439,38654,2066,240,232,0,782,457,77,380,38556,3875,0.4406,23658,24676,25919,10085,12037,36967,9497,-666666666,11291,11467,48,499
"Yoakum County, Texas",8054,3998,4056,7112,110,20,70,0,573,169,94,75,3156,4898,0.4273,23103,23176,33683,16875,14785,,15254,-666666666,26613,17807,48,501
"Young County, Texas",18374,9132,9242,17345,195,98,53,0,345,338,97,241,15226,3148,0.4825,25859,26736,29525,11650,8938,7140,26106,-666666666,13396,8744,48,503
"Zapata County, Texas",14231,7183,7048,13983,162,0,0,0,86,0,0,0,926,13305,0.4858,16026,16174,28437,15164,7804,-666666666,-666666666,-666666666,7465,-666666666,48,505
"Zavala County, Texas",12013,6168,5845,11076,37,7,0,0,859,34,4,30,821,11192,0.4972,13595,13114,28153,12605,7276,,-666666666,-666666666,20394,,48,507
"Beaver County, Utah",6514,3410,3104,6067,15,43,0,106,164,119,11,108,5814,700,0.4033,20405,21369,21823,12294,-666666666,6033,-666666666,19897,5080,,49,001
"Box Elder County, Utah",50613,25557,25056,47157,149,460,430,68,1443,906,140,766,46202,4411,0.3833,22150,22631,23028,15125,9116,18768,24080,12684,15156,11910,49,003
"Cache County, Utah",115954,57725,58229,105162,771,697,2603,359,4007,2355,613,1742,104125,11829,0.4272,20195,20942,21777,10585,19824,11979,13089,13011,13758,9274,49,005
"Carbon County, Utah",21118,10444,10674,19419,123,167,154,35,682,538,161,377,18420,2698,0.4043,20691,21147,21746,15605,21874,25071,14917,18406,17280,8730,49,007
"Daggett County, Utah",714,405,309,671,0,5,0,30,2,6,0,6,694,20,0.4290,24369,24512,24848,9085,-666666666,,-666666666,,,,49,009
"Davis County, Utah",317646,159678,157968,285897,4039,1471,5852,1953,8990,9444,2307,7137,289775,27871,0.3888,26309,27339,27827,16746,18212,22194,26800,16073,16506,10393,49,011
"Duchesne County, Utah",19378,9813,9565,17617,36,948,80,70,365,262,23,239,17987,1391,0.3940,24162,24815,25237,16298,1531,16666,28018,12177,17302,22017,49,013
"Emery County, Utah",10834,5474,5360,10534,76,101,18,0,48,57,3,54,10176,658,0.3464,20274,20581,21128,11424,,13491,2006,-666666666,10544,16265,49,015
"Garfield County, Utah",5105,2665,2440,4875,33,30,51,34,6,76,7,69,4835,270,0.4249,20975,21453,21991,10700,18367,7777,11463,22715,,3900,49,017
"Grand County, Utah",9348,4838,4510,8689,18,469,61,21,36,54,8,46,8419,929,0.4106,23894,25145,26710,11025,12178,7225,8489,,4525,2635,49,019
"Iron County, Utah",46725,23484,23241,42722,308,1286,316,281,786,1026,153,873,43006,3719,0.4304,17946,18493,18933,9720,10727,7684,36891,9485,8480,13934,49,021
"Juab County, Utah",10349,5348,5001,9816,20,78,27,26,260,122,6,116,9905,444,0.3608,18503,18893,19058,8278,,15813,9463,17981,7475,11931,49,023
"Kane County, Utah",7221,3543,3678,6785,43,47,23,0,41,282,81,201,6922,299,0.3779,24152,24716,24729,24280,,30936,3035,-666666666,33349,13511,49,025
"Millard County, Utah",12582,6437,6145,11167,47,100,59,13,1040,156,22,134,10972,1610,0.3765,20310,21717,22198,10363,,12131,7925,,9746,6664,49,027
"Morgan County, Utah",9955,5049,4906,9662,0,0,130,0,111,52,4,48,9693,262,0.3763,28193,28752,29143,6500,-666666666,-666666666,13855,-666666666,4444,,49,029
"Piute County, Utah",1921,974,947,1870,4,0,0,2,16,29,10,19,1758,163,0.4224,16780,16831,17886,4239,,-666666666,-666666666,,5794,21748,49,031
"Rich County, Utah",2285,1153,1132,2210,2,1,0,2,66,4,1,3,2210,75,0.4975,23018,23630,24090,6761,,,-666666666,,3998,18500,49,033
"Salt Lake County, Utah",1063670,534396,529274,887112,17484,8549,37588,16653,67475,28809,5811,22998,877892,185778,0.4352,26747,28814,30738,13960,16911,16299,26693,15015,12799,11692,49,035
"San Juan County, Utah",14944,7485,7459,7364,26,7106,93,31,89,235,22,213,14223,721,0.4616,15531,21174,21900,10826,15635,9764,4551,42455,9240,16258,49,037
"Sanpete County, Utah",28129,14790,13339,25355,278,338,109,179,1515,355,47,308,25452,2677,0.4110,17519,18602,19069,6035,3032,11180,13577,6074,5197,17109,49,039
"Sevier County, Utah",20812,10545,10267,19774,112,202,49,52,313,310,129,181,19828,984,0.4007,19121,19629,19888,10946,3830,7000,34078,14029,10224,7637,49,041
"Summit County, Utah",37877,19595,18282,35868,181,117,755,18,599,339,54,285,33508,4369,0.4705,45461,46466,50262,12666,34719,19803,38144,6378,12380,30499,49,043
"Tooele County, Utah",59973,30220,29753,55483,499,677,522,217,1624,951,143,808,52921,7052,0.3605,22423,22934,23698,15566,22462,17696,21131,11418,16250,9700,49,045
"Uintah County, Utah",34576,17696,16880,30191,125,2659,166,110,457,868,273,595,31917,2659,0.4232,24572,25582,26321,12694,22550,21023,16919,12655,14208,9067,49,047
"Utah County, Utah",540425,271483,268942,495181,3298,2860,7522,4370,13518,13676,1778,11898,481049,59376,0.4164,20973,21651,22516,12701,10814,12782,18388,15170,14554,10198,49,049
"Wasatch County, Utah",25550,12878,12672,24688,45,61,241,15,153,347,84,263,22195,3355,0.4057,26145,26594,28867,11053,2907,16431,16541,,13862,10658,49,051
"Washington County, Utah",144844,71546,73298,134475,681,1612,1004,1310,2986,2776,312,2464,130572,14272,0.4278,21771,22470,23387,11779,7486,11540,36913,10822,10523,9152,49,053
"Wayne County, Utah",2742,1429,1313,2655,22,28,18,0,16,3,0,3,2611,131,0.4258,19950,20424,20308,20179,,2932,19567,-666666666,,,49,055
"Weber County, Utah",236307,118588,117719,206886,2728,1887,2760,536,15204,6306,995,5311,195576,40731,0.4033,23430,24727,26137,12985,18392,20601,23675,15045,11827,12481,49,057
"Addison County, Vermont",36883,18395,18488,35138,322,107,688,55,68,505,49,456,36154,729,0.4229,29295,29787,30018,15254,14496,22114,22899,33964,5919,17313,50,001
"Bennington County, Vermont",36739,17893,18846,35396,209,29,202,0,133,770,76,694,36150,589,0.4657,29647,30298,30085,38154,19891,8790,18794,-666666666,14623,8615,50,003
"Caledonia County, Vermont",31109,15389,15720,30045,161,114,266,17,42,464,29,435,30711,398,0.4292,23568,23860,23982,13114,4869,18788,20118,,27540,13658,50,005
"Chittenden County, Vermont",158686,77419,81267,145904,3375,425,4705,25,639,3613,116,3497,155478,3208,0.4471,33881,35272,35445,21957,14494,25064,22497,6024,16202,15024,50,007
"Essex County, Vermont",6231,3134,3097,6023,46,27,18,0,15,102,25,77,6159,72,0.4210,20904,21204,21282,6967,16172,,10294,-666666666,12327,13505,50,009
"Franklin County, Vermont",48226,23940,24286,46015,207,258,157,40,214,1335,53,1282,47595,631,0.4164,27879,28364,28471,15278,28306,25185,20745,,20163,14521,50,011
"Grand Isle County, Vermont",6979,3456,3523,6641,7,66,23,0,7,235,12,223,6876,103,0.4410,34925,35887,36129,15301,,6129,17748,-666666666,11443,19223,50,013
"Lamoille County, Vermont",24843,12335,12508,23896,126,111,104,0,134,472,13,459,24475,368,0.4322,26508,27077,27121,25228,20309,12061,10874,-666666666,16536,8990,50,015
"Orange County, Vermont",28927,14348,14579,27994,121,153,138,0,90,431,14,417,28594,333,0.4058,27623,27967,28049,16220,13246,8600,23212,-666666666,9162,21327,50,017
"Orleans County, Vermont",27160,13603,13557,26254,174,151,116,0,24,441,16,425,26823,337,0.4356,23164,23569,23662,12142,6181,11426,11933,-666666666,17313,13046,50,019
"Rutland County, Vermont",60864,30042,30822,59066,360,169,416,0,146,707,37,670,60114,750,0.4296,26384,26658,26758,14188,20641,13849,23853,-666666666,13025,13709,50,021
"Washington County, Vermont",59333,29318,30015,57057,515,191,471,0,55,1044,34,1010,58269,1064,0.4179,30210,30577,30746,20120,20942,23819,30858,-666666666,16078,16347,50,023
"Windham County, Vermont",44050,21672,22378,41817,472,47,440,61,132,1081,31,1050,43158,892,0.4215,27895,28503,28577,16228,27495,24447,16439,7223,21235,11357,50,025
"Windsor County, Vermont",56328,27562,28766,54139,340,160,456,16,225,992,64,928,55576,752,0.4596,31740,32238,32314,22825,21592,17314,31500,,22128,13117,50,027
"Accomack County, Virginia",33165,16122,17043,22736,9495,105,36,0,308,485,9,476,30256,2909,0.4721,23206,26581,28376,11692,15989,24094,65333,-666666666,9316,11758,51,001
"Albemarle County, Virginia",101883,48767,53116,83125,9616,279,4415,20,1283,3145,265,2880,96185,5698,0.4861,37510,40889,41584,24823,21901,7068,32925,,16491,12377,51,003
"Alleghany County, Virginia",16133,7911,8222,15053,813,2,55,5,19,186,25,161,15918,215,0.4226,24399,25260,25336,18533,13238,,11693,,16337,7618,51,005
"Amelia County, Virginia",12764,6344,6420,9258,3184,61,14,12,62,173,80,93,12649,115,0.4083,25545,28372,28495,9210,18174,25775,,,30987,8001,51,007
"Amherst County, Virginia",32237,15415,16822,24770,6001,256,236,16,260,698,18,680,31572,665,0.4110,22938,24204,24304,12644,18543,24485,13304,,5480,24996,51,009
"Appomattox County, Virginia",15137,7317,7820,11673,3023,44,24,0,76,297,17,280,14960,177,0.4129,23098,25187,25227,7172,17601,5314,43150,-666666666,,3830,51,011
"Arlington County, Virginia",220173,110103,110070,158046,18354,1190,21399,213,13711,7260,1470,5790,186159,34014,0.4368,62854,72753,77484,29592,36334,27386,50194,57287,18752,40990,51,013
"Augusta County, Virginia",73707,37288,36419,68577,3029,187,421,35,757,701,64,637,72040,1667,0.4232,26398,27526,27650,13494,10935,19856,14278,8520,10280,10176,51,015
"Bath County, Virginia",4644,2274,2370,4260,275,0,0,0,1,108,0,108,4561,83,0.5055,32259,29309,29702,9233,90151,-666666666,-666666666,-666666666,,,51,017
"Bedford County, Virginia",75607,37188,38419,68143,5257,125,887,23,144,1028,66,962,74220,1387,0.4223,28548,29503,29705,20041,19051,35436,23251,72774,5706,19786,51,019
"Bland County, Virginia",6727,3828,2899,6402,302,0,0,2,0,21,0,21,6700,27,0.3824,19042,19807,19852,4722,3372,-666666666,-666666666,,-666666666,2643,51,021
"Botetourt County, Virginia",33105,16324,16781,31172,1242,90,42,0,149,410,35,375,32676,429,0.4315,32266,32851,32981,15668,28077,18387,38869,-666666666,8151,11594,51,023
"Brunswick County, Virginia",16961,8808,8153,7072,9564,53,7,0,81,184,32,152,16645,316,0.4536,17920,24361,24907,5818,13250,,,-666666666,6390,13947,51,025
"Buchanan County, Virginia",23683,11982,11701,22760,549,4,215,0,62,93,0,93,23577,106,0.4555,18357,18644,18671,8266,5177,,19237,-666666666,4624,33680,51,027
"Buckingham County, Virginia",17072,9427,7645,10627,5917,7,40,4,124,353,13,340,16738,334,0.4211,17345,20276,20645,7641,12595,171,20488,,16374,9238,51,029
"Campbell County, Virginia",54833,26535,28298,45000,7542,113,444,26,389,1319,90,1229,53794,1039,0.4216,23801,25534,25623,18268,17829,16905,11317,,15280,5530,51,031
"Caroline County, Virginia",29057,14344,14713,19323,8463,165,201,0,232,673,30,643,27961,1096,0.4029,26403,28201,28620,21672,22596,52305,17489,-666666666,19679,21300,51,033
"Carroll County, Virginia",29881,14916,14965,29203,247,27,34,0,31,339,110,229,29030,851,0.4216,19761,19984,20190,11091,9938,,,-666666666,46865,3133,51,035
"Charles City County, Virginia",7154,3552,3602,3001,3471,475,18,6,10,173,2,171,7042,112,0.4407,26053,32557,32761,20728,20801,23494,32806,,17050,26171,51,036
"Charlotte County, Virginia",12399,6164,6235,8333,3768,12,14,0,157,115,0,115,12102,297,0.4426,18767,21744,21622,15595,12632,11467,11921,-666666666,13392,12985,51,037
"Chesterfield County, Virginia",324337,156136,168201,224705,73489,840,11224,120,5870,8089,913,7176,299708,24629,0.4075,32942,36216,37698,17542,25845,27996,31098,18402,17651,20867,51,041
"Clarke County, Virginia",14273,6898,7375,12887,734,62,163,0,135,292,29,263,13728,545,0.4379,38590,40935,41461,20208,15210,22166,32878,-666666666,16971,10540,51,043
"Craig County, Virginia",5206,2605,2601,5037,10,0,21,0,0,138,0,138,5206,0,0.3937,22435,22841,22841,-666666666,-666666666,-666666666,,-666666666,-666666666,12667,51,045
"Culpeper County, Virginia",47910,24155,23755,36998,6821,188,663,73,905,2262,292,1970,43655,4255,0.3974,28076,31007,31924,18353,20627,21727,15331,,19172,11098,51,047
"Cumberland County, Virginia",9916,4938,4978,6255,3415,72,0,0,0,174,0,174,9906,10,0.4399,22922,26561,26561,,17659,3222,-666666666,-666666666,-666666666,3546,51,049
"Dickenson County, Virginia",15612,7930,7682,15376,118,0,13,0,8,97,48,49,15498,114,0.4306,17954,18088,18092,11173,7969,-666666666,7246,-666666666,,7910,51,051
"Dinwiddie County, Virginia",27993,13803,14190,18137,9166,30,90,0,110,460,112,348,27239,754,0.4011,23766,26363,26795,14370,19340,6293,20144,-666666666,22608,11656,51,053
"Essex County, Virginia",11166,5299,5867,6566,4170,81,0,0,17,332,7,325,10787,379,0.4135,21595,24515,24884,18168,18055,13400,-666666666,-666666666,,10475,51,057
"Fairfax County, Virginia",1117072,552607,564465,705991,104083,3630,202094,814,51513,48947,7874,41073,938150,178922,0.4202,51137,60339,66421,25311,37124,31222,40903,59233,20172,24379,51,059
"Fauquier County, Virginia",66726,32883,33843,58451,5030,111,767,39,307,2021,62,1959,62224,4502,0.4274,41394,43695,45452,20537,27216,15397,29042,,28291,17939,51,061
"Floyd County, Virginia",15452,7783,7669,14809,323,22,170,0,10,118,37,81,15039,413,0.3866,22805,23064,23201,17313,11416,,33891,-666666666,,11543,51,063
"Fluvanna County, Virginia",25945,11863,14082,20917,3637,24,166,0,358,843,36,807,25132,813,0.4127,30300,32846,32788,23596,20771,23079,46099,-666666666,8851,14458,51,065
"Franklin County, Virginia",56360,27758,28602,50315,4724,57,152,0,381,731,44,687,54878,1482,0.4378,24789,25715,26115,13410,17226,10544,23553,-666666666,19190,14250,51,067
"Frederick County, Virginia",80377,39943,40434,73235,3615,100,1152,13,875,1387,142,1245,74783,5594,0.3980,30764,31569,32533,17137,24588,21461,28760,,18636,14299,51,069
"Giles County, Virginia",17025,8307,8718,16438,211,75,95,15,61,130,11,119,16788,237,0.4293,24485,24966,25168,7262,17113,10016,9688,,9328,3646,51,071
"Gloucester County, Virginia",36938,18183,18755,32333,3253,96,176,0,83,997,71,926,35889,1049,0.3925,29396,30224,30230,26992,26025,23069,16471,-666666666,57019,14151,51,073
"Goochland County, Virginia",21627,10770,10857,16950,4256,42,127,0,67,185,28,157,21150,477,0.5030,46306,53701,53988,28108,18884,37200,56898,-666666666,9784,7678,51,075
"Grayson County, Virginia",15255,7364,7891,14682,293,0,0,84,39,157,27,130,14821,434,0.4477,18760,18863,19039,11878,15989,-666666666,-666666666,,14608,25078,51,077
"Greene County, Virginia",18766,9243,9523,16783,1265,0,236,28,43,411,1,410,17903,863,0.3794,28727,29925,30449,19197,19395,-666666666,36875,,,8665,51,079
"Greensville County, Virginia",11911,7420,4491,4549,7110,42,47,0,49,114,57,57,11669,242,0.4734,14992,17083,17273,1760,14007,5090,13209,-666666666,522,3676,51,081
"Halifax County, Virginia",35704,16951,18753,21649,13216,44,201,9,343,242,25,217,35067,637,0.4504,19777,22553,22340,21118,15515,29791,19773,,9147,13373,51,083
"Hanover County, Virginia",100689,49343,51346,87003,9327,250,1423,30,808,1848,111,1737,98291,2398,0.3914,34241,35772,35888,25854,27295,14310,27776,,11883,15205,51,085
"Henrico County, Virginia",314878,148417,166461,186687,93134,891,22163,135,3942,7926,564,7362,298575,16303,0.4461,33576,39459,40648,17807,23367,16785,35151,67903,16852,20189,51,087
"Henry County, Virginia",52960,25441,27519,39126,11584,22,287,0,1095,846,49,797,50298,2662,0.4250,19538,21157,21755,7891,15672,6068,18539,-666666666,9252,11624,51,089
"Highland County, Virginia",2258,1045,1213,2254,0,0,0,0,0,4,0,4,2258,0,0.4246,26949,26901,26901,-666666666,-666666666,-666666666,-666666666,-666666666,-666666666,,51,091
"Isle of Wight County, Virginia",35518,17390,18128,25377,8304,32,380,0,369,1056,105,951,34706,812,0.4166,31247,34764,35019,16320,23133,40378,30616,-666666666,18473,14943,51,093
"James City County, Virginia",69832,33720,36112,56253,9581,258,2047,45,452,1196,176,1020,66270,3562,0.4330,39960,43400,44612,20264,23218,26542,40462,27133,28396,19201,51,095
"King and Queen County, Virginia",7073,3645,3428,4860,1987,75,13,0,8,130,10,120,6849,224,0.3835,25406,28710,29381,18432,18063,28340,,-666666666,,5727,51,097
"King George County, Virginia",24577,12440,12137,18809,4518,79,280,21,174,696,3,693,23606,971,0.3727,34995,36307,36581,45114,30045,40306,28482,,17079,38295,51,099
"King William County, Virginia",16045,7828,8217,12326,3056,189,170,0,17,287,4,283,15916,129,0.3653,28981,30563,30675,21273,25710,23727,6514,-666666666,30794,12491,51,101
"Lancaster County, Virginia",11224,5263,5961,7826,3164,0,123,0,14,97,0,97,11067,157,0.4421,30836,36586,36605,26296,17597,-666666666,21692,-666666666,,12333,51,103
"Lee County, Virginia",25380,13361,12019,23875,882,186,61,0,130,246,15,231,24947,433,0.4315,16769,16917,17005,8346,18158,4935,41985,-666666666,1884,8056,51,105
"Loudoun County, Virginia",338916,167766,171150,232135,24880,847,52794,222,13422,14616,2092,12524,294888,44028,0.3600,46962,51236,54909,22880,40186,38413,44494,50768,20007,24719,51,107
"Louisa County, Virginia",33743,16698,17045,26507,5639,90,169,0,550,788,51,737,32919,824,0.4034,27481,29665,30049,15449,21116,14644,27912,-666666666,14304,10128,51,109
"Lunenburg County, Virginia",12667,6732,5935,7845,4366,13,34,13,200,196,44,152,12173,494,0.4277,18595,22600,22928,10521,12347,-666666666,10353,,6896,13306,51,111
"Madison County, Virginia",13208,6552,6656,11358,1265,0,81,0,10,494,59,435,13067,141,0.4387,26096,28019,28082,10997,14604,-666666666,12015,-666666666,,14015,51,113
"Mathews County, Virginia",8923,4203,4720,7842,888,16,27,0,18,132,14,118,8768,155,0.4063,33487,35377,35821,4972,21629,,,-666666666,5067,12372,51,115
"Mecklenburg County, Virginia",31913,15508,16405,19229,11340,34,180,8,529,593,18,575,31105,808,0.4449,20798,24943,25021,14316,15109,,18086,,13008,2847,51,117
"Middlesex County, Virginia",10817,5360,5457,8597,2096,45,0,0,43,36,2,34,10615,202,0.4442,30489,34502,34700,23108,14753,34024,-666666666,-666666666,11179,6889,51,119
"Montgomery County, Virginia",95808,49739,46069,83583,4041,236,5775,23,643,1507,8,1499,93046,2762,0.4891,23727,24672,24973,11681,14143,16782,19990,,6544,17884,51,121
"Nelson County, Virginia",14892,7168,7724,12450,2032,28,65,0,239,78,0,78,14397,495,0.4677,27958,29168,29507,14064,14118,33768,278354,-666666666,14489,25924,51,125
"New Kent County, Virginia",19187,9780,9407,15688,2493,118,206,0,74,608,0,608,18737,450,0.3741,33839,34845,35218,16803,34256,46887,15564,-666666666,12227,12476,51,127
"Northampton County, Virginia",12254,5914,6340,7535,4519,12,86,13,36,53,10,43,11298,956,0.5260,23412,29598,30764,20334,12954,,14651,,13222,25270,51,131
"Northumberland County, Virginia",12320,6035,6285,8681,3631,0,8,0,0,0,0,0,12267,53,0.4325,29602,36047,36181,6432,14063,-666666666,,-666666666,-666666666,-666666666,51,133
"Nottoway County, Virginia",15756,8260,7496,8880,6201,51,44,0,331,249,0,249,15138,618,0.4476,19208,22984,23330,10489,14540,10714,2289,-666666666,16490,9163,51,135
"Orange County, Virginia",34239,16689,17550,28257,4372,65,393,0,388,764,19,745,32921,1318,0.4111,28856,30423,31013,15585,24177,24500,18047,-666666666,20974,7577,51,137
"Page County, Virginia",23905,11793,12112,22916,389,36,121,0,40,403,62,341,23492,413,0.4239,22083,22362,22486,11941,24986,23603,10274,-666666666,11863,7862,51,139
"Patrick County, Virginia",18365,8961,9404,16981,1209,17,2,0,20,136,0,136,17892,473,0.4136,18916,19414,19757,6859,13699,,,-666666666,,8538,51,141
"Pittsylvania County, Virginia",62955,30911,32044,47318,13472,19,226,11,787,1122,50,1072,61498,1457,0.4083,21615,23526,23666,9827,16569,,36572,,7836,8466,51,143
"Powhatan County, Virginia",28193,15200,12993,23853,3584,64,175,0,74,443,30,413,27653,540,0.3954,31918,35666,36008,16480,10759,14598,26959,-666666666,18,11082,51,145
"Prince Edward County, Virginia",23140,11337,11803,14739,7768,19,270,0,111,233,51,182,22596,544,0.4644,17779,20203,20346,11024,13248,,33029,-666666666,2011,6758,51,147
"Prince George County, Virginia",36792,20131,16661,21952,11870,384,734,96,730,1026,229,797,34302,2490,0.3652,24521,28058,28225,16519,19313,22458,23281,55409,11885,16873,51,149
"Prince William County, Virginia",428772,213427,215345,266081,86197,1348,32799,469,19209,22669,2351,20318,338026,90746,0.3717,37440,41378,47630,21778,35070,28583,32018,32762,22746,21150,51,153
"Pulaski County, Virginia",34630,17277,17353,31909,2081,11,52,0,84,493,73,420,34158,472,0.4217,24722,25307,25381,19545,18777,,9650,-666666666,8249,16713,51,155
"Rappahannock County, Virginia",7446,3633,3813,6857,284,2,53,0,19,231,49,182,7203,243,0.4754,37211,37696,37988,25598,51092,,13911,-666666666,,13891,51,157
"Richmond County, Virginia",9072,5208,3864,6067,2490,28,274,0,50,163,22,141,8532,540,0.4551,19956,23253,24747,5253,10225,,24840,-666666666,1966,32780,51,159
"Roanoke County, Virginia",93194,44653,48541,83346,5171,73,2516,0,167,1921,362,1559,90907,2287,0.4161,31864,32498,32563,24713,26205,22942,36747,-666666666,33203,13421,51,161
"Rockbridge County, Virginia",22367,11084,11283,20998,641,46,149,20,151,362,31,331,22041,326,0.4402,26391,27186,27241,10651,12399,50563,19748,,9717,12838,51,163
"Rockingham County, Virginia",77345,37671,39674,73299,1223,276,517,11,969,1050,53,997,72943,4402,0.4518,27696,28510,29298,10900,16473,12204,24891,,9514,6322,51,165
"Russell County, Virginia",28444,13934,14510,27615,384,8,64,0,100,273,33,240,28318,126,0.4579,20117,20328,20344,23629,12801,,30072,-666666666,28251,3844,51,167
"Scott County, Virginia",22781,11413,11368,22385,161,9,90,0,1,135,0,135,22507,274,0.4657,21376,21502,21539,18115,18934,,13441,-666666666,,10163,51,169
"Shenandoah County, Virginia",42545,20641,21904,40054,921,40,225,0,505,800,131,669,39777,2768,0.4123,24967,25580,26376,11070,16490,31143,32235,-666666666,15249,7840,51,171
"Smyth County, Virginia",31876,15598,16278,30699,663,17,100,0,5,392,27,365,31309,567,0.4693,22010,22409,22669,9136,11228,,13280,-666666666,,10107,51,173
"Southampton County, Virginia",18364,9574,8790,11196,6670,49,16,0,50,383,18,365,18134,230,0.4202,23414,26854,27189,8070,18539,42512,10769,-666666666,12202,7296,51,175
"Spotsylvania County, Virginia",126200,61986,64214,93660,20006,357,3291,222,5473,3191,300,2891,115964,10236,0.3862,31842,34626,34898,20009,26957,30971,27281,9179,15129,15794,51,177
"Stafford County, Virginia",134672,67752,66920,94428,23169,665,3875,138,7466,4931,483,4448,121028,13644,0.3688,37237,39938,40685,22247,37057,37481,31692,22679,18428,19566,51,179
"Surry County, Virginia",6885,3373,3512,3556,3194,8,54,0,23,50,0,50,6841,44,0.3695,24469,26328,26329,8807,22311,,25369,-666666666,,39244,51,181
"Sussex County, Virginia",11923,8149,3774,4673,6800,34,10,7,170,229,0,229,11530,393,0.4183,14316,20356,20575,8750,10526,2156,3810,,12423,5231,51,183
"Tazewell County, Virginia",44331,21844,22487,42070,1221,50,163,0,26,801,5,796,43977,354,0.4770,21558,21929,21974,13859,11369,8092,18577,-666666666,2831,19699,51,185
"Warren County, Virginia",38142,18987,19155,34867,1446,72,377,23,106,1251,56,1195,36705,1437,0.4152,29160,29712,30190,17509,28427,20038,24436,,19208,17543,51,187
"Washington County, Virginia",54833,27052,27781,52986,794,50,264,0,230,509,51,458,54067,766,0.4688,25807,26032,26085,17633,15663,12710,27791,-666666666,8345,26309,51,191
"Westmoreland County, Virginia",17518,8433,9085,11924,5189,13,48,0,176,168,5,163,16470,1048,0.4213,25591,27878,29200,12757,20194,42223,,-666666666,31899,17957,51,193
"Wise County, Virginia",40872,21227,19645,37926,2143,43,204,0,151,405,36,369,40378,494,0.4718,19970,20949,21057,7711,4836,14635,34435,-666666666,12714,4325,51,195
"Wythe County, Virginia",29259,14413,14846,27804,1088,22,189,0,97,59,0,59,28950,309,0.4505,23237,23380,23446,15941,19287,8118,37497,-666666666,,2829,51,197
"York County, Virginia",65808,32368,33440,50872,8852,107,3346,167,268,2196,166,2030,62441,3367,0.3926,36004,38021,39023,18867,27491,45183,39448,31422,20394,20138,51,199
"Alexandria city, Virginia",146422,70729,75693,93493,31614,373,9298,65,5482,6097,1580,4517,122310,24112,0.4402,54597,67628,75524,27002,29795,51921,45002,20471,17630,31771,51,510
"Bristol city, Virginia",17595,8214,9381,15744,1169,105,146,0,198,233,0,233,17472,123,0.4616,20574,21859,21885,11076,9534,13329,11510,-666666666,10341,6787,51,520
"Buena Vista city, Virginia",6683,3135,3548,6005,213,0,382,1,0,82,0,82,6631,52,0.4273,17460,18598,18719,4765,10409,-666666666,7110,,-666666666,830,51,530
"Charlottesville city, Virginia",44505,21363,23142,31415,8743,109,3038,59,130,1011,72,939,42312,2193,0.5100,28285,32423,32948,21578,19299,45957,16487,81536,12534,9854,51,540
"Chesapeake city, Virginia",228168,111436,116732,142696,67981,642,7391,229,2561,6668,476,6192,217079,11089,0.3951,29735,33612,34008,24257,23185,21541,32665,10704,19075,15824,51,550
"Colonial Heights city, Virginia",17542,8116,9426,14150,2422,33,569,0,186,182,6,176,16722,820,0.4052,28282,31068,31606,14516,15429,16339,21262,-666666666,16199,19219,51,570
"Covington city, Virginia",5853,3094,2759,4818,804,0,21,0,44,166,0,166,5780,73,0.4193,21243,21502,21558,26440,20124,-666666666,,-666666666,,18009,51,580
"Danville city, Virginia",42704,19541,23163,20004,20629,42,515,14,665,835,75,760,41389,1315,0.4926,20569,26664,27121,12668,15612,24090,15201,,16416,3785,51,590
"Emporia city, Virginia",5682,2683,2999,1762,3715,12,61,0,59,73,0,73,5623,59,0.5128,18909,30797,30797,18422,13177,,45221,-666666666,18422,,51,595
"Fairfax city, Virginia",23507,11638,11869,16234,1107,175,3466,37,1336,1152,246,906,19684,3823,0.4132,44747,52306,55080,27137,33031,21570,33165,,21446,16121,51,600
"Falls Church city, Virginia",13074,6290,6784,10138,724,0,1179,0,475,558,37,521,11835,1239,0.4230,59861,65958,69107,24303,44328,-666666666,47726,-666666666,37298,14087,51,610
"Franklin city, Virginia",8534,3863,4671,3310,4947,0,73,0,14,190,0,190,8484,50,0.4618,19754,30097,30031,34374,13796,-666666666,764,-666666666,,2878,51,620
"Fredericksburg city, Virginia",26632,12405,14227,17588,5974,104,741,11,1089,1125,267,858,23755,2877,0.4809,28453,32652,34256,13006,22122,20967,20360,,9978,20035,51,630
"Galax city, Virginia",6981,3307,3674,6441,315,15,15,0,19,176,68,108,5691,1290,0.4917,20081,20145,21980,11288,27577,,,-666666666,,6512,51,640
"Hampton city, Virginia",136904,65884,71020,58796,68794,616,3145,15,1550,3988,290,3698,130056,6848,0.4164,25131,30433,31069,18728,21270,14189,23541,,22454,17408,51,650
"Harrisonburg city, Virginia",50821,23706,27115,43006,3708,96,1818,30,661,1502,211,1291,42031,8790,0.4767,17919,18665,20053,12836,14713,17908,13609,,19942,9152,51,660
"Hopewell city, Virginia",22375,10557,11818,12053,8416,26,294,0,901,685,31,654,20867,1508,0.4240,21041,24946,25069,20387,16290,27581,18366,-666666666,22984,9045,51,670
"Lexington city, Virginia",7114,4396,2718,6023,455,0,316,0,59,261,45,216,6816,298,0.5068,15627,16554,16882,3493,14487,-666666666,12502,-666666666,105,3515,51,678
"Lynchburg city, Virginia",77626,36525,41101,50330,21807,159,2211,20,673,2426,334,2092,75114,2512,0.4882,21236,25066,25310,18126,13870,11194,22486,21695,25540,6313,51,680
"Manassas city, Virginia",40436,20195,20241,29696,5864,43,2054,0,1120,1659,339,1320,27307,13129,0.4004,28646,30532,40063,14962,24975,,28791,-666666666,14544,17835,51,683
"Manassas Park city, Virginia",14992,7572,7420,10177,1951,45,1187,0,452,1180,272,908,9888,5104,0.3710,28054,28934,36883,16988,36654,,23141,-666666666,13342,16190,51,685
"Martinsville city, Virginia",13745,6231,7514,6782,6264,30,19,0,422,228,0,228,13143,602,0.5085,19663,25665,26427,11679,13629,,,-666666666,9955,16198,51,690
"Newport News city, Virginia",181362,87796,93566,91978,72732,646,5061,359,2711,7875,550,7325,166816,14546,0.4261,25408,30772,32156,17719,20042,21394,23965,18699,18293,16317,51,700
"Norfolk city, Virginia",244745,127453,117292,116874,104313,1075,8225,600,4614,9044,916,8128,227394,17351,0.4690,24252,31470,32554,18516,17169,25361,24758,17103,17190,16142,51,710
"Norton city, Virginia",4015,1500,2515,3623,280,5,0,0,80,27,0,27,3935,80,0.5261,22715,23392,23392,19141,17406,,-666666666,-666666666,19141,,51,720
"Petersburg city, Virginia",32439,15008,17431,5882,25099,17,315,12,308,806,175,631,31106,1333,0.4352,18535,25821,27904,14013,16991,14488,16542,,15181,15562,51,730
"Poquoson city, Virginia",12103,5981,6122,11446,83,9,342,0,41,182,22,160,11846,257,0.4042,38295,38490,38484,36898,83958,,33109,-666666666,39385,15620,51,735
"Portsmouth city, Virginia",96007,46220,49787,39631,50736,319,1134,42,1199,2946,345,2601,92672,3335,0.4224,23219,28904,29156,20101,19440,17236,20757,20271,20132,14699,51,740
"Radford city, Virginia",16993,7988,9005,14558,1495,0,289,11,157,483,40,443,16519,474,0.5118,15509,16169,16276,8490,8745,-666666666,31357,,16088,7090,51,750
"Richmond city, Virginia",211063,100506,110557,92430,103194,725,4741,29,2639,7305,326,6979,197555,13508,0.5373,27860,41626,44436,14492,16939,20905,25495,376,14835,14999,51,760
"Roanoke city, Virginia",97949,46981,50968,63687,27289,186,2065,133,1197,3392,238,3154,92350,5599,0.4593,23565,28161,29000,13284,15516,18106,15056,44157,15483,9569,51,770
"Salem city, Virginia",25120,11926,13194,22085,1990,0,497,0,336,212,19,193,24405,715,0.4446,27559,28551,28863,13839,21638,-666666666,22623,-666666666,15503,10436,51,775
"Staunton city, Virginia",24132,10673,13459,20171,2811,17,253,0,133,747,51,696,23529,603,0.4713,25255,27004,27364,10007,17610,,11860,-666666666,13657,13757,51,790
"Suffolk city, Virginia",85477,41200,44277,44663,35775,69,1178,24,491,3277,215,3062,82643,2834,0.4183,30021,36887,37142,25688,22889,29428,28990,,19485,16220,51,800
"Virginia Beach city, Virginia",445623,218909,226714,303547,85459,1387,28921,540,5993,19776,1566,18210,413465,32158,0.4117,32477,36800,37714,21176,23746,32680,27975,43137,18450,14386,51,810
"Waynesboro city, Virginia",21177,9899,11278,17026,2593,145,181,0,406,826,55,771,19784,1393,0.3975,21515,23650,23920,9116,14091,20073,21170,-666666666,12103,5760,51,820
"Williamsburg city, Virginia",14401,6553,7848,10787,2132,9,778,0,139,556,53,503,13399,1002,0.4999,23686,26839,28009,11814,17586,,10848,-666666666,9166,7671,51,830
"Winchester city, Virginia",27031,13376,13655,21703,2915,72,641,23,846,831,85,746,22693,4338,0.4762,26624,28169,31046,11403,16414,41496,56563,,11130,11948,51,840
"Adams County, Washington",18951,9641,9310,12783,18,72,184,37,5316,541,181,360,7421,11530,0.4039,17398,19847,26586,11713,,5329,20948,16192,11475,17829,53,001
"Asotin County, Washington",21955,10524,11431,20583,123,248,169,72,196,564,97,467,21213,742,0.4493,24836,25458,25757,9658,19735,14687,31844,2036,9565,13824,53,003
"Benton County, Washington",182053,91336,90717,146078,2871,1482,4902,198,20561,5961,1570,4391,146561,35492,0.4329,29060,32103,33600,13372,22376,18588,32831,19402,12417,14953,53,005
"Chelan County, Washington",73664,36766,36898,66354,265,843,637,76,3886,1603,252,1351,53913,19751,0.4485,25619,26573,30610,13381,8266,18646,17106,21605,14328,23608,53,007
"Clallam County, Washington",72024,35743,36281,63318,686,3616,1066,56,726,2556,50,2506,68067,3957,0.4211,26325,27574,28235,11662,17406,15633,29794,18979,7615,16924,53,009
"Clark County, Washington",438272,216638,221634,372662,8743,3274,18216,3185,13537,18655,1647,17008,402652,35620,0.4177,28206,29631,30364,14099,22045,24050,29812,18177,13209,14384,53,011
"Columbia County, Washington",4031,2023,2008,3720,3,52,20,0,123,113,6,107,3780,251,0.4572,23558,24659,25008,13707,,16548,12055,-666666666,10378,7537,53,013
"Cowlitz County, Washington",102072,50519,51553,92786,584,1233,1462,191,1493,4323,390,3933,93787,8285,0.4367,24042,25154,26142,10083,12309,13668,14766,7722,8633,13917,53,015
"Douglas County, Washington",39183,19689,19494,28836,139,392,339,14,8175,1288,466,822,27586,11597,0.3850,23116,26973,28228,12062,21569,11805,27150,,11086,14296,53,017
"Ferry County, Washington",7657,4001,3656,5808,23,1275,9,52,88,402,41,361,7371,286,0.4566,20646,23230,23423,10630,26252,12374,11756,12169,8031,13283,53,019
"Franklin County, Washington",84508,44037,40471,56156,1597,496,1704,46,21891,2618,843,1775,41208,43300,0.4080,19982,23908,29851,12041,17525,13204,23821,8213,10754,13417,53,021
"Garfield County, Washington",2240,1106,1134,2140,0,5,9,0,0,86,0,86,2124,116,0.3625,24767,25624,26417,6501,-666666666,,6544,-666666666,-666666666,5724,53,023
"Grant County, Washington",91458,46412,45046,64344,828,1143,966,56,21096,3025,914,2111,55567,35891,0.4139,19844,22922,25515,11805,10953,21354,21796,34757,11626,12653,53,025
"Grays Harbor County, Washington",71734,36900,34834,61989,911,3049,1076,244,1808,2657,176,2481,65077,6657,0.4330,22190,23520,24391,10823,8606,14144,22664,10763,10912,13570,53,027
"Island County, Washington",78951,39292,39659,67247,1984,834,3504,402,1159,3821,527,3294,73985,4966,0.4187,31563,33696,34189,19252,21372,18587,24801,13892,17745,14387,53,029
"Jefferson County, Washington",29978,14892,15086,26920,283,674,511,41,144,1405,108,1297,29016,962,0.4479,28607,29353,29407,13681,6400,19197,49145,23776,47972,13989,53,031
"King County, Washington",2008997,1002198,1006799,1384506,123852,15724,306079,15323,51985,111528,10793,100735,1824679,184318,0.4658,40656,46175,48264,20490,22480,22767,35832,20177,19510,20763,53,033
"Kitsap County, Washington",253614,128985,124629,208328,6777,3546,12475,2276,4442,15770,1254,14516,236278,17336,0.4237,31901,34275,34966,18970,21988,19563,28678,20946,19899,15086,53,035
"Kittitas County, Washington",41705,20947,20758,37063,379,415,902,0,1740,1206,40,1166,38253,3452,0.4514,23754,24759,25259,13432,14275,20140,14030,-666666666,13458,19220,53,037
"Klickitat County, Washington",20668,10271,10397,18588,133,581,122,39,760,445,45,400,18274,2394,0.3939,22716,23847,24809,10679,3844,20231,25208,,8222,10419,53,039
"Lewis County, Washington",75382,37741,37641,68858,529,474,785,7,1283,3446,529,2917,68450,6932,0.4136,22094,22923,23693,11471,10070,16942,22024,,14531,10964,53,041
"Lincoln County, Washington",10409,5239,5170,9827,25,110,40,25,34,348,20,328,10127,282,0.4098,25512,26050,26174,17045,9240,29704,28943,25612,17785,10522,53,043
"Mason County, Washington",60728,31294,29434,52057,994,1872,903,211,1694,2997,412,2585,55592,5136,0.4137,23965,25517,25955,9990,15253,17566,24740,33893,6177,13000,53,045
"Okanogan County, Washington",41241,20781,20460,31041,205,4261,292,72,3555,1815,235,1580,33618,7623,0.4383,21483,23493,24856,10984,9977,15166,25607,8601,10928,23773,53,047
"Pacific County, Washington",20665,10376,10289,18396,84,288,450,31,565,851,33,818,18898,1767,0.4456,23224,24544,25383,10592,14132,14227,11270,6858,9507,14646,53,049
"Pend Oreille County, Washington",12965,6653,6312,11808,22,465,11,27,74,558,21,537,12525,440,0.4426,21758,22317,22529,12451,22041,19131,,14874,11962,13760,53,051
"Pierce County, Washington",812689,402977,409712,610781,55651,9264,48641,11235,20858,56259,3511,52748,733965,78724,0.4184,28571,31166,32293,16688,24335,22693,25361,17749,15866,15213,53,053
"San Juan County, Washington",15847,7627,8220,14685,105,126,220,6,347,358,63,295,14942,905,0.4970,38556,39432,40284,14241,77982,23206,33229,,15621,22557,53,055
"Skagit County, Washington",118364,58664,59700,102704,761,1859,2058,636,6319,4027,622,3405,97820,20544,0.4284,27598,29241,31478,13705,20007,17288,21665,31738,14334,15071,53,057
"Skamania County, Washington",11194,5691,5503,10488,63,232,131,26,71,183,11,172,10576,618,0.4681,28705,29407,30286,14324,8613,18669,28618,4369,20282,14898,53,059
"Snohomish County, Washington",735351,368756,366595,583890,19147,8374,68757,3117,15459,36607,2560,34047,666572,68779,0.4037,31782,33636,35014,17445,24313,25438,30066,27248,17195,17347,53,061
"Spokane County, Washington",476950,236240,240710,425316,9300,6680,11078,1652,4875,18049,1146,16903,453611,23339,0.4453,26125,27309,27707,15558,16342,15200,21424,14681,17530,13576,53,063
"Stevens County, Washington",43541,21878,21663,39016,214,1959,244,31,272,1805,22,1783,42184,1357,0.4104,22035,22886,22834,19788,8225,16285,38562,22145,9711,11141,53,065
"Thurston County, Washington",259330,126989,132341,214795,7439,3648,14897,2343,3543,12665,1041,11624,239180,20150,0.4034,29909,31524,32386,19302,28118,19246,24908,26081,21737,15519,53,067
"Wahkiakum County, Washington",4016,1956,2060,3774,0,76,37,0,0,129,13,116,3904,112,0.4124,23215,23791,24200,12921,-666666666,22301,17535,-666666666,-666666666,8535,53,069
"Walla Walla County, Washington",59476,30408,29068,51494,1004,739,996,84,3199,1960,315,1645,47243,12233,0.4495,23656,24698,27224,12128,7727,12177,44071,37269,16283,9818,53,071
"Whatcom County, Washington",204855,101494,103361,176607,1836,5531,8034,510,4317,8020,888,7132,187591,17264,0.4399,26671,28043,28965,13407,20807,16313,23669,20938,11539,16468,53,073
"Whitman County, Washington",46003,23452,22551,38701,958,287,3555,142,505,1855,107,1748,43644,2359,0.5241,21086,22207,22798,11347,9016,18584,19475,4927,22226,8328,53,075
"Yakima County, Washington",246402,123372,123030,187855,1948,9918,2591,145,35481,8464,2591,5873,131871,114531,0.4373,19861,21924,29079,11406,16252,13160,21436,21097,12872,11560,53,077
"Barbour County, West Virginia",16723,8130,8593,16206,140,127,59,0,0,191,0,191,16610,113,0.4277,17909,18193,18250,7996,8444,16787,6603,-666666666,-666666666,5041,54,001
"Berkeley County, West Virginia",107324,52917,54407,94247,7663,124,897,44,1296,3053,128,2925,103184,4140,0.4202,26516,27452,27661,16826,24803,18816,27139,18514,10070,9149,54,003
"Boone County, West Virginia",24257,12049,12208,23860,209,0,8,0,40,140,1,139,24145,112,0.4557,22400,22413,22400,18530,21527,-666666666,,-666666666,,24859,54,005
"Braxton County, West Virginia",14492,7285,7207,14209,95,12,22,1,1,152,0,152,14412,80,0.4444,18537,18710,18790,3038,7617,,7791,,,12001,54,007
"Brooke County, West Virginia",23787,11579,12208,23037,386,47,121,3,23,170,16,154,23607,180,0.4102,23310,23702,23787,12099,16225,5555,7321,,,2132,54,009
"Cabell County, West Virginia",96826,47070,49756,88291,4502,159,1059,45,203,2567,11,2556,95617,1209,0.5004,23595,24388,24422,15986,17086,25226,26365,,9707,7897,54,011
"Calhoun County, West Virginia",7583,3765,3818,7406,8,4,6,0,1,158,4,154,7560,23,0.4440,18181,18298,18309,13617,,,,-666666666,,14137,54,013
"Clay County, West Virginia",9226,4607,4619,9141,0,13,0,0,7,65,0,65,9213,13,0.4232,16487,16463,16463,,-666666666,,-666666666,-666666666,,21149,54,015
"Doddridge County, West Virginia",8282,4419,3863,8047,78,10,0,0,0,147,7,140,8198,84,0.3917,18552,18713,18842,6402,4656,,-666666666,-666666666,-666666666,17738,54,017
"Fayette County, West Virginia",45709,22885,22824,42723,2289,45,46,0,100,506,12,494,45260,449,0.4323,18928,19145,19202,15728,17011,13076,21530,-666666666,23068,8757,54,019
"Gilmer County, West Virginia",8706,5217,3489,7100,1014,71,17,0,140,364,43,321,8317,389,0.4724,17175,19572,19951,5856,4884,4375,,-666666666,8173,11133,54,021
"Grant County, West Virginia",11829,5917,5912,11552,97,0,0,0,12,168,0,168,11741,88,0.3887,19696,20012,20067,12860,6538,-666666666,-666666666,-666666666,,4737,54,023
"Greenbrier County, West Virginia",35639,17447,18192,33651,805,9,132,9,124,909,80,829,35178,461,0.4652,22913,23360,23388,14211,22945,,9351,,8967,10449,54,025
"Hampshire County, West Virginia",23674,12267,11407,23032,330,0,17,0,26,269,0,269,23402,272,0.4511,17652,17884,17843,22209,10810,-666666666,,-666666666,,7042,54,027
"Hancock County, West Virginia",30369,14683,15686,29078,787,22,85,0,0,397,7,390,30038,331,0.4492,23947,24254,24377,12827,21493,35764,17401,-666666666,-666666666,7139,54,029
"Hardy County, West Virginia",13955,7080,6875,13160,524,15,50,0,118,88,8,80,13469,486,0.4429,20977,21018,21244,9705,26157,,7868,-666666666,5490,10942,54,031
"Harrison County, West Virginia",69069,33778,35291,66145,1177,273,369,136,101,868,49,819,68099,970,0.4490,24021,24252,24301,18901,21120,16138,13718,9054,13365,20852,54,033
"Jackson County, West Virginia",29229,14530,14699,28509,212,17,0,0,0,491,0,491,29221,8,0.4582,22870,23306,23307,,,,-666666666,-666666666,-666666666,3428,54,035
"Jefferson County, West Virginia",54650,26833,27817,48029,3553,39,868,0,616,1545,201,1344,51862,2788,0.4141,29861,30921,31221,21736,26943,8777,15848,-666666666,21746,15277,54,037
"Kanawha County, West Virginia",191765,92232,99533,170300,7984,334,1957,0,365,10825,136,10689,189816,1949,0.4689,27913,28976,29001,24044,17201,15245,53788,-666666666,26466,14856,54,039
"Lewis County, West Virginia",16412,8191,8221,15947,141,0,30,18,0,276,38,238,16383,29,0.4398,20587,20738,20709,36462,6577,-666666666,20113,,-666666666,15147,54,041
"Lincoln County, West Virginia",21599,10719,10880,21271,97,33,50,0,0,148,0,148,21570,29,0.4357,18824,18981,18997,7669,13353,561,20974,-666666666,-666666666,3138,54,043
"Logan County, West Virginia",36169,17804,18365,34915,793,110,130,0,41,180,4,176,35864,305,0.4487,20644,20719,20757,18297,17545,,37905,-666666666,35856,9715,54,045
"McDowell County, West Virginia",21281,10640,10641,18998,2017,0,25,0,31,210,32,178,21132,149,0.4839,14813,15337,15387,2617,11510,-666666666,,-666666666,,2416,54,047
"Marion County, West Virginia",56698,27708,28990,53383,2031,47,280,10,0,947,24,923,56084,614,0.4369,23870,24477,24363,30434,13613,8557,20057,,-666666666,13703,54,049
"Marshall County, West Virginia",32716,16064,16652,31982,280,100,140,0,54,160,15,145,32416,300,0.4585,24419,24638,24732,10924,7017,17213,38470,-666666666,9926,8179,54,051
"Mason County, West Virginia",27207,13179,14028,26528,199,0,24,0,0,456,34,422,27064,143,0.4247,19969,20026,20054,9038,13359,-666666666,,-666666666,-666666666,19721,54,053
"Mercer County, West Virginia",62161,29659,32502,56796,3520,210,388,15,100,1132,34,1098,61598,563,0.4594,20833,21479,21551,10324,14952,12243,28250,,25335,5451,54,055
"Mineral County, West Virginia",27912,13625,14287,26503,849,1,32,0,42,485,40,445,27685,227,0.4534,19055,19633,19718,5671,7781,,24366,-666666666,9274,7689,54,057
"Mingo County, West Virginia",26229,12909,13320,25263,434,14,121,0,84,313,0,313,26126,103,0.4646,20222,20190,20182,15277,18793,,72068,-666666666,11926,7410,54,059
"Monongalia County, West Virginia",100332,51907,48425,91058,3597,143,3251,10,370,1903,118,1785,98381,1951,0.5153,26109,26758,26926,14855,17283,20503,30577,,3771,9042,54,061
"Monroe County, West Virginia",13524,6655,6869,13193,79,43,0,0,0,209,12,197,13425,99,0.3896,20041,20384,20380,20879,6572,11400,-666666666,-666666666,-666666666,5287,54,063
"Morgan County, West Virginia",17450,8642,8808,16976,140,4,67,0,0,263,23,240,17245,205,0.4554,22770,22882,23019,12164,21308,,28461,-666666666,-666666666,14967,54,065
"Nicholas County, West Virginia",26090,12723,13367,25441,6,196,206,0,0,241,0,241,26073,17,0.5030,22674,22757,22721,,-666666666,,54509,-666666666,-666666666,5213,54,067
"Ohio County, West Virginia",43956,21061,22895,40992,1753,62,395,0,81,673,14,659,43528,428,0.4958,26370,27177,27218,19619,11115,15168,51154,-666666666,14768,4863,54,069
"Pendleton County, West Virginia",7525,3805,3720,7219,214,0,6,0,11,75,0,75,7446,79,0.4563,21486,21574,21639,14895,19806,-666666666,,-666666666,,15871,54,071
"Pleasants County, West Virginia",7600,4072,3528,7358,45,2,0,0,0,195,37,158,7528,72,0.4283,22308,22867,22883,11169,6538,,-666666666,-666666666,-666666666,4586,54,073
"Pocahontas County, West Virginia",8710,4422,4288,8424,128,5,0,0,1,152,13,139,8674,36,0.4293,21120,21333,21317,22064,18626,,-666666666,-666666666,,12172,54,075
"Preston County, West Virginia",33720,17363,16357,31995,1018,83,52,16,160,396,164,232,33296,424,0.3976,21237,22016,22074,10342,6502,13183,10581,,6184,6134,54,077
"Putnam County, West Virginia",56356,27686,28670,54507,672,112,326,0,90,649,44,605,55804,552,0.4298,28493,28788,28901,17445,21388,23636,28268,-666666666,,15443,54,079
"Raleigh County, West Virginia",78827,39389,39438,69583,6527,198,877,72,518,1052,85,967,77737,1090,0.4547,22384,23315,23443,10488,14812,12239,19729,9676,7521,20061,54,081
"Randolph County, West Virginia",29446,15254,14192,28575,415,46,93,27,27,263,15,248,29226,220,0.4409,20464,20753,20868,3629,17172,2028,,,,7589,54,083
"Ritchie County, West Virginia",10221,5065,5156,10044,37,0,0,0,3,137,0,137,10159,62,0.3879,18717,18856,18884,4106,14154,-666666666,-666666666,-666666666,,9964,54,085
"Roane County, West Virginia",14749,7290,7459,14455,4,16,18,1,7,248,0,248,14625,124,0.4639,18124,18317,18382,5267,6550,12863,9733,,,8379,54,087
"Summers County, West Virginia",13699,6329,7370,12822,615,63,8,58,27,106,9,97,13379,320,0.4290,19181,19652,19508,23448,14031,,,,17937,5487,54,089
"Taylor County, West Virginia",16969,8600,8369,16521,175,28,117,12,5,111,13,98,16811,158,0.4405,21266,21435,21418,21473,20316,7482,14257,,,9329,54,091
"Tucker County, West Virginia",6996,3486,3510,6879,11,0,5,0,0,101,0,101,6957,39,0.4305,21014,21227,21316,4233,2464,-666666666,,-666666666,-666666666,9282,54,093
"Tyler County, West Virginia",9084,4493,4591,8978,21,12,1,0,0,72,0,72,9029,55,0.4362,20900,20971,21008,14898,457,63017,,-666666666,-666666666,11358,54,095
"Upshur County, West Virginia",24487,12169,12318,23897,231,35,51,48,15,210,10,200,24220,267,0.4270,19537,19816,19976,5681,11001,3440,8720,,,8269,54,097
"Wayne County, West Virginia",41735,20227,21508,40954,69,47,113,0,50,502,3,499,41490,245,0.4517,19910,19874,19750,33796,701,24413,60004,-666666666,,17935,54,099
"Webster County, West Virginia",9005,4452,4553,8860,4,15,31,0,0,95,0,95,8961,44,0.4586,17423,17608,17620,,,,,-666666666,-666666666,6535,54,101
"Wetzel County, West Virginia",16314,8011,8303,16079,15,5,88,13,0,114,0,114,16214,100,0.4566,20996,21186,21224,15133,,,9739,,-666666666,2682,54,103
"Wirt County, West Virginia",5810,2945,2865,5667,50,23,0,0,0,70,0,70,5810,0,0.4567,23240,23252,23252,-666666666,,32357,-666666666,-666666666,-666666666,11080,54,105
"Wood County, West Virginia",86595,41854,44741,83347,925,95,501,78,237,1412,77,1335,85786,809,0.4560,24528,24790,24836,23210,19785,21618,26737,10105,36640,10320,54,107
"Wyoming County, West Virginia",23203,11492,11711,22683,164,6,5,29,24,292,0,292,23145,58,0.4444,18729,18939,18945,8722,15663,,,,,6922,54,109
"Adams County, Wisconsin",20604,11100,9504,19243,620,181,77,33,126,324,53,271,19821,783,0.4006,22639,23338,23753,8615,3722,12030,22666,,8731,6319,55,001
"Ashland County, Wisconsin",16065,8023,8042,13644,53,1642,94,1,44,587,13,574,15713,352,0.4295,21159,22407,22617,12184,10936,14974,12143,,19641,11892,55,003
"Barron County, Wisconsin",45718,23028,22690,43879,548,338,199,0,275,479,3,476,44733,985,0.4086,23547,23949,24142,12612,16837,13853,13134,-666666666,13908,11127,55,005
"Bayfield County, Wisconsin",15064,7758,7306,13051,91,1530,64,0,42,286,0,286,14865,199,0.4110,25919,27557,27682,15266,7642,14738,11942,-666666666,18412,21074,55,007
"Brown County, Wisconsin",252698,125242,127456,220870,5827,5880,7308,30,5458,7325,779,6546,233283,19415,0.4339,27734,29791,30734,12020,11449,17129,18051,,11618,8904,55,009
"Buffalo County, Wisconsin",13374,6787,6587,13015,51,44,3,0,132,129,19,110,13117,257,0.4121,25207,25489,25576,15244,16825,14586,,-666666666,14734,14236,55,011
"Burnett County, Wisconsin",15387,7845,7542,14105,87,783,60,4,43,305,13,292,15165,222,0.4240,23542,24475,24622,9778,10479,14442,12752,,18565,10326,55,013
"Calumet County, Wisconsin",49502,24873,24629,46918,302,268,1131,0,329,554,60,494,47665,1837,0.3751,29406,30040,30538,11503,10334,39073,14892,-666666666,7246,24196,55,015
"Chippewa County, Wisconsin",63051,32666,30385,60064,882,187,790,3,153,972,48,924,62179,872,0.4004,25097,25634,25826,8825,10857,15119,13559,,10462,18505,55,017
"Clark County, Wisconsin",34575,17513,17062,33642,139,156,115,0,166,357,49,308,33212,1363,0.4184,21005,21021,21349,11776,17465,14863,75157,-666666666,15493,8753,55,019
"Columbia County, Wisconsin",56659,28833,27826,54261,876,282,276,18,229,717,70,647,55106,1553,0.3945,28655,29289,29562,14344,4081,34428,23043,44144,20848,12688,55,021
"Crawford County, Wisconsin",16525,8515,8010,16106,260,35,32,0,23,69,13,56,16355,170,0.4150,22801,23199,23243,10656,4586,19294,12569,-666666666,11452,8803,55,023
"Dane County, Wisconsin",502984,249102,253882,427117,25851,1162,26220,99,8812,13723,1521,12202,472322,30662,0.4434,33895,36494,37444,15510,16352,29875,26238,11618,15480,13000,55,025
"Dodge County, Wisconsin",88589,46421,42168,83652,2409,235,455,0,564,1274,160,1114,84805,3784,0.3879,24864,25812,26333,11255,5663,17480,12152,-666666666,11037,10927,55,027
"Door County, Wisconsin",27789,13710,14079,26818,128,208,132,0,158,345,30,315,27062,727,0.4387,30216,30820,31038,13391,7852,30387,14408,-666666666,7747,7850,55,029
"Douglas County, Wisconsin",43901,21841,22060,40817,509,826,485,2,102,1160,34,1126,43344,557,0.4187,24821,25697,25719,16742,7608,18664,9731,,13423,13249,55,031
"Dunn County, Wisconsin",44045,22212,21833,41690,243,186,1079,0,85,762,26,736,43343,702,0.4096,23324,23835,23996,11828,9372,15531,14812,-666666666,14429,14800,55,033
"Eau Claire County, Wisconsin",100607,49425,51182,93700,714,424,3149,115,319,2186,49,2137,98519,2088,0.4469,25808,26706,27009,11047,10605,13235,18910,14496,8139,7845,55,035
"Florence County, Wisconsin",4473,2340,2133,4301,8,50,2,0,9,103,11,92,4433,40,0.3971,24690,25339,25267,25718,,17014,,-666666666,,4339,55,037
"Fond du Lac County, Wisconsin",101709,49876,51833,95345,1211,445,1249,11,1754,1694,103,1591,97044,4665,0.4018,27158,27971,28281,14518,8911,29098,27159,39091,13610,7869,55,039
"Forest County, Wisconsin",9198,4680,4518,7591,95,1258,7,0,9,238,0,238,9031,167,0.4095,20890,22207,22405,9960,9943,16539,28557,-666666666,,6811,55,041
"Grant County, Wisconsin",51272,26628,24644,49618,675,78,292,19,149,441,13,428,50601,671,0.4055,22343,22732,22826,11507,5615,10687,19101,19642,16635,10527,55,043
"Green County, Wisconsin",36971,18318,18653,36028,93,36,179,0,134,501,13,488,35914,1057,0.4097,27575,27925,28333,13416,9873,19722,23697,-666666666,21176,9297,55,045
"Green Lake County, Wisconsin",19001,9512,9489,18224,93,68,70,7,356,183,4,179,18178,823,0.4194,25486,26060,26475,8645,17186,17804,11371,,7193,17104,55,047
"Iowa County, Wisconsin",23754,11881,11873,23063,84,54,139,0,176,238,13,225,23374,380,0.4046,27052,27397,27485,14214,11286,20022,19102,-666666666,11607,16847,55,049
"Iron County, Wisconsin",5927,2962,2965,5759,41,27,2,0,24,74,12,62,5881,46,0.4328,25053,25489,25534,7830,2000,28563,,-666666666,,10323,55,051
"Jackson County, Wisconsin",20543,11003,9540,18244,446,1102,89,0,138,524,21,503,19937,606,0.4071,22169,23385,23612,11282,2105,18497,16173,-666666666,16025,7267,55,053
"Jefferson County, Wisconsin",84201,41940,42261,79693,631,102,610,0,1591,1574,264,1310,78478,5723,0.3951,26349,27055,27718,12775,10735,46989,17396,-666666666,12817,12674,55,055
"Juneau County, Wisconsin",26607,14019,12588,25115,575,426,88,7,114,282,26,256,25864,743,0.4114,22439,22976,23107,16561,10255,15073,23910,,13779,10376,55,057
"Kenosha County, Wisconsin",167268,82692,84576,146220,11947,584,2381,32,2256,3848,709,3139,146820,20448,0.4340,26560,28008,29864,13969,14944,18017,34200,225,18313,9226,55,059
"Kewaunee County, Wisconsin",20545,10435,10110,19945,80,141,78,0,118,183,21,162,20066,479,0.4038,25651,26080,26271,10066,24319,9144,24079,-666666666,4780,6420,55,061
"La Crosse County, Wisconsin",116470,57140,59330,106647,1700,470,5104,55,619,1875,143,1732,114568,1902,0.4313,26719,27832,27895,15809,13535,15697,16496,,14221,9822,55,063
"Lafayette County, Wisconsin",16847,8500,8347,16302,54,64,27,0,284,116,0,116,16270,577,0.3960,24370,24480,24758,17115,8685,10911,27578,-666666666,25997,18925,55,065
"Langlade County, Wisconsin",19706,9930,9776,18866,118,162,80,18,187,275,6,269,19339,367,0.4308,23081,23324,23441,4774,6786,10287,87993,,4873,13933,55,067
"Lincoln County, Wisconsin",28566,14400,14166,27626,229,107,156,0,104,344,19,325,28189,377,0.4019,25371,25504,25641,8405,3993,15969,84844,-666666666,9995,9517,55,069
"Manitowoc County, Wisconsin",80805,40178,40627,76311,441,512,1961,34,656,890,43,847,78126,2679,0.4069,26085,26974,27368,10473,8232,14648,13269,,7216,7274,55,071
"Marathon County, Wisconsin",134886,67799,67087,123623,912,344,7188,11,364,2444,105,2339,131627,3259,0.4307,27723,28843,29224,10489,10167,20638,18179,,17304,8323,55,073
"Marinette County, Wisconsin",41488,20745,20743,40151,120,174,230,5,227,581,9,572,40896,592,0.4235,23751,23738,23798,13576,6970,15713,78787,,9230,14531,55,075
"Marquette County, Wisconsin",15224,7724,7500,14706,69,31,71,3,152,192,6,186,14793,431,0.4005,23914,24304,24579,11611,5694,32955,22979,,13466,7727,55,077
"Menominee County, Wisconsin",4382,2149,2233,566,15,3658,86,0,7,50,2,48,4154,228,0.4479,15201,27654,28749,4000,14900,13289,6472,-666666666,,29630,55,078
"Milwaukee County, Wisconsin",953401,460337,493064,591716,251235,5389,34374,221,39015,31451,5078,26373,821928,131473,0.4695,24622,30725,33284,13440,14527,17930,21291,10861,12380,10529,55,079
"Monroe County, Wisconsin",45116,22861,22255,42556,561,448,316,0,406,829,148,681,43370,1746,0.3911,23406,23880,24056,14502,24105,17781,15052,-666666666,12175,10300,55,081
"Oconto County, Wisconsin",37483,19146,18337,36125,95,423,137,0,274,429,55,374,36895,588,0.4050,26230,26353,26483,12462,12396,22964,79609,-666666666,17875,10515,55,083
"Oneida County, Wisconsin",35754,18053,17701,34550,229,418,238,34,53,232,34,198,35304,450,0.4300,26352,26809,26981,11050,6750,11879,13582,,25687,18080,55,085
"Outagamie County, Wisconsin",179139,89355,89784,162930,1891,2753,5378,22,2652,3513,364,3149,172273,6866,0.4048,28441,29684,29929,15519,19219,17602,16727,,11871,14706,55,087
"Ozaukee County, Wisconsin",86930,42539,44391,82399,1129,314,1737,14,315,1022,82,940,84748,2182,0.4738,42537,42596,43106,18793,42841,30439,57268,,23536,22099,55,089
"Pepin County, Wisconsin",7390,3730,3660,7247,28,13,12,0,30,60,4,56,7299,91,0.4119,24945,25047,25230,8293,10482,,20842,-666666666,20943,18310,55,091
"Pierce County, Wisconsin",40859,20265,20594,39473,234,207,454,11,89,391,37,354,40157,702,0.4209,28559,29023,29231,14622,19977,19530,12765,,27335,11043,55,093
"Polk County, Wisconsin",43698,21981,21717,42126,161,407,223,0,320,461,39,422,42992,706,0.4151,26356,26834,26869,16611,7530,22463,10046,-666666666,14767,8675,55,095
"Portage County, Wisconsin",70337,35100,35237,66246,469,490,1924,5,320,883,89,794,68337,2000,0.4191,25462,26106,26406,11499,26733,40927,8807,,14518,8011,55,097
"Price County, Wisconsin",13888,6992,6896,13469,12,51,90,54,8,204,12,192,13698,190,0.3975,24535,24921,25102,10118,13750,11133,14907,16706,11750,9863,55,099
"Racine County, Wisconsin",195039,96544,98495,157494,21375,909,2328,48,7410,5475,1207,4268,171552,23487,0.4308,27732,30852,32301,14557,14080,23418,33366,20671,14179,8000,55,101
"Richland County, Wisconsin",17842,9002,8840,17167,159,51,67,10,192,196,18,178,17442,400,0.4278,23691,24238,24266,10933,5023,6908,20807,,10160,9772,55,103
"Rock County, Wisconsin",160465,78798,81667,144870,5640,307,1770,38,1811,6029,295,5734,147780,12685,0.4118,24715,25961,26989,12102,12877,16486,19523,16905,14920,10778,55,105
"Rusk County, Wisconsin",14468,7260,7208,14054,104,51,56,1,46,156,24,132,14262,206,0.4176,21475,21808,21915,10202,7029,7425,14900,,9050,11283,55,107
"St. Croix County, Wisconsin",85442,42607,42835,82084,627,571,835,0,133,1192,168,1024,83621,1821,0.4071,33035,33621,33911,12930,16464,10653,39351,-666666666,15520,9646,55,109
"Sauk County, Wisconsin",62681,31223,31458,59171,330,748,462,2,946,1022,337,685,59801,2880,0.4061,25709,26496,26615,16390,12345,14519,18824,,12209,8261,55,111
"Sawyer County, Wisconsin",16516,8353,8163,12968,119,2828,61,6,100,434,17,417,16199,317,0.4452,24423,27365,27480,9002,6328,13843,21341,,3983,15901,55,113
"Shawano County, Wisconsin",41697,20866,20831,37193,147,3115,188,32,211,811,63,748,40700,997,0.4092,23843,24869,25143,9475,10250,15838,19121,31281,13723,13397,55,115
"Sheboygan County, Wisconsin",115168,57910,57258,104283,1720,319,5547,23,1204,2072,296,1776,108556,6612,0.4036,26580,28107,28923,10636,7198,23182,14023,,8986,9612,55,117
"Taylor County, Wisconsin",20596,10535,10061,20246,79,64,30,0,18,159,5,154,20255,341,0.4236,23742,23846,24001,11701,37890,12439,23787,-666666666,12661,9286,55,119
"Trempealeau County, Wisconsin",29274,14773,14501,27707,125,44,155,0,911,332,151,181,27450,1824,0.4179,25490,26231,26640,11686,4945,31882,19845,-666666666,12392,9096,55,121
"Vernon County, Wisconsin",30124,15016,15108,29338,118,32,121,38,188,289,33,256,29676,448,0.4349,23968,24297,24380,11011,5737,13153,22412,,9873,11501,55,123
"Vilas County, Wisconsin",21368,10762,10606,18531,102,2074,102,0,52,507,12,495,21027,341,0.4379,26016,28139,28257,13765,15861,11224,31608,-666666666,14923,11007,55,125
"Walworth County, Wisconsin",102920,51459,51461,96486,1004,195,858,82,2629,1666,396,1270,91900,11020,0.4303,27321,28069,29384,13123,14943,17565,27584,15535,12970,15664,55,127
"Washburn County, Wisconsin",15785,7827,7958,15111,73,281,83,2,52,183,8,175,15544,241,0.4401,25313,25738,25837,10627,9808,19025,19830,,18773,10588,55,129
"Washington County, Wisconsin",132526,65697,66829,127150,1392,150,1483,6,578,1767,298,1469,128804,3722,0.3990,33173,33703,34133,14258,22661,40659,27221,,17654,12834,55,131
"Waukesha County, Wisconsin",392511,192752,199759,365554,5121,615,10972,92,3915,6242,677,5565,375286,17225,0.4248,38151,38884,39447,20888,18975,26725,43558,27314,15861,16685,55,133
"Waupaca County, Wisconsin",52212,26428,25784,50687,347,313,230,8,218,409,71,338,50779,1433,0.4063,26816,27232,27479,14149,15624,14695,9654,,14145,10953,55,135
"Waushara County, Wisconsin",24409,12824,11585,23035,464,119,89,0,400,302,44,258,22934,1475,0.4125,23195,24061,24581,10479,4331,21570,24142,-666666666,5901,9399,55,137
"Winnebago County, Wisconsin",168413,84655,83758,156006,3077,994,3843,47,1333,3113,343,2770,162220,6193,0.4317,27295,28361,28691,14969,6996,17287,24817,16500,13729,6159,55,139
"Wood County, Wisconsin",74261,36655,37606,70690,364,610,1483,0,373,741,125,616,72419,1842,0.4159,26302,26630,26829,15082,17254,19957,26463,-666666666,10929,12109,55,141
"Albany County, Wyoming",37220,19476,17744,33374,520,155,1156,13,1001,1001,206,795,33841,3379,0.4896,24401,25605,26063,17950,7641,12054,14962,,16760,13720,56,001
"Big Horn County, Wyoming",11827,5927,5900,11094,6,257,63,14,175,218,46,172,10793,1034,0.3926,24960,25548,26243,14794,22450,15226,17005,6964,23796,11006,56,003
"Campbell County, Wyoming",47448,24748,22700,44254,371,673,289,16,1032,813,230,583,43646,3802,0.3763,34342,34990,35991,19717,27322,18593,49681,,28559,16743,56,005
"Carbon County, Wyoming",15795,8562,7233,14469,168,93,132,20,380,533,53,480,13083,2712,0.3799,26673,27734,28969,19558,12815,12448,4872,,28689,8866,56,007
"Converse County, Wyoming",13991,7091,6900,13250,40,169,67,5,220,240,20,220,13000,991,0.4055,30380,31242,31802,18257,6843,12666,44243,,10323,13494,56,009
"Crook County, Wyoming",7155,3695,3460,7097,4,20,5,0,16,13,7,6,6979,176,0.3999,31183,31271,30783,50154,,13815,,-666666666,37181,,56,011
"Fremont County, Wyoming",40739,20314,20425,30137,182,8523,269,26,368,1234,205,1029,38175,2564,0.4081,24431,27840,28479,16256,22585,13787,28050,37492,19869,15245,56,013
"Goshen County, Wyoming",13555,7190,6365,12620,48,44,10,6,501,326,25,301,12159,1396,0.4157,24900,24305,24610,28435,51965,13582,10480,,44362,16481,56,015
"Hot Springs County, Wyoming",4826,2364,2462,4661,12,90,14,1,17,31,0,31,4682,144,0.4223,27548,27987,28646,6995,,12046,,,25841,18545,56,017
"Johnson County, Wyoming",8599,4446,4153,8147,1,0,95,0,162,194,4,190,8250,349,0.3848,28062,28264,28846,29028,,-666666666,,-666666666,55806,6351,56,019
"Laramie County, Wyoming",94412,47194,47218,82486,2730,863,1061,24,4210,3038,645,2393,81434,12978,0.4064,29375,31130,32174,18043,22323,10882,21272,7367,16282,14470,56,021
"Lincoln County, Wyoming",18180,9301,8879,17548,22,59,82,16,113,340,36,304,17397,783,0.3738,28077,28613,29112,14333,22695,9039,5856,,6956,14492,56,023
"Natrona County, Wyoming",78667,39848,38819,72701,824,960,708,3,1028,2443,306,2137,72673,5994,0.4240,30265,31259,32068,17141,17011,19781,28135,,25199,12054,56,025
"Niobrara County, Wyoming",2492,1170,1322,2341,6,10,18,0,17,100,0,100,2423,69,0.4841,25867,25946,26200,33077,,6290,30250,-666666666,96618,13798,56,027
"Park County, Wyoming",28735,14162,14573,27209,203,255,163,2,416,487,36,451,27181,1554,0.3795,28870,29533,30073,18393,9985,28735,19169,,11467,17972,56,029
"Platte County, Wyoming",8730,4468,4262,8297,2,30,21,0,213,167,73,94,8085,645,0.4138,25302,25858,26391,12987,,1513,9410,-666666666,20051,10922,56,031
"Sheridan County, Wyoming",29578,14573,15005,27655,230,436,235,17,513,492,141,351,28374,1204,0.4121,29656,30623,30789,18193,11236,13568,18154,,19430,15133,56,033
"Sublette County, Wyoming",10183,5508,4675,9469,0,22,106,3,9,574,0,574,9395,788,0.3440,33532,34012,34708,22135,-666666666,32791,11754,,,29455,56,035
"Sweetwater County, Wyoming",44595,23283,21312,40965,413,226,315,166,751,1759,95,1664,37605,6990,0.3818,30500,31276,33279,19007,13978,9780,26184,64035,37438,13634,56,037
"Teton County, Wyoming",21956,11478,10478,20737,68,141,378,0,377,255,23,232,18625,3331,0.4875,43628,43812,47546,28016,429785,37126,12167,-666666666,11422,23588,56,039
"Uinta County, Wyoming",20989,10687,10302,19660,27,40,12,0,331,919,0,919,19123,1866,0.4273,25778,26514,27038,16188,25178,28520,,-666666666,18282,12222,56,041
"Washakie County, Wyoming",8444,4216,4228,7700,65,41,49,0,362,227,73,154,7273,1171,0.4750,26922,27111,28712,17503,,35607,49416,-666666666,27175,21385,56,043
"Weston County, Wyoming",7135,3766,3369,6664,16,37,129,0,175,114,18,96,6874,261,0.4178,29091,30294,30370,9884,1363,18068,17473,-666666666,7931,11895,56,045
"Adjuntas Municipio, Puerto Rico",19188,9391,9797,18458,175,5,0,0,481,69,24,45,35,19153,0.6023,7042,7076,3789,7048,10698,,-666666666,-666666666,5026,2186,72,001
"Aguada Municipio, Puerto Rico",41176,20219,20957,24072,1097,27,75,0,1520,14385,148,14237,2777,38399,0.5126,9043,9463,9810,8891,7381,,18089,-666666666,8217,8468,72,003
"Aguadilla Municipio, Puerto Rico",59068,28808,30260,42400,2112,75,636,0,4053,9792,298,9494,2283,56785,0.5421,9938,10037,12256,9904,11927,5876,6384,-666666666,9719,9437,72,005
"Aguas Buenas Municipio, Puerto Rico",28083,13740,14343,22806,958,0,2,0,580,3737,67,3670,251,27832,0.5719,8357,8567,16935,8282,6779,-666666666,,-666666666,9096,7362,72,007
"Aibonito Municipio, Puerto Rico",25241,12226,13015,20881,1845,0,30,0,2288,197,25,172,57,25184,0.4739,8766,9026,29655,8731,7223,-666666666,,-666666666,7791,8142,72,009
"Arecibo Municipio, Puerto Rico",93969,45202,48767,80655,3762,205,903,0,5957,2487,761,1726,484,93485,0.5322,9638,9621,7034,9647,10790,7954,5184,-666666666,9398,10774,72,013
"Arroyo Municipio, Puerto Rico",19255,9044,10211,10051,4947,0,0,0,1863,2394,95,2299,50,19205,0.4951,7996,8804,11490,7987,7672,-666666666,-666666666,-666666666,7229,5865,72,015
"Barceloneta Municipio, Puerto Rico",24908,11958,12950,23993,416,0,30,0,255,214,28,186,182,24726,0.5134,7967,7984,4128,7958,8505,-666666666,,-666666666,8030,2705,72,017
"Barranquitas Municipio, Puerto Rico",30045,14810,15235,14115,993,26,0,0,691,14220,145,14075,63,29982,0.5440,7611,7791,,7611,9147,,-666666666,-666666666,7420,7332,72,019
"Cabo Rojo Municipio, Puerto Rico",50706,24223,26483,44762,1515,32,5,0,4024,368,50,318,188,50518,0.5231,9145,9094,21188,9100,7878,10478,,-666666666,10536,5167,72,023
"Caguas Municipio, Puerto Rico",140166,65763,74403,105693,10590,212,533,0,15278,7860,868,6992,1150,139016,0.5073,13149,13215,17118,13123,13459,5423,10602,-666666666,13836,10900,72,025
"Camuy Municipio, Puerto Rico",34438,16630,17808,30566,505,32,39,0,2853,443,231,212,216,34222,0.4942,9493,9690,,9544,9915,,,-666666666,6875,12418,72,027
"Carolina Municipio, Puerto Rico",171310,79150,92160,101669,36871,3395,1130,19,17387,10839,1252,9587,2191,169119,0.4778,14937,16210,36959,14706,13196,11418,9421,,12257,14883,72,031
"Cayey Municipio, Puerto Rico",47252,22811,24441,34930,1570,8,186,0,9462,1096,145,951,258,46994,0.5337,12281,12968,15933,12257,13677,,9620,-666666666,9907,9394,72,035
"Ceiba Municipio, Puerto Rico",13122,6191,6931,7836,757,0,153,0,4028,348,65,283,83,13039,0.4695,10640,11635,29381,10525,16094,-666666666,9561,-666666666,8183,5295,72,037
"Ciales Municipio, Puerto Rico",18242,8955,9287,17586,136,0,0,0,267,253,25,228,74,18168,0.5084,6684,6612,9119,6674,7813,-666666666,-666666666,-666666666,8724,8934,72,039
"Cidra Municipio, Puerto Rico",42878,20950,21928,31839,1448,70,241,0,8294,986,115,871,142,42736,0.4786,11572,11780,38997,11503,13808,1871,4946,-666666666,11015,8554,72,041
"Coamo Municipio, Puerto Rico",40496,19739,20757,27186,3132,0,0,0,9629,549,34,515,88,40408,0.5033,9311,9289,10878,9308,8513,-666666666,-666666666,-666666666,9866,5242,72,043
"Corozal Municipio, Puerto Rico",36463,17785,18678,17368,519,8,0,0,1594,16974,161,16813,72,36391,0.5079,7820,8471,,7834,6708,,-666666666,-666666666,5636,7389,72,047
"Culebra Municipio, Puerto Rico",1585,916,669,949,49,0,0,0,577,10,0,10,71,1514,0.4509,9041,8556,15247,8788,15486,-666666666,-666666666,-666666666,9304,8350,72,049
"Dorado Municipio, Puerto Rico",38305,18388,19917,28518,5385,0,32,0,813,3557,128,3429,916,37389,0.5394,14753,16272,21966,14593,9544,-666666666,,-666666666,15347,10297,72,051
"Fajardo Municipio, Puerto Rico",35539,16721,18818,21132,3350,28,161,0,9949,919,383,536,313,35226,0.4630,10590,10708,7322,10580,12436,22711,18859,-666666666,9984,5919,72,053
"Florida Municipio, Puerto Rico",12565,6037,6528,12299,30,0,28,0,178,30,0,30,19,12546,0.4311,7193,7176,,7196,,-666666666,,-666666666,7852,,72,054
"Guayama Municipio, Puerto Rico",44261,21980,22281,30224,5850,188,32,0,4319,3648,150,3498,181,44080,0.5026,9260,8903,9254,9280,12409,9088,,-666666666,7724,8964,72,057
"Guayanilla Municipio, Puerto Rico",20862,10076,10786,18588,576,151,0,0,1071,476,93,383,52,20810,0.5010,7565,7453,5095,7569,10014,4932,-666666666,-666666666,7383,10223,72,059
"Guaynabo Municipio, Puerto Rico",95428,45309,50119,72916,5400,414,138,0,10657,5903,505,5398,1437,93991,0.5457,21992,24647,36887,21829,14248,13889,19514,-666666666,12167,14644,72,061
"Gurabo Municipio, Puerto Rico",46460,22181,24279,28133,5000,55,133,0,6575,6564,459,6105,227,46233,0.5126,14523,14452,15758,14527,13271,15585,10833,-666666666,14568,15800,72,063
"Hatillo Municipio, Puerto Rico",41830,20220,21610,39843,360,0,131,0,759,737,143,594,335,41495,0.4831,9632,9614,8606,9592,12201,-666666666,22127,-666666666,10592,6139,72,065
"Hormigueros Municipio, Puerto Rico",17023,7918,9105,7317,558,0,66,0,4057,5025,176,4849,154,16869,0.4425,10700,11013,10151,10646,13168,-666666666,23294,-666666666,10305,10124,72,067
"Humacao Municipio, Puerto Rico",57181,27143,30038,33344,4794,184,421,0,16443,1995,133,1862,569,56612,0.5001,10826,11859,39670,10589,10755,7552,4627,-666666666,8934,10934,72,069
"Isabela Municipio, Puerto Rico",44965,21926,23039,29910,2351,329,20,0,10588,1767,343,1424,496,44469,0.5172,8472,8986,16201,8446,10638,4609,,-666666666,6657,8232,72,071
"Jayuya Municipio, Puerto Rico",16183,8084,8099,13761,380,83,14,0,563,1382,76,1306,30,16153,0.4829,7454,7388,8817,7452,6209,24948,,-666666666,6605,7823,72,073
"Juncos Municipio, Puerto Rico",40284,19270,21014,31008,1743,3,0,0,7218,312,0,312,165,40119,0.4871,9473,9609,2957,9493,10382,,-666666666,-666666666,8739,7929,72,077
"Lajas Municipio, Puerto Rico",25117,12278,12839,21973,639,30,0,0,1818,657,269,388,83,25034,0.5102,6893,6745,3980,6903,9490,11693,-666666666,-666666666,6601,9893,72,079
"Lares Municipio, Puerto Rico",29426,14530,14896,27954,214,0,29,0,817,412,8,404,94,29332,0.5488,7055,6863,10886,7048,15645,-666666666,,-666666666,9900,10446,72,081
"Las Piedras Municipio, Puerto Rico",38759,18766,19993,28722,2070,0,116,0,1820,6031,73,5958,92,38667,0.5072,9816,9477,16565,9787,12208,-666666666,,-666666666,14137,9472,72,085
"Luquillo Municipio, Puerto Rico",19731,9325,10406,10791,2035,51,163,0,6299,392,196,196,447,19284,0.5070,10495,11503,26601,10168,9825,4667,18528,-666666666,8937,8704,72,089
"Maricao Municipio, Puerto Rico",6384,3174,3210,5590,154,0,0,0,519,121,36,85,7,6377,0.4832,6373,6441,-666666666,6380,9269,-666666666,-666666666,-666666666,5824,1906,72,093
"Maunabo Municipio, Puerto Rico",11904,5883,6021,5990,3472,6,0,0,652,1784,160,1624,14,11890,0.4675,8436,7778,,8443,9146,,-666666666,-666666666,9079,9043,72,095
"Moca Municipio, Puerto Rico",39349,19321,20028,31456,1020,89,20,20,4641,2103,103,2000,312,39037,0.4998,7834,7841,13677,7819,7719,8863,,,7878,7663,72,099
"Morovis Municipio, Puerto Rico",32484,16186,16298,28015,402,0,33,0,524,3510,0,3510,84,32400,0.5068,7722,7663,,7729,6301,-666666666,,-666666666,7786,8366,72,101
"Naguabo Municipio, Puerto Rico",26881,12813,14068,17003,1025,0,219,0,8033,601,55,546,112,26769,0.5323,9776,8824,3396,9775,9384,-666666666,4002,-666666666,12298,5777,72,103
"Naranjito Municipio, Puerto Rico",30034,14842,15192,14421,1229,10,9,0,1573,12792,361,12431,99,29935,0.5349,9481,10800,1678,9508,8863,,,-666666666,9366,8080,72,105
"Orocovis Municipio, Puerto Rico",22927,11560,11367,18353,717,0,0,0,739,3118,75,3043,40,22887,0.4908,6968,7355,85,6980,4730,-666666666,-666666666,-666666666,5192,5630,72,107
"Patillas Municipio, Puerto Rico",18766,9258,9508,10991,3387,225,0,12,1836,2315,8,2307,35,18731,0.5004,7745,7725,,7744,8059,2445,-666666666,,7034,8501,72,109
"Ponce Municipio, Puerto Rico",159660,76895,82765,120374,8281,201,154,0,10803,19847,708,19139,909,158751,0.5766,10564,11091,19188,10528,9318,4349,17391,-666666666,9249,8615,72,113
"Quebradillas Municipio, Puerto Rico",25512,12431,13081,18588,900,55,0,0,5489,480,159,321,181,25331,0.5042,7602,7530,5319,7608,7053,9927,-666666666,-666666666,8067,5834,72,115
"Sabana Grande Municipio, Puerto Rico",24692,11751,12941,21251,817,91,0,0,1951,582,155,427,257,24435,0.5201,8013,8131,11120,7980,8014,11079,-666666666,-666666666,6536,8159,72,121
"Salinas Municipio, Puerto Rico",30506,14833,15673,17286,2238,35,93,0,8910,1944,185,1759,236,30270,0.5118,7992,7959,1496,8017,8286,,7766,-666666666,8283,6731,72,123
"San Juan Municipio, Puerto Rico",380149,174705,205444,251507,56775,1494,3407,12,27561,39393,3614,35779,7158,372991,0.5988,16931,19562,28921,16777,11010,12098,9923,,11793,13060,72,127
"San Lorenzo Municipio, Puerto Rico",40313,19778,20535,32548,1984,0,0,0,666,5115,156,4959,115,40198,0.5271,9912,9557,16495,9883,12148,-666666666,-666666666,-666666666,13105,10890,72,129
"Santa Isabel Municipio, Puerto Rico",23114,11186,11928,13327,1733,0,0,0,7697,357,38,319,18,23096,0.5278,8863,8951,-666666666,8806,8889,-666666666,-666666666,-666666666,8653,9987,72,133
"Toa Alta Municipio, Puerto Rico",74688,36127,38561,46653,6112,173,32,0,5449,16269,585,15684,307,74381,0.4822,13197,13569,20417,13167,13066,5337,,-666666666,13774,12051,72,135
"Toa Baja Municipio, Puerto Rico",86873,41076,45797,43145,8907,237,60,7,3582,30935,460,30475,634,86239,0.4665,11736,12570,14566,11675,11100,13404,11768,,11343,10792,72,137
"Trujillo Alto Municipio, Puerto Rico",73030,34645,38385,44869,5951,71,13,11,2915,19200,520,18680,309,72721,0.4905,15182,16360,32616,15110,15458,6663,36846,,12973,12703,72,139
"Utuado Municipio, Puerto Rico",32086,15699,16387,27936,915,26,223,0,2382,604,247,357,155,31931,0.5249,7642,7606,7720,7656,6416,,1752,-666666666,8442,10320,72,141
"Vega Alta Municipio, Puerto Rico",39670,18956,20714,31079,3716,45,68,0,1639,3123,164,2959,555,39115,0.5642,10072,10467,10357,10074,9391,9849,2894,-666666666,8069,8160,72,143
"Vega Baja Municipio, Puerto Rico",57915,27920,29995,53588,1785,145,62,32,1587,716,254,462,1699,56216,0.5459,9145,8811,5508,9236,10945,16324,6403,,15011,12192,72,145
"Vieques Municipio, Puerto Rico",9217,4720,4497,3883,1211,59,131,0,3617,316,0,316,220,8997,0.4115,8611,10455,20002,8395,5976,3332,422,-666666666,8294,4076,72,147
"Villalba Municipio, Puerto Rico",25196,12356,12840,15546,796,73,10,0,3239,5532,90,5442,114,25082,0.4805,8271,9018,1345,8306,9219,1189,,-666666666,6935,6910,72,149
"Yabucoa Municipio, Puerto Rico",36903,17984,18919,25775,4760,102,26,0,4082,2158,108,2050,164,36739,0.4785,7864,7853,22771,7726,7109,7475,,-666666666,8510,6991,72,151
"Yauco Municipio, Puerto Rico",40391,19514,20877,36327,1105,179,43,0,1366,1371,334,1037,265,40126,0.5292,7858,7835,20047,7788,9256,1602,19293,-666666666,8059,7582,72,153
"Hardin County, Tennessee",25969,12508,13461,24140,1160,86,100,16,35,432,12,420,25733,236,0.5155,20949,21731,21851,5944,12364,15172,8219,,9883,5857,47,071
"Hawkins County, Tennessee",56741,27589,29152,54706,766,190,218,0,351,510,0,510,56010,731,0.4476,21259,21254,21331,14187,26723,14588,39460,-666666666,13432,13646,47,073
"Haywood County, Tennessee",18389,8619,9770,8469,9137,41,0,0,414,328,17,311,17643,746,0.4795,18998,23419,23739,25988,14512,6893,-666666666,-666666666,42291,1955,47,075
"Henderson County, Tennessee",27963,13471,14492,24923,2154,9,25,20,232,600,27,573,27371,592,0.4358,19847,20785,20836,12351,14396,23967,50484,,6977,4323,47,077
"Henry County, Tennessee",32279,15586,16693,28883,2774,83,24,0,26,489,26,463,31626,653,0.4657,21941,23281,23521,10728,10593,28293,15058,-666666666,16954,6664,47,079
"Hickman County, Tennessee",24354,12799,11555,22479,1152,9,7,0,237,470,0,470,23865,489,0.4373,18147,18993,19202,8358,5527,,,-666666666,16579,7113,47,081
"Houston County, Tennessee",8356,4151,4205,7911,167,16,14,0,17,231,7,224,8190,166,0.4167,19230,19545,19840,4057,18539,,,-666666666,10929,8573,47,083
"Humphreys County, Tennessee",18322,9039,9283,17449,711,20,28,5,48,61,17,44,17989,333,0.4364,21883,21711,21918,9206,27781,22550,25800,,17046,4830,47,085
"Jackson County, Tennessee",11555,5813,5742,11237,87,0,4,0,72,155,16,139,11362,193,0.4701,18452,18574,18644,8016,19317,-666666666,,-666666666,7736,14518,47,087
"Jefferson County, Tennessee",52166,25694,26472,49494,1420,70,75,0,237,870,259,611,50396,1770,0.4408,21603,22170,22383,11685,11581,,22643,-666666666,12575,9633,47,089
"Johnson County, Tennessee",18089,9785,8304,17294,518,25,5,0,149,98,0,98,17795,294,0.4337,17273,17689,17696,13082,7879,4220,,-666666666,9558,8614,47,091
"Knox County, Tennessee",440732,214220,226512,377816,40328,1150,8868,140,3941,8489,751,7738,424480,16252,0.4814,28255,30008,30439,14693,15963,21821,29596,13725,18892,12679,47,093
"Lake County, Tennessee",7725,4879,2846,5354,2035,21,15,3,125,172,45,127,7446,279,0.4695,11875,15172,15347,2943,4815,2386,3847,,3508,497,47,095
"Lauderdale County, Tennessee",27619,14484,13135,17048,9696,107,120,0,369,279,41,238,27008,611,0.4653,15715,19431,19564,9993,9673,4094,18153,-666666666,9908,9678,47,097
"Lawrence County, Tennessee",42084,20613,21471,39978,757,79,157,0,423,690,101,589,41338,746,0.4416,19298,19631,19672,8628,12603,14778,36889,-666666666,6829,11467,47,099
"Lewis County, Tennessee",12010,5933,6077,11386,180,0,228,0,120,96,15,81,11766,244,0.4001,17962,18502,18705,8306,8945,-666666666,3553,-666666666,15804,7726,47,101
"Lincoln County, Tennessee",33498,16380,17118,29858,1508,104,31,0,396,1601,116,1485,32525,973,0.4209,21686,22518,22657,12977,18037,29847,6390,-666666666,14968,11048,47,103
"Loudon County, Tennessee",49749,24199,25550,47763,617,89,377,23,228,652,0,652,46037,3712,0.4627,28191,28542,29765,12358,12685,31283,41095,,11311,15427,47,105
"McMinn County, Tennessee",52409,25384,27025,48498,2106,127,266,0,326,1086,75,1011,50793,1616,0.4529,20615,20892,21168,10945,14324,22623,27889,-666666666,15598,19928,47,107
"McNairy County, Tennessee",26138,12928,13210,23976,1566,71,0,0,151,374,6,368,25673,465,0.4769,17516,18205,18373,5104,12261,6696,-666666666,-666666666,774,4160,47,109
"Macon County, Tennessee",22582,11095,11487,21668,122,27,169,0,359,237,97,140,21529,1053,0.4227,17386,17814,17713,15250,1398,,16304,-666666666,4533,7400,47,111
"Madison County, Tennessee",98364,46657,51707,59033,36357,201,1078,67,315,1313,198,1115,94945,3419,0.4802,23398,29061,30033,10970,14556,25797,25483,,11947,14116,47,113
"Marion County, Tennessee",28261,13888,14373,26432,458,49,70,0,110,1142,27,1115,27844,417,0.4351,21127,21526,21624,9931,16932,8192,53544,-666666666,7325,13482,47,115
"Marshall County, Tennessee",30977,15151,15826,27777,2231,28,124,0,389,428,0,428,29505,1472,0.4365,21241,21859,22318,10426,15058,19111,52207,-666666666,13853,11227,47,117
"Maury County, Tennessee",82729,39882,42847,69495,9840,247,552,11,797,1787,124,1663,78544,4185,0.4279,23259,24752,25435,10786,16499,8831,26873,,14490,7271,47,119
"Meigs County, Tennessee",11694,5789,5905,11271,126,3,0,0,0,294,0,294,11550,144,0.4210,18465,18669,18715,15112,24925,,-666666666,-666666666,-666666666,7832,47,121
"Monroe County, Tennessee",45002,22486,22516,42831,1059,258,152,27,47,628,17,611,43374,1628,0.4563,19880,20059,20535,7639,21517,20333,13528,38252,16751,5723,47,123
"Montgomery County, Tennessee",182015,90325,91690,130733,34480,1161,3780,828,3342,7691,692,6999,165835,16180,0.4200,22867,24828,25465,16552,18814,21236,20716,17754,16681,12260,47,125
"Moore County, Tennessee",6348,3091,3257,5965,203,45,0,0,36,99,0,99,6342,6,0.4660,25687,26242,26269,,21181,18589,-666666666,-666666666,,14055,47,127
"Morgan County, Tennessee",21866,12046,9820,20630,809,17,54,8,33,315,2,313,21636,230,0.4317,16927,17702,17734,12520,1191,8588,18374,,2282,8725,47,129
"Obion County, Tennessee",31378,15020,16358,27248,3399,68,69,8,187,399,60,339,30298,1080,0.4694,21929,23204,23652,9164,14882,9360,12925,,10143,4558,47,131
"Overton County, Tennessee",22109,10906,11203,21620,137,38,51,0,0,263,0,263,21857,252,0.4549,18679,18944,19120,3979,10266,8474,,-666666666,-666666666,5943,47,133
"Perry County, Tennessee",7851,3945,3906,7474,198,23,0,0,0,156,0,156,7699,152,0.4227,16597,16916,16887,16870,9534,,-666666666,-666666666,-666666666,12486,47,135
"Pickett County, Tennessee",5101,2490,2611,4980,41,0,0,0,0,80,0,80,5091,10,0.4334,20590,20933,20945,,9944,-666666666,-666666666,-666666666,-666666666,4694,47,137
"Polk County, Tennessee",16715,8324,8391,16259,30,104,28,0,38,256,30,226,16442,273,0.4544,20825,21158,21039,24891,5887,15776,,-666666666,6513,6585,47,139
"Putnam County, Tennessee",73237,35981,37256,69008,1793,98,793,22,446,1077,105,972,69181,4056,0.5135,21470,21533,20949,35439,8821,23381,31302,11018,65527,13033,47,141
"Rhea County, Tennessee",32272,15957,16315,30485,703,51,23,0,373,637,35,602,30939,1333,0.4495,19764,20201,20635,8483,16253,29631,18735,-666666666,12714,6093,47,143
"Roane County, Tennessee",53413,26229,27184,50437,1418,200,233,0,37,1088,60,1028,52605,808,0.4502,23478,23688,23646,21739,26377,15148,19191,-666666666,,13174,47,145
"Robertson County, Tennessee",67024,32964,34060,58851,5139,269,246,11,1401,1107,330,777,62996,4028,0.3921,24049,25556,26129,10828,14274,17619,14464,,10632,10173,47,147
"Rutherford County, Tennessee",275461,135832,139629,220756,36905,1112,8151,110,2369,6058,427,5631,256374,19087,0.4040,25057,26333,27232,13865,20531,16222,22842,16803,13884,15270,47,149
"Scott County, Tennessee",22104,10876,11228,21738,48,101,17,0,5,195,0,195,21954,150,0.5183,17680,17762,17794,13067,12748,15840,,-666666666,,12641,47,151
"Sequatchie County, Tennessee",14431,7099,7332,12895,25,179,0,0,220,1112,0,1112,13947,484,0.4476,22300,23056,23362,11775,20972,21455,-666666666,-666666666,14455,15250,47,153
"Sevier County, Tennessee",92561,45609,46952,87763,739,213,1002,11,1520,1313,43,1270,87469,5092,0.4337,22125,22439,22829,13275,19062,18118,20572,,13888,14085,47,155
"Shelby County, Tennessee",936130,446442,489688,378933,491453,2011,22959,387,24891,15496,2177,13319,881825,54305,0.4993,25913,38567,40134,13620,17009,19032,32271,12855,11414,13984,47,157
"Smith County, Tennessee",19092,9408,9684,18198,383,106,55,0,125,225,8,217,18626,466,0.4355,21354,21687,21952,9522,14944,8324,30064,-666666666,14578,13080,47,159
"Stewart County, Tennessee",13311,6729,6582,12504,257,164,139,0,85,162,49,113,13014,297,0.4313,21598,21784,21952,18836,17478,26123,8433,-666666666,,11158,47,161
"Sullivan County, Tennessee",156850,75840,81010,148572,2818,496,863,60,1327,2714,58,2656,154312,2538,0.4661,24085,24603,24666,13392,18155,14723,31489,37643,10084,7760,47,163
"Sumner County, Tennessee",166636,81331,85305,148611,11406,745,1991,106,1716,2061,125,1936,159795,6841,0.4460,28393,29387,29913,14016,19934,19804,38453,1776,14041,10244,47,165
"Tipton County, Tennessee",61433,30327,31106,48165,11096,369,397,384,110,912,32,880,59986,1447,0.4197,23205,25083,25261,21522,15681,37479,24368,3511,36033,16020,47,167
"Trousdale County, Tennessee",7859,3951,3908,6738,891,0,196,0,0,34,0,34,7853,6,0.4622,20298,21156,21158,,17630,-666666666,6349,-666666666,-666666666,,47,169
"Unicoi County, Tennessee",18175,8943,9232,17694,147,28,60,0,152,94,18,76,17427,748,0.4821,21162,21441,21929,8958,11882,-666666666,,-666666666,14496,7161,47,171
"Union County, Tennessee",19139,9497,9642,18774,58,0,10,0,13,284,11,273,18868,271,0.4364,18053,18219,18281,13194,3778,-666666666,,-666666666,,10635,47,173
"Van Buren County, Tennessee",5578,2774,2804,5405,18,0,37,0,0,118,42,76,5539,39,0.4707,19945,20201,20093,35092,,-666666666,29943,-666666666,-666666666,7972,47,175
"Warren County, Tennessee",39867,19729,20138,36539,638,76,224,12,1063,1315,70,1245,36592,3275,0.4740,20048,20857,21519,8689,14689,6562,18881,,9738,9597,47,177
"Washington County, Tennessee",124798,60640,64158,115228,4770,399,1660,20,486,2235,191,2044,120946,3852,0.4909,26083,26488,26772,18995,15458,19583,39835,,42225,15231,47,179
"Wayne County, Tennessee",16967,9375,7592,15633,1041,36,40,0,76,141,0,141,16675,292,0.4379,15812,16827,16995,4165,2123,23389,4960,-666666666,2192,12889,47,181
"Weakley County, Tennessee",34699,16918,17781,30731,3278,55,56,7,150,422,51,371,33953,746,0.4583,19516,20255,20338,14103,13895,22191,21809,,8226,12452,47,183
"White County, Tennessee",26086,12791,13295,25002,469,25,10,0,17,563,52,511,25589,497,0.4460,17529,17973,18141,6855,8805,,,-666666666,,6393,47,185
"Williamson County, Tennessee",193921,94597,99324,174068,8227,268,6355,14,1684,3305,478,2827,184993,8928,0.4441,42675,43835,44863,19078,32439,47010,39349,,16540,26450,47,187
"Wilson County, Tennessee",119584,58535,61049,105851,8120,382,1612,72,1799,1748,152,1596,115404,4180,0.4178,28435,29666,29832,15874,16796,31538,31413,8378,10419,23950,47,189
"Anderson County, Texas",58084,35459,22625,43451,12295,255,341,8,939,795,204,591,48502,9582,0.4546,18623,21773,25208,7893,8464,22585,13192,,13586,10658,48,001
"Andrews County, Texas",16126,8048,8078,14737,417,148,105,0,486,233,66,167,7767,8359,0.4712,29363,29548,38295,21174,22994,24771,80095,-666666666,13567,42046,48,003
"Angelina County, Texas",87433,42779,44654,68512,13408,498,815,0,2989,1211,265,946,69469,17964,0.4731,21521,23525,26441,11699,15168,12265,16860,-666666666,11375,10458,48,005
"Aransas County, Texas",23889,11868,12021,21335,345,159,332,0,575,1143,352,791,17756,6133,0.4775,25906,26479,30185,13956,20688,7385,68404,-666666666,22101,8936,48,007
"Archer County, Texas",8853,4440,4413,8406,80,99,55,0,124,89,16,73,8149,704,0.4403,28250,29074,30025,14658,10544,6144,8431,-666666666,19382,15449,48,009
"Armstrong County, Texas",1947,970,977,1801,43,18,0,1,50,34,11,23,1718,229,0.3554,27199,28294,30301,9583,21574,9239,-666666666,,15426,1726,48,011
"Atascosa County, Texas",46343,23018,23325,39198,330,214,179,0,4723,1699,727,972,17397,28946,0.4455,21957,23322,32242,15939,22736,39514,50417,-666666666,13272,9254,48,013
"Austin County, Texas",28724,14393,14331,24010,2590,15,0,0,1421,688,209,479,21580,7144,0.4384,27490,29638,32946,17238,19889,32560,-666666666,-666666666,12789,11367,48,015
"Bailey County, Texas",7084,3619,3465,6201,119,8,24,9,699,24,24,0,2876,4208,0.4406,18082,18588,28464,11750,8360,,7175,,16130,,48,017
"Bandera County, Texas",20642,10089,10553,19589,93,152,91,0,166,551,72,479,17084,3558,0.4266,26900,27472,28079,23420,5727,14207,11418,-666666666,13542,20225,48,019
"Bastrop County, Texas",75708,38702,37006,63257,5950,819,654,0,3953,1075,159,916,50060,25648,0.4147,23605,24956,30238,14126,18493,18315,20096,-666666666,13081,17249,48,021
"Baylor County, Texas",3648,1788,1860,3432,60,26,0,0,15,115,12,103,3224,424,0.5835,30573,31725,33789,13530,26292,11019,-666666666,-666666666,,6862,48,023
"Bee County, Texas",32462,19550,12912,25771,2849,108,112,0,2997,625,456,169,13950,18512,0.4730,16509,18336,26168,12970,3367,25161,2140,-666666666,15476,7100,48,025
"Bell County, Texas",321591,160340,161251,209370,68492,2629,9139,2471,13929,15561,1870,13691,248465,73126,0.4238,23335,25792,28806,15721,20440,18771,21501,14513,16173,12667,48,027
"Bexar County, Texas",1789088,879006,910082,1372868,131053,12664,45343,2523,169959,54678,15720,38958,733520,1055568,0.4606,24525,25993,38546,17609,22370,17661,29473,21042,16183,16420,48,029
"Blanco County, Texas",10625,5348,5277,9960,132,100,64,0,202,167,2,165,8624,2001,0.4234,28113,28666,31332,16683,18127,7125,15997,-666666666,30231,17698,48,031
"Borden County, Texas",676,339,337,658,0,13,0,0,0,5,0,5,612,64,0.5928,47823,48575,51531,19547,-666666666,28069,-666666666,-666666666,-666666666,,48,033
"Bosque County, Texas",18052,8932,9120,16974,283,63,58,0,292,382,38,344,15064,2988,0.4581,24290,24914,27286,11443,18985,35710,3376,-666666666,12625,10668,48,035
"Bowie County, Texas",93068,47046,46022,64647,22695,769,816,94,2103,1944,175,1769,86611,6457,0.4826,22977,26919,27868,10196,14179,21068,18942,23506,9044,12096,48,037
"Brazoria County, Texas",325477,165146,160331,243679,41926,1008,19203,20,13762,5879,1214,4665,232485,92992,0.4276,30134,30609,35017,20333,29144,29791,37707,,17850,21674,48,039
"Brazos County, Texas",201534,102190,99344,149587,22013,691,11123,73,13007,5040,1011,4029,152883,48651,0.5238,22243,24758,27901,12993,16074,19418,16542,21296,12127,13602,48,041
"Brewster County, Texas",9270,4543,4727,8635,168,134,0,0,167,166,34,132,5274,3996,0.4940,27095,27633,34793,18111,31099,16652,-666666666,-666666666,14954,15730,48,043
"Briscoe County, Texas",1601,830,771,1445,67,1,0,0,19,69,3,66,1121,480,0.4427,22197,23649,29861,9255,8363,,-666666666,-666666666,23774,4649,48,045
"Brooks County, Texas",7200,3814,3386,6361,10,0,60,0,694,75,25,50,646,6554,0.5242,14353,14235,20679,13919,3590,-666666666,,-666666666,17056,10245,48,047
"Brown County, Texas",37903,18786,19117,34813,1474,250,151,6,641,568,123,445,30182,7721,0.4443,20533,20906,23007,12112,19096,14372,16847,,13284,13324,48,049
"Burleson County, Texas",17236,8631,8605,14087,2036,0,63,0,725,325,27,298,13899,3337,0.4290,23223,24915,27138,15712,15931,-666666666,5263,-666666666,18783,8970,48,051
"Burnet County, Texas",43911,21837,22074,41139,1031,272,58,0,816,595,115,480,34671,9240,0.4304,25757,26216,29643,12732,20480,20813,,-666666666,15793,19797,48,053
"Caldwell County, Texas",38870,19610,19260,28186,2728,305,78,10,6109,1454,686,768,20024,18846,0.4195,20368,23098,28364,14685,10552,16598,16240,,13582,15256,48,055
"Calhoun County, Texas",21569,10783,10786,18975,583,26,601,0,343,1041,93,948,11350,10219,0.4318,24142,24083,32228,15666,19965,14650,39321,-666666666,17369,21262,48,057
"Callahan County, Texas",13519,6647,6872,12743,203,7,102,8,138,318,11,307,12355,1164,0.4559,22008,22496,22926,17567,10767,,6934,,23039,14789,48,059
"Cameron County, Texas",415103,200279,214824,381670,2236,760,2850,18,23509,4060,2325,1735,48211,366892,0.4942,14898,14918,32898,12568,19214,16583,37105,,11587,13789,48,061
"Camp County, Texas",12463,6140,6323,9262,2211,21,42,0,683,244,30,214,9652,2811,0.4461,18873,20322,23706,9881,14582,,97469,-666666666,9059,17807,48,063
"Carson County, Texas",6108,3002,3106,5856,60,55,25,12,17,83,25,58,5541,567,0.3618,27062,27612,28803,15860,2037,27391,,20708,42200,12094,48,065
"Cass County, Texas",30350,14667,15683,24069,5121,84,138,36,336,566,47,519,29160,1190,0.4426,20534,21976,22296,10980,16202,16306,15517,16994,9212,7202,48,067
"Castro County, Texas",8026,4082,3944,7105,42,52,37,9,337,444,143,301,3089,4937,0.5203,22198,23487,39556,12660,3917,13129,10600,,11168,14149,48,069
"Chambers County, Texas",36550,18300,18250,30412,2983,84,450,17,1654,950,138,812,29136,7414,0.4268,30102,30978,33614,19488,27352,48940,31432,,27341,11820,48,071
"Cherokee County, Texas",50971,25930,25041,40931,7455,153,252,0,842,1338,398,940,40043,10928,0.4817,19683,21574,24685,10959,10835,15501,30994,-666666666,12041,14283,48,073
"Childress County, Texas",7066,4063,3003,5822,730,79,33,86,246,70,18,52,5471,1595,0.4298,20982,23384,27852,8963,8620,,,,15195,,48,075
"Clay County, Texas",10547,5263,5284,10032,51,147,35,0,121,161,16,145,10024,523,0.4330,25729,26445,26916,12274,2814,13917,12329,-666666666,4516,18034,48,077
"Cochran County, Texas",3031,1550,1481,2479,134,22,4,0,306,86,59,27,1359,1672,0.4623,18318,18908,26161,12408,10646,12332,,-666666666,15907,9299,48,079
"Coke County, Texas",3260,1647,1613,3121,27,26,3,0,75,8,0,8,2605,655,0.4928,28741,29245,32990,13807,4589,18000,,-666666666,20928,19725,48,081
"Coleman County, Texas",8656,4261,4395,8077,199,45,79,0,173,83,24,59,7190,1466,0.4672,21332,21804,23569,12195,20112,9451,12503,-666666666,12830,10842,48,083
"Collin County, Texas",836947,411046,425901,612604,73607,3456,100136,500,20441,26203,4222,21981,711924,125023,0.4298,38575,41136,45000,20578,29096,33024,38435,34633,20902,20473,48,085
"Collingsworth County, Texas",3053,1495,1558,2602,104,56,6,0,215,70,9,61,2071,982,0.4283,21594,23803,29442,9324,10997,11254,,-666666666,9134,3594,48,087
"Colorado County, Texas",20771,10225,10546,17034,2769,100,70,0,726,72,31,41,15103,5668,0.4679,24112,26672,31155,14824,12451,6162,14059,-666666666,12886,14990,48,089
"Comal County, Texas",115808,57109,58699,106233,2282,498,857,21,2852,3065,736,2329,85919,29889,0.4543,33020,33745,37817,20014,35473,26804,38164,,16292,20447,48,091
"Comanche County, Texas",13755,6763,6992,13119,55,32,9,0,264,276,64,212,10102,3653,0.4372,19125,19314,22831,9613,29778,7447,,-666666666,20744,8447,48,093
"Concho County, Texas",4091,2770,1321,3640,52,17,15,0,314,53,38,15,1851,2240,0.4428,20503,22005,30892,11898,35052,,-666666666,-666666666,4885,4508,48,095
"Cooke County, Texas",38558,19136,19422,35448,998,378,294,24,504,912,207,705,32239,6319,0.4403,25823,26566,29506,10894,17479,18298,41454,,16922,9332,48,097
"Coryell County, Texas",76276,37585,38691,54815,11999,526,1526,705,2012,4693,336,4357,63271,13005,0.3870,19410,21456,22987,12875,15351,14004,17471,13141,15476,9743,48,099
"Cottle County, Texas",1596,719,877,1291,184,39,2,0,69,11,0,11,1235,361,0.4114,19813,20526,23136,10956,18894,4469,,-666666666,18791,6964,48,101
"Crane County, Texas",4602,2340,2262,2879,160,58,0,0,1440,65,54,11,1915,2687,0.4370,24344,27755,35171,16713,37403,13778,-666666666,-666666666,16697,20003,48,103
"Crockett County, Texas",3871,1980,1891,2854,6,0,0,0,956,55,30,25,1418,2453,0.4221,24862,27918,38575,17262,,-666666666,-666666666,-666666666,16500,14387,48,105
"Crosby County, Texas",6025,2912,3113,5359,254,3,0,21,256,132,65,67,2803,3222,0.4695,19740,20749,30254,12217,13351,,-666666666,,9148,15042,48,107
"Culberson County, Texas",2325,1109,1216,2252,16,13,0,3,18,23,4,19,478,1847,0.4663,16120,16182,26247,13801,2644,,-666666666,,14172,6426,48,109
"Dallam County, Texas",6957,3692,3265,5875,97,112,59,0,559,255,118,137,4057,2900,0.4321,20528,22089,27654,11441,26457,14183,23803,-666666666,11464,4205,48,111
"Dallas County, Texas",2448943,1208920,1240023,1441979,542525,8590,132872,1284,258844,62849,16425,46424,1498784,950159,0.4971,27195,32644,47951,13970,19899,17390,30524,27943,13101,17478,48,113
"Dawson County, Texas",13593,7721,5872,10790,863,245,42,2,1399,252,100,152,6209,7384,0.4985,19725,22669,33993,11384,5060,5854,3945,,11206,7457,48,115
"Deaf Smith County, Texas",19331,9604,9727,17042,190,97,53,0,1343,606,222,384,5979,13352,0.4162,17855,18890,31708,12358,11883,7348,17460,-666666666,11801,5768,48,117
"Delta County, Texas",5239,2568,2671,4455,450,36,35,0,67,196,69,127,4894,345,0.4197,20251,21777,22242,8798,9458,18400,38060,-666666666,4870,12785,48,119
"Denton County, Texas",708627,348748,359879,551219,60946,3044,50026,555,18117,24720,4444,20276,576360,132267,0.4264,34528,36621,40777,19273,27038,27926,33604,23135,21465,18822,48,121
"DeWitt County, Texas",20397,10771,9626,14286,1992,17,21,7,3603,471,279,192,13609,6788,0.5061,26104,30234,33754,17597,10633,,12405,,20381,9943,48,123
"Dickens County, Texas",2339,1277,1062,2072,125,13,3,0,75,51,29,22,1751,588,0.4314,20353,21780,25684,9365,7364,10731,,-666666666,5871,19059,48,125
"Dimmit County, Texas",10537,5115,5422,9898,66,6,4,0,425,138,138,0,1485,9052,0.5074,20822,21081,37395,18119,28211,19233,,-666666666,13606,20257,48,127
"Donley County, Texas",3636,1785,1851,3369,205,26,16,2,8,10,0,10,3280,356,0.4103,21264,21577,22712,11299,18912,19000,4031,,4050,15390,48,129
"Duval County, Texas",11644,6084,5560,10018,105,59,43,0,1386,33,25,8,1343,10301,0.5413,21334,22169,34378,19575,13336,8627,,-666666666,13983,16897,48,131
"Eastland County, Texas",18403,8969,9434,17130,514,37,18,0,391,313,87,226,15610,2793,0.5534,22171,23132,25211,8583,8455,6757,11689,-666666666,6029,14714,48,133
"Ector County, Texas",144932,72359,72573,122535,6227,1026,1185,38,9199,4722,985,3737,64763,80169,0.4522,25726,26950,34263,19950,17416,21913,57720,125576,18276,11438,48,135
"Juana Díaz Municipio, Puerto Rico",49876,23990,25886,29884,5124,81,213,0,3158,11416,317,11099,234,49642,0.4921,9205,9644,11399,9198,8226,21137,6047,-666666666,9040,8514,72,075
"Río Grande Municipio, Puerto Rico",53628,26162,27466,29244,7170,61,123,0,15523,1507,333,1174,225,53403,0.4526,10391,11117,16706,10373,9976,7090,10963,-666666666,9438,8179,72,119
"Loíza Municipio, Puerto Rico",29054,13648,15406,6718,10413,51,33,0,11390,449,181,268,12,29042,0.4822,8563,10566,,8562,8683,8447,7418,-666666666,7169,11294,72,087
"Manatí Municipio, Puerto Rico",42900,20421,22479,37177,1795,14,8,0,3441,465,80,385,490,42410,0.5172,10390,10435,5876,10415,11964,,,-666666666,9380,7895,72,091
"San Germán Municipio, Puerto Rico",34725,16881,17844,31513,975,46,0,0,1767,424,198,226,179,34546,0.5203,9098,9164,7826,9094,7624,26228,-666666666,-666666666,8431,8535,72,125
"Bayamón Municipio, Puerto Rico",201273,95717,105556,119465,16003,1547,504,16,17446,46292,1279,45013,1918,199355,0.4837,12975,13913,17531,12924,12248,7573,10840,,10381,11990,72,021
"Cataño Municipio, Puerto Rico",27211,12912,14299,18600,1971,60,77,0,4670,1833,107,1726,221,26990,0.5567,10592,11798,21628,10535,10262,5947,12336,-666666666,7555,6531,72,033
"San Sebastián Municipio, Puerto Rico",41204,20100,21104,37326,649,0,27,0,2601,601,104,497,342,40862,0.4979,7384,7407,21698,7292,9294,-666666666,,-666666666,6647,6728,72,131
"Añasco Municipio, Puerto Rico",28874,14048,14826,19397,1028,0,26,0,5628,2795,87,2708,253,28621,0.4540,8223,8096,21168,8118,8034,-666666666,,-666666666,8719,8227,72,011
"Canóvanas Municipio, Puerto Rico",47655,23116,24539,23851,6500,57,287,0,16840,120,15,105,80,47575,0.5073,10304,11191,,10291,11434,6858,6069,-666666666,8686,11508,72,029
"Peñuelas Municipio, Puerto Rico",23307,11390,11917,20146,674,32,12,0,1965,478,108,370,211,23096,0.4803,6997,6940,1615,7039,6157,12800,,-666666666,6449,12510,72,111
"Rincón Municipio, Puerto Rico",14998,7334,7664,8583,453,22,37,0,298,5605,17,5588,1314,13684,0.4714,9330,10656,17830,8818,7325,,,-666666666,7466,7452,72,117
"Mayagüez Municipio, Puerto Rico",85425,40978,44447,44716,3410,119,73,0,21363,15744,575,15169,1037,84388,0.5973,10074,11259,25604,9896,14933,3983,38556,-666666666,7934,8475,72,097
"Guánica Municipio, Puerto Rico",18627,8992,9635,16202,625,46,0,0,1330,424,55,369,97,18530,0.4948,6653,7007,4941,6661,5977,11291,-666666666,-666666666,3067,4851,72,055
"Comerío Municipio, Puerto Rico",20533,10222,10311,12087,619,19,14,0,1070,6724,21,6703,16,20517,0.5444,7152,7588,,7158,13263,,,-666666666,7243,5793,72,045
"Las Marías Municipio, Puerto Rico",9521,4717,4804,8923,66,20,0,0,491,21,10,11,94,9427,0.4814,6963,7066,6316,6970,3461,,-666666666,-666666666,5825,7576,72,083